,Part,TrialN,PairID,LValue,RValue,ChosenITM,ChoiceRT,Conf,ConfRT,BlockCond,tDDT,lIA_DT,rIA_DT,tGSF,lastFixat,DV,zDV,absDV,zAbsDV,zConf,zChoiceRT,TotVal,ValCh,ValUnCh,Correct,zTotVal,zValCh,zValUnCh,zGSF,zDDT,absDDT,zValR,zValL,ConfSplit,GSFMedSplit,DDTMedSplit
0,1,1,49,110,131,0,4261.735,74,1584.966,LESS,-508,2392,1884,4,2,21,1.968557767,21,2.095290887,0.388833339,1.228449028,241,110,131,1,1.615547226,1.170500555,1.989850943,1.312145182,-0.061319475,0.061319475,1.989850943,1.170500555,1,1,1
1,1,2,13,47,50,1,3559.258,54,1864.387,LESS,-504,2188,1684,4,1,3,0.281222538,3,-1.047645444,-0.640053114,0.655295103,97,47,50,1,-1.256536731,-1.28755061,-1.170500555,1.312145182,-0.05645687,0.05645687,-1.170500555,-1.28755061,0,1,1
2,1,3,16,50,44,1,3754.464,64,3778.807,LESS,-48,1644,1596,2,1,-6,-0.562445076,6,-0.523822722,-0.125609888,0.814564495,94,50,44,0,-1.316371814,-1.170500555,-1.404600665,-0.399348534,0.497880095,0.497880095,-1.404600665,-1.170500555,0,0,1
3,1,4,7,57,50,0,2431.751,84,3064.179,LESS,-2462,3136,674,2,1,-7,-0.656185922,7,-0.349215148,0.903276565,-0.264642579,107,57,50,0,-1.057086457,-0.897383758,-1.170500555,-0.399348534,-2.436701993,2.436701993,-1.170500555,-0.897383758,1,0,0
4,1,5,18,42,50,0,2199.342,44,2850.845,LESS,-1130,1672,542,2,1,8,0.749926769,8,-0.174607574,-1.15449634,-0.454266055,92,42,50,1,-1.356261869,-1.482634036,-1.170500555,-0.399348534,-0.817454544,0.817454544,-1.170500555,-1.482634036,0,0,0
5,1,6,51,108,110,0,3269.922,44,3745.039,LESS,-1490,2472,982,2,1,2,0.187481692,2,-1.222253018,-1.15449634,0.419224649,218,108,110,1,1.156811594,1.092467184,1.170500555,-0.399348534,-1.25508899,1.25508899,1.170500555,1.092467184,0,0,0
6,1,7,31,78,80,0,6606.698,74,2425.516,LESS,-1170,3474,2304,5,1,2,0.187481692,2,-1.222253018,0.388833339,3.141714156,158,78,80,1,-0.039890055,-0.07803337,0,2.16789204,-0.866080594,0.866080594,0,-0.07803337,1,1,0
7,1,8,58,110,92,1,3642.146,74,3030.001,LESS,-1680,3044,1364,2,2,-18,-1.687335229,18,1.571468165,0.388833339,0.722923769,202,110,92,0,0.837691154,1.170500555,0.468200222,-0.399348534,-1.486062725,1.486062725,0.468200222,1.170500555,1,0,0
8,1,9,12,50,48,1,5213.48,54,2229.314,LESS,-472,2860,2388,6,1,-2,-0.187481692,2,-1.222253018,-0.640053114,2.004981758,98,50,48,0,-1.236591704,-1.170500555,-1.248533925,3.023638899,-0.01755603,0.01755603,-1.248533925,-1.170500555,0,1,1
9,1,10,54,110,101,1,5511.334,34,1727.761,LESS,752,2000,2752,5,2,-9,-0.843667615,9,0,-1.668939567,2.248002083,211,110,101,0,1.017196402,1.170500555,0.819350388,2.16789204,1.470401085,1.470401085,0.819350388,1.170500555,0,1,1
10,1,11,14,46,50,0,2007.957,74,1249.337,LESS,-772,1334,562,2,1,4,0.374963384,4,-0.87303787,0.388833339,-0.610417877,96,46,50,1,-1.276481759,-1.326567295,-1.170500555,-0.399348534,-0.382251401,0.382251401,-1.170500555,-1.326567295,1,0,0
11,1,12,22,80,83,1,3124.521,64,1956.342,LESS,-918,2186,1268,4,1,3,0.281222538,3,-1.047645444,-0.125609888,0.300591365,163,80,83,1,0.059835082,0,0.117050055,1.312145182,-0.559736482,0.559736482,0.117050055,0,0,1,0
12,1,13,6,50,56,0,1978.076,74,3940.974,LESS,-1050,1608,558,2,1,6,0.562445076,6,-0.523822722,0.388833339,-0.63479791,106,50,56,1,-1.077031484,-1.170500555,-0.936400444,-0.399348534,-0.720202445,0.720202445,-0.936400444,-1.170500555,1,0,0
13,1,14,13,50,47,1,2508.548,34,2032.978,LESS,-428,1614,1186,3,1,-3,-0.281222538,3,-1.047645444,-1.668939567,-0.201983585,97,50,47,0,-1.256536731,-1.170500555,-1.28755061,0.456398324,0.035932625,0.035932625,-1.28755061,-1.170500555,0,1,1
14,1,15,46,110,124,1,3907.246,4,1461.971,LESS,-660,2542,1882,5,1,14,1.312371845,14,0.87303787,-3.212269245,0.939219969,234,110,124,1,1.475932034,1.170500555,1.716734147,2.16789204,-0.246098463,0.246098463,1.716734147,1.170500555,0,1,1
15,1,16,27,91,80,1,3482.062,64,2540.283,LESS,-660,2246,1586,4,1,-11,-1.031149307,11,0.349215148,-0.125609888,0.592310563,171,91,80,0,0.219395302,0.429183537,0,1.312145182,-0.246098463,0.246098463,0,0.429183537,0,1,1
16,1,17,40,64,80,0,1823.377,74,2167.747,LESS,-750,1256,506,2,1,16,1.499853537,16,1.222253018,0.388833339,-0.761017472,144,64,80,1,-0.31912044,-0.624266962,0,-0.399348534,-0.355507074,0.355507074,0,-0.624266962,1,0,0
17,1,18,22,83,80,0,5111.944,64,1821.922,LESS,-1778,3340,1562,4,2,-3,-0.281222538,3,-1.047645444,-0.125609888,1.92213811,163,83,80,0,0.059835082,0.117050055,0,1.312145182,-1.605196547,1.605196547,0,0.117050055,0,1,0
18,1,19,54,101,110,0,4920.474,54,3188.875,LESS,-2694,3968,1274,4,1,9,0.843667615,9,0,-0.640053114,1.765916936,211,101,110,1,1.017196402,0.819350388,1.170500555,1.312145182,-2.71873308,2.71873308,1.170500555,0.819350388,0,1,0
19,1,20,6,56,50,0,1869.935,54,1348.091,LESS,-620,1160,540,2,1,-6,-0.562445076,6,-0.523822722,-0.640053114,-0.723030605,106,56,50,0,-1.077031484,-0.936400444,-1.170500555,-0.399348534,-0.197472413,0.197472413,-1.170500555,-0.936400444,0,1,1
20,1,21,18,50,42,0,1705.811,84,1299.314,LESS,20,1130,1150,2,2,-8,-0.749926769,8,-0.174607574,0.903276565,-0.856940064,92,50,42,0,-1.356261869,-1.170500555,-1.482634036,-0.399348534,0.580544379,0.580544379,-1.482634036,-1.170500555,1,0,1
21,1,22,43,110,117,0,3083.54,54,2248.677,LESS,-1634,2252,618,2,1,7,0.656185922,7,-0.349215148,-0.640053114,0.267154795,227,110,117,1,1.336316841,1.170500555,1.443617351,-0.399348534,-1.430142768,1.430142768,1.443617351,1.170500555,0,0,0
22,1,23,32,77,80,0,2474.714,24,1261.502,LESS,-1258,1954,696,2,1,3,0.281222538,3,-1.047645444,-2.183382793,-0.229588887,157,77,80,1,-0.059835082,-0.117050055,0,-0.399348534,-0.973057903,0.973057903,0,-0.117050055,0,1,0
23,1,24,27,80,91,0,2272.349,74,1373.872,LESS,-728,1536,808,2,1,11,1.031149307,11,0.349215148,0.388833339,-0.394699338,171,80,91,1,0.219395302,0,0.429183537,-0.399348534,-0.328762747,0.328762747,0.429183537,0,1,0,0
24,1,25,16,44,50,0,3790.48,64,2175.914,LESS,-616,1952,1336,4,1,6,0.562445076,6,-0.523822722,-0.125609888,0.843950101,94,44,50,1,-1.316371814,-1.404600665,-1.170500555,1.312145182,-0.192609808,0.192609808,-1.170500555,-1.404600665,0,1,1
25,1,26,7,50,57,0,2046.062,64,1804.283,LESS,-774,1330,556,2,1,7,0.656185922,7,-0.349215148,-0.125609888,-0.579327848,107,50,57,1,-1.057086457,-1.170500555,-0.897383758,-0.399348534,-0.384682704,0.384682704,-0.897383758,-1.170500555,0,0,0
26,1,27,14,50,46,1,3822.251,64,1246.179,LESS,686,1538,2224,3,2,-4,-0.374963384,4,-0.87303787,-0.125609888,0.869872192,96,50,46,0,-1.276481759,-1.170500555,-1.326567295,0.456398324,1.390168103,1.390168103,-1.326567295,-1.170500555,0,1,1
27,1,28,51,110,108,0,3347.54,64,1979.166,LESS,-1556,2496,940,4,1,-2,-0.187481692,2,-1.222253018,-0.125609888,0.4825535,218,110,108,0,1.156811594,1.170500555,1.092467184,1.312145182,-1.335321972,1.335321972,1.092467184,1.170500555,0,1,0
28,1,29,50,133,110,1,2252.245,54,2859.177,LESS,-236,1374,1138,1,1,-23,-2.15603946,23,2.444506035,-0.640053114,-0.411102275,243,133,110,0,1.655437281,2.067884313,1.170500555,-1.255095392,0.269337662,0.269337662,1.170500555,2.067884313,0,0,1
29,1,30,49,131,110,1,2083.424,74,1310.553,LESS,388,964,1352,1,2,-21,-1.968557767,21,2.095290887,0.388833339,-0.548844036,241,131,110,0,1.615547226,1.989850943,1.170500555,-1.255095392,1.027904035,1.027904035,1.170500555,1.989850943,1,0,1
30,1,31,47,126,110,1,4155.502,44,1021.733,LESS,-726,2120,1394,3,2,-16,-1.499853537,16,1.222253018,-1.15449634,1.141773078,236,126,110,0,1.515822089,1.794767517,1.170500555,0.456398324,-0.326331444,0.326331444,1.170500555,1.794767517,0,1,0
31,1,32,50,110,133,0,2550.939,84,2476.876,LESS,-610,1748,1138,2,2,23,2.15603946,23,2.444506035,0.903276565,-0.16739659,243,110,133,1,1.655437281,1.170500555,2.067884313,-0.399348534,-0.185315901,0.185315901,2.067884313,1.170500555,1,0,1
32,1,33,47,110,126,0,5814.551,64,1875.655,LESS,-2620,3952,1332,3,2,16,1.499853537,16,1.222253018,-0.125609888,2.495398103,236,110,126,1,1.515822089,1.170500555,1.794767517,0.456398324,-2.628774889,2.628774889,1.794767517,1.170500555,0,1,0
33,1,34,12,48,50,0,1428.288,94,3195.264,LESS,538,1024,1562,2,2,2,0.187481692,2,-1.222253018,1.417719791,-1.083372241,98,48,50,1,-1.236591704,-1.248533925,-1.170500555,-0.399348534,1.21025172,1.21025172,-1.170500555,-1.248533925,1,0,1
34,1,35,32,80,77,0,1743.991,84,714.693,LESS,-582,1362,780,3,2,-3,-0.281222538,3,-1.047645444,0.903276565,-0.825788842,157,80,77,0,-0.059835082,0,-0.117050055,0.456398324,-0.151277666,0.151277666,-0.117050055,0,1,1,1
35,1,36,43,117,110,1,2329.644,34,2402.523,LESS,-514,1568,1054,3,1,-7,-0.656185922,7,-0.349215148,-1.668939567,-0.347952107,227,117,110,0,1.336316841,1.443617351,1.170500555,0.456398324,-0.068613382,0.068613382,1.170500555,1.443617351,0,1,1
36,1,37,40,80,64,1,3381.75,74,1358.669,LESS,-252,1750,1498,3,2,-16,-1.499853537,16,1.222253018,0.388833339,0.510465583,144,80,64,0,-0.31912044,0,-0.624266962,0.456398324,0.249887242,0.249887242,-0.624266962,0,1,1,1
37,1,38,31,80,78,0,2209.993,34,1186.315,LESS,-956,1456,500,2,1,-2,-0.187481692,2,-1.222253018,-1.668939567,-0.445575859,158,80,78,0,-0.039890055,0,-0.07803337,-0.399348534,-0.605931229,0.605931229,-0.07803337,0,0,0,0
38,1,39,46,124,110,1,3602.313,64,1465.37,LESS,390,1444,1834,3,2,-14,-1.312371845,14,0.87303787,-0.125609888,0.690423858,234,124,110,0,1.475932034,1.716734147,1.170500555,0.456398324,1.030335337,1.030335337,1.170500555,1.716734147,0,1,1
39,1,40,58,92,110,0,2506.099,84,3023.266,LESS,-294,1550,1256,2,2,18,1.687335229,18,1.571468165,0.903276565,-0.203981734,202,92,110,1,0.837691154,0.468200222,1.170500555,-0.399348534,0.19882989,0.19882989,1.170500555,0.468200222,1,0,1
40,1,41,49,110,131,1,1734.284,74,2314.899,MORE,-92,726,634,0,2,21,1.968557767,21,2.095290887,0.388833339,-0.833708824,241,110,131,0,1.615547226,1.170500555,1.989850943,-2.11084225,0.44439144,0.44439144,1.989850943,1.170500555,1,0,1
41,1,42,13,47,50,0,6555.37,64,2919.419,MORE,-3882,5110,1228,4,1,3,0.281222538,3,-1.047645444,-0.125609888,3.099835426,97,47,50,0,-1.256536731,-1.28755061,-1.170500555,1.312145182,-4.162926751,4.162926751,-1.170500555,-1.28755061,0,1,0
42,1,43,16,50,44,0,3174.566,64,1513.199,MORE,-638,1764,1126,4,1,-6,-0.562445076,6,-0.523822722,-0.125609888,0.34142329,94,50,44,1,-1.316371814,-1.170500555,-1.404600665,1.312145182,-0.219354135,0.219354135,-1.404600665,-1.170500555,0,1,0
43,1,44,7,57,50,1,2877.579,74,1177.676,MORE,-352,1472,1120,3,2,-7,-0.656185922,7,-0.349215148,0.388833339,0.099110353,107,57,50,1,-1.057086457,-0.897383758,-1.170500555,0.456398324,0.128322119,0.128322119,-1.170500555,-0.897383758,1,1,0
44,1,45,18,42,50,1,1806.31,54,1375.228,MORE,194,772,966,1,2,8,0.749926769,8,-0.174607574,-0.640053114,-0.774942509,92,42,50,0,-1.356261869,-1.482634036,-1.170500555,-1.255095392,0.792067694,0.792067694,-1.170500555,-1.482634036,0,0,1
45,1,46,51,108,110,0,3636.816,64,1251.974,MORE,-686,1854,1168,3,1,2,0.187481692,2,-1.222253018,-0.125609888,0.718575,218,108,110,0,1.156811594,1.092467184,1.170500555,0.456398324,-0.277705395,0.277705395,1.170500555,1.092467184,0,1,0
46,1,47,31,78,80,1,3650.266,100,1077.556,MORE,24,2008,2032,1,2,2,0.187481692,2,-1.222253018,1.726385727,0.729548911,158,78,80,0,-0.039890055,-0.07803337,0,-1.255095392,0.585406984,0.585406984,0,-0.07803337,1,0,1
47,1,48,58,110,92,0,3078.223,74,1222.433,MORE,-364,1728,1364,4,1,-18,-1.687335229,18,1.571468165,0.388833339,0.262816633,202,110,92,1,0.837691154,1.170500555,0.468200222,1.312145182,0.113734304,0.113734304,0.468200222,1.170500555,1,1,0
48,1,49,12,50,48,1,1259.268,94,1471.199,MORE,946,466,1412,1,2,-2,-0.187481692,2,-1.222253018,1.417719791,-1.221276367,98,50,48,1,-1.236591704,-1.170500555,-1.248533925,-1.255095392,1.706237425,1.706237425,-1.248533925,-1.170500555,1,0,1
49,1,50,54,110,101,0,3440.738,24,2589.771,MORE,-1738,2902,1164,4,1,-9,-0.843667615,9,0,-2.183382793,0.558594139,211,110,101,1,1.017196402,1.170500555,0.819350388,1.312145182,-1.556570497,1.556570497,0.819350388,1.170500555,0,1,0
50,1,51,14,46,50,1,5698.027,44,1077.134,MORE,-290,1972,1682,3,2,4,0.374963384,4,-0.87303787,-1.15449634,2.400325683,96,46,50,0,-1.276481759,-1.326567295,-1.170500555,0.456398324,0.203692495,0.203692495,-1.170500555,-1.326567295,0,1,1
51,1,52,22,80,83,1,8224.467,64,1717.749,MORE,-1804,4458,2654,7,2,3,0.281222538,3,-1.047645444,-0.125609888,4.461658656,163,80,83,0,0.059835082,0,0.117050055,3.879385757,-1.636803479,1.636803479,0.117050055,0,0,1,0
52,1,53,6,50,56,1,2626.168,64,2225.933,MORE,-434,1480,1046,3,2,6,0.562445076,6,-0.523822722,-0.125609888,-0.106016934,106,50,56,0,-1.077031484,-1.170500555,-0.936400444,0.456398324,0.028638717,0.028638717,-0.936400444,-1.170500555,0,1,0
53,1,54,13,50,47,0,1991.413,34,929.111,MORE,-994,1494,500,2,1,-3,-0.281222538,3,-1.047645444,-1.668939567,-0.623916196,97,50,47,1,-1.256536731,-1.170500555,-1.28755061,-0.399348534,-0.652125976,0.652125976,-1.28755061,-1.170500555,0,1,0
54,1,55,46,110,124,1,1671.149,64,893.164,MORE,432,654,1086,1,2,14,1.312371845,14,0.87303787,-0.125609888,-0.885220934,234,110,124,0,1.475932034,1.170500555,1.716734147,-1.255095392,1.081392689,1.081392689,1.716734147,1.170500555,0,0,1
55,1,56,27,91,80,0,2607.607,54,1793.087,MORE,-1654,2206,552,2,1,-11,-1.031149307,11,0.349215148,-0.640053114,-0.121160932,171,91,80,1,0.219395302,0.429183537,0,-0.399348534,-1.454455793,1.454455793,0,0.429183537,0,1,0
56,1,57,40,64,80,1,1527.826,100,813.322,MORE,758,562,1320,1,2,16,1.499853537,16,1.222253018,1.726385727,-1.00215877,144,64,80,0,-0.31912044,-0.624266962,0,-1.255095392,1.477694993,1.477694993,0,-0.624266962,1,0,1
57,1,58,22,83,80,0,5043.16,64,1399.128,MORE,-526,2494,1968,6,1,-3,-0.281222538,3,-1.047645444,-0.125609888,1.866016957,163,83,80,1,0.059835082,0.117050055,0,3.023638899,-0.083201197,0.083201197,0,0.117050055,0,1,0
58,1,59,54,101,110,1,2267.665,34,986.77,MORE,142,996,1138,1,2,9,0.843667615,9,0,-1.668939567,-0.398521033,211,101,110,0,1.017196402,0.819350388,1.170500555,-1.255095392,0.72885383,0.72885383,1.170500555,0.819350388,0,0,1
59,1,60,6,56,50,0,4499.543,74,1357.733,MORE,-1232,2734,1502,4,2,-6,-0.562445076,6,-0.523822722,0.388833339,1.422477571,106,56,50,1,-1.077031484,-0.936400444,-1.170500555,1.312145182,-0.941450971,0.941450971,-1.170500555,-0.936400444,1,1,0
60,1,61,18,50,42,0,5571.061,74,991.395,MORE,-696,2884,2188,4,2,-8,-0.749926769,8,-0.174607574,0.388833339,2.296733592,92,50,42,1,-1.356261869,-1.170500555,-1.482634036,1.312145182,-0.289861907,0.289861907,-1.482634036,-1.170500555,1,1,0
61,1,62,43,110,117,1,2045.641,84,1732.67,MORE,556,1108,1664,1,2,7,0.656185922,7,-0.349215148,0.903276565,-0.579671344,227,110,117,0,1.336316841,1.170500555,1.443617351,-1.255095392,1.232133443,1.232133443,1.443617351,1.170500555,1,0,1
62,1,63,32,77,80,1,1402.112,64,2053.806,MORE,518,482,1000,1,2,3,0.281222538,3,-1.047645444,-0.125609888,-1.104729349,157,77,80,0,-0.059835082,-0.117050055,0,-1.255095392,1.185938696,1.185938696,0,-0.117050055,0,0,1
63,1,64,27,80,91,1,2736.625,74,1971.489,MORE,190,1316,1506,3,2,11,1.031149307,11,0.349215148,0.388833339,-0.015894606,171,80,91,0,0.219395302,0,0.429183537,0.456398324,0.787205089,0.787205089,0.429183537,0,1,1,1
64,1,65,16,44,50,1,2065.604,64,2403.31,MORE,294,818,1112,0,2,6,0.562445076,6,-0.523822722,-0.125609888,-0.563383449,94,44,50,0,-1.316371814,-1.404600665,-1.170500555,-2.11084225,0.913632818,0.913632818,-1.170500555,-1.404600665,0,0,1
65,1,66,7,50,57,1,3058.203,64,1657.954,MORE,-6,1416,1410,3,2,7,0.656185922,7,-0.349215148,-0.125609888,0.246482231,107,50,57,0,-1.057086457,-1.170500555,-0.897383758,0.456398324,0.548937447,0.548937447,-0.897383758,-1.170500555,0,1,1
66,1,67,14,50,46,1,1613.454,64,1014.648,MORE,358,608,966,1,2,-4,-0.374963384,4,-0.87303787,-0.125609888,-0.932294526,96,50,46,1,-1.276481759,-1.170500555,-1.326567295,-1.255095392,0.991434497,0.991434497,-1.326567295,-1.170500555,0,0,1
67,1,68,51,110,108,1,1931.482,84,1086.543,MORE,460,998,1458,1,2,-2,-0.187481692,2,-1.222253018,0.903276565,-0.67281415,218,110,108,1,1.156811594,1.170500555,1.092467184,-1.255095392,1.115430924,1.115430924,1.092467184,1.170500555,1,0,1
68,1,69,50,133,110,0,4895.517,74,964.583,MORE,-1858,3392,1534,4,2,-23,-2.15603946,23,2.444506035,0.388833339,1.745554415,243,133,110,1,1.655437281,2.067884313,1.170500555,1.312145182,-1.702448646,1.702448646,1.170500555,2.067884313,1,1,0
69,1,70,49,131,110,1,3197.86,34,1226.561,MORE,-104,1512,1408,2,2,-21,-1.968557767,21,2.095290887,-1.668939567,0.360428962,241,131,110,1,1.615547226,1.989850943,1.170500555,-0.399348534,0.429803626,0.429803626,1.170500555,1.989850943,0,0,1
70,1,71,47,126,110,1,2000.688,64,1976.766,MORE,1668,814,2482,1,2,-16,-1.499853537,16,1.222253018,-0.125609888,-0.616348685,236,126,110,1,1.515822089,1.794767517,1.170500555,-1.255095392,2.583937619,2.583937619,1.170500555,1.794767517,0,0,1
71,1,72,50,110,133,1,1921.251,94,1085.583,MORE,388,902,1290,1,2,23,2.15603946,23,2.444506035,1.417719791,-0.681161666,243,110,133,0,1.655437281,1.170500555,2.067884313,-1.255095392,1.027904035,1.027904035,2.067884313,1.170500555,1,0,1
72,1,73,47,110,126,1,2050.497,94,671.347,MORE,400,986,1386,1,2,16,1.499853537,16,1.222253018,1.417719791,-0.575709313,236,110,126,0,1.515822089,1.170500555,1.794767517,-1.255095392,1.042491849,1.042491849,1.794767517,1.170500555,1,0,1
73,1,74,12,48,50,1,2219.756,64,947.498,MORE,1160,504,1664,1,2,2,0.187481692,2,-1.222253018,-0.125609888,-0.437610187,98,48,50,0,-1.236591704,-1.248533925,-1.170500555,-1.255095392,1.96638679,1.96638679,-1.170500555,-1.248533925,0,0,1
74,1,75,32,80,77,1,1635.473,34,1756.646,MORE,298,644,942,0,2,-3,-0.281222538,3,-1.047645444,-1.668939567,-0.914329132,157,80,77,1,-0.059835082,0,-0.117050055,-2.11084225,0.918495423,0.918495423,-0.117050055,0,0,0,1
75,1,76,43,117,110,0,5608.432,64,1783.309,MORE,-674,2874,2200,6,1,-7,-0.656185922,7,-0.349215148,-0.125609888,2.327224748,227,117,110,1,1.336316841,1.443617351,1.170500555,3.023638899,-0.26311758,0.26311758,1.170500555,1.443617351,0,1,0
76,1,77,40,80,64,0,4443.018,34,914.203,MORE,-1002,2624,1622,4,1,-16,-1.499853537,16,1.222253018,-1.668939567,1.376358586,144,80,64,1,-0.31912044,0,-0.624266962,1.312145182,-0.661851186,0.661851186,-0.624266962,0,0,1,0
77,1,78,31,80,78,1,2620.927,100,1013.713,MORE,408,1098,1506,3,2,-2,-0.187481692,2,-1.222253018,1.726385727,-0.110293088,158,80,78,1,-0.039890055,0,-0.07803337,0.456398324,1.052217059,1.052217059,-0.07803337,0,1,1,1
78,1,79,46,124,110,1,1725.903,64,2174.162,MORE,-200,1128,928,1,1,-14,-1.312371845,14,0.87303787,-0.125609888,-0.840546917,234,124,110,1,1.475932034,1.716734147,1.170500555,-1.255095392,0.313101107,0.313101107,1.170500555,1.716734147,0,0,1
79,1,80,58,92,110,1,3225.23,54,1560.319,MORE,-480,1938,1458,3,1,18,1.687335229,18,1.571468165,-0.640053114,0.382760259,202,92,110,0,0.837691154,0.468200222,1.170500555,0.456398324,-0.02728124,0.02728124,1.170500555,0.468200222,0,1,0
80,1,81,48,128,110,1,7964.301,54,1952.117,LESS,-734,3890,3156,4,1,-18,-1.687335229,18,1.571468165,-0.640053114,4.249388127,238,128,110,0,1.555712144,1.872800887,1.170500555,1.312145182,-0.336056654,0.336056654,1.170500555,1.872800887,0,1,0
81,1,82,8,50,58,0,1743.824,64,2343.446,LESS,-960,1426,466,2,1,8,0.749926769,8,-0.174607574,-0.125609888,-0.825925098,108,50,58,1,-1.037141429,-1.170500555,-0.858367073,-0.399348534,-0.610793834,0.610793834,-0.858367073,-1.170500555,1,0,0
82,1,83,4,54,50,0,2122.334,54,1286.756,LESS,-1186,1716,530,2,1,-4,-0.374963384,4,-0.87303787,-0.640053114,-0.517097204,104,54,50,0,-1.116921539,-1.014433814,-1.170500555,-0.399348534,-0.885531014,0.885531014,-1.170500555,-1.014433814,0,0,0
83,1,84,37,80,69,1,2518.011,84,2851.118,LESS,212,1776,1988,3,2,-11,-1.031149307,11,0.349215148,0.903276565,-0.194262683,149,80,69,0,-0.219395302,0,-0.429183537,0.456398324,0.813949417,0.813949417,-0.429183537,0,1,1,1
84,1,85,52,105,110,0,2201.475,64,1874.471,LESS,-944,1712,768,2,1,5,0.46870423,5,-0.698430296,-0.125609888,-0.452525731,215,105,110,1,1.096976512,0.975417129,1.170500555,-0.399348534,-0.591343414,0.591343414,1.170500555,0.975417129,1,0,0
85,1,86,5,55,50,0,2131.478,64,1083.81,LESS,-634,1302,668,2,1,-5,-0.46870423,5,-0.698430296,-0.125609888,-0.509636576,105,55,50,0,-1.096976512,-0.975417129,-1.170500555,-0.399348534,-0.21449153,0.21449153,-1.170500555,-0.975417129,1,0,1
86,1,87,30,96,80,0,2017.429,4,1183.942,LESS,-1858,2362,504,2,1,-16,-1.499853537,16,1.222253018,-3.212269245,-0.602689633,176,96,80,0,0.31912044,0.624266962,0,-0.399348534,-1.702448646,1.702448646,0,0.624266962,0,0,0
87,1,88,33,80,75,1,3241.381,64,1875.688,LESS,712,1180,1892,3,2,-5,-0.46870423,5,-0.698430296,-0.125609888,0.395937928,155,80,75,0,-0.099725137,0,-0.195083426,0.456398324,1.421775036,1.421775036,-0.195083426,0,1,1,1
88,1,89,48,110,128,0,2528.386,64,1824.788,LESS,-1444,2070,626,2,1,18,1.687335229,18,1.571468165,-0.125609888,-0.185797677,238,110,128,1,1.555712144,1.170500555,1.872800887,-0.399348534,-1.199169033,1.199169033,1.872800887,1.170500555,0,0,0
89,1,90,9,59,50,1,1679.873,64,1211.035,LESS,444,628,1072,1,2,-9,-0.843667615,9,0,-0.125609888,-0.878102986,109,59,50,0,-1.017196402,-0.819350388,-1.170500555,-1.255095392,1.095980504,1.095980504,-1.170500555,-0.819350388,0,0,1
90,1,91,44,110,119,0,1513.221,24,1929.333,LESS,-672,1086,414,2,1,9,0.843667615,9,0,-2.183382793,-1.014075051,229,110,119,1,1.376206896,1.170500555,1.521650721,-0.399348534,-0.260686278,0.260686278,1.521650721,1.170500555,0,0,0
91,1,92,2,52,50,1,3359.407,74,1520.963,LESS,974,1046,2020,3,2,-2,-0.187481692,2,-1.222253018,0.388833339,0.492235835,102,52,50,0,-1.156811594,-1.092467184,-1.170500555,0.456398324,1.74027566,1.74027566,-1.170500555,-1.092467184,1,1,1
92,1,93,8,58,50,0,3815.203,74,1109.56,LESS,-556,2110,1554,4,2,-8,-0.749926769,8,-0.174607574,0.388833339,0.8641217,108,58,50,0,-1.037141429,-0.858367073,-1.170500555,1.312145182,-0.119670734,0.119670734,-1.170500555,-0.858367073,1,1,1
93,1,94,44,119,110,0,4747.633,24,1125.921,LESS,98,2082,2180,4,1,-9,-0.843667615,9,0,-2.183382793,1.62489524,229,119,110,0,1.376206896,1.521650721,1.170500555,1.312145182,0.675365176,0.675365176,1.170500555,1.521650721,0,1,1
94,1,95,34,74,80,0,3013.624,100,1360.27,LESS,882,1144,2026,3,2,6,0.562445076,6,-0.523822722,1.726385727,0.210110038,154,74,80,1,-0.119670165,-0.234100111,0,0.456398324,1.628435746,1.628435746,0,-0.234100111,1,1,1
95,1,96,24,86,80,0,3695.847,74,2038.684,LESS,-376,2298,1922,5,2,-6,-0.562445076,6,-0.523822722,0.388833339,0.76673864,166,86,80,0,0.119670165,0.234100111,0,2.16789204,0.099146489,0.099146489,0,0.234100111,1,1,1
96,1,97,39,66,80,0,1818.684,74,1972.947,LESS,-730,1246,516,2,1,14,1.312371845,14,0.87303787,0.388833339,-0.76484651,146,66,80,1,-0.279230385,-0.546233592,0,-0.399348534,-0.331194049,0.331194049,0,-0.546233592,1,0,0
97,1,98,9,50,59,0,3040.837,74,1288.515,LESS,-1704,2296,592,2,2,9,0.843667615,9,0,0.388833339,0.232313239,109,50,59,1,-1.017196402,-1.170500555,-0.819350388,-0.399348534,-1.515238355,1.515238355,-0.819350388,-1.170500555,1,0,0
98,1,99,57,94,110,0,3156.807,100,1195.264,LESS,-1062,2242,1180,1,2,16,1.499853537,16,1.222253018,1.726385727,0.326933647,204,94,110,1,0.877581209,0.546233592,1.170500555,-1.255095392,-0.73479026,0.73479026,1.170500555,0.546233592,1,0,0
99,1,100,60,110,87,1,5926.643,94,1651.209,LESS,-950,3560,2610,3,2,-23,-2.15603946,23,2.444506035,1.417719791,2.586854435,197,110,87,0,0.737966017,1.170500555,0.273116796,0.456398324,-0.598637322,0.598637322,0.273116796,1.170500555,1,1,0
100,1,101,33,75,80,1,4156.099,94,1382.893,LESS,1626,1500,3126,3,2,5,0.46870423,5,-0.698430296,1.417719791,1.142260173,155,75,80,1,-0.099725137,-0.195083426,0,0.456398324,2.532880267,2.532880267,0,-0.195083426,1,1,1
101,1,102,15,50,45,1,2333.893,64,2767.159,LESS,-698,1704,1006,3,1,-5,-0.46870423,5,-0.698430296,-0.125609888,-0.34448533,95,50,45,0,-1.296426786,-1.170500555,-1.36558398,0.456398324,-0.29229321,0.29229321,-1.36558398,-1.170500555,0,1,0
102,1,103,59,89,110,0,2362.993,84,1411.212,LESS,966,832,1798,3,2,21,1.968557767,21,2.095290887,0.903276565,-0.320742519,199,89,110,1,0.777856072,0.351150166,1.170500555,0.456398324,1.73055045,1.73055045,1.170500555,0.351150166,1,1,1
103,1,104,29,80,94,0,1705.088,54,1625.992,LESS,-128,1012,884,1,1,14,1.312371845,14,0.87303787,-0.640053114,-0.857529962,174,80,94,1,0.279230385,0,0.546233592,-1.255095392,0.400627996,0.400627996,0.546233592,0,0,0,1
104,1,105,55,110,98,1,1720.385,64,1479.807,LESS,-840,1380,540,2,1,-12,-1.124890153,12,0.523822722,-0.125609888,-0.845049076,208,110,98,0,0.957361319,1.170500555,0.702300333,-0.399348534,-0.464915685,0.464915685,0.702300333,1.170500555,0,0,0
105,1,106,29,94,80,0,1728.218,24,1289.573,LESS,-586,1148,562,2,1,-14,-1.312371845,14,0.87303787,-2.183382793,-0.838658098,174,94,80,0,0.279230385,0.546233592,0,-0.399348534,-0.156140271,0.156140271,0,0.546233592,0,0,1
106,1,107,57,110,94,1,2498.348,64,1178.775,LESS,-44,1216,1172,3,2,-16,-1.499853537,16,1.222253018,-0.125609888,-0.210305807,204,110,94,0,0.877581209,1.170500555,0.546233592,0.456398324,0.5027427,0.5027427,0.546233592,1.170500555,0,1,1
107,1,108,39,80,66,1,3240.459,54,1331.467,LESS,664,1148,1812,3,2,-14,-1.312371845,14,0.87303787,-0.640053114,0.395185664,146,80,66,0,-0.279230385,0,-0.546233592,0.456398324,1.363423776,1.363423776,-0.546233592,0,0,1,1
108,1,109,4,50,54,1,2765.97,84,1498.413,LESS,538,1174,1712,3,2,4,0.374963384,4,-0.87303787,0.903276565,0.008048103,104,50,54,1,-1.116921539,-1.170500555,-1.014433814,0.456398324,1.21025172,1.21025172,-1.014433814,-1.170500555,1,1,1
109,1,110,55,98,110,1,2998.353,84,982.983,LESS,154,1404,1558,3,2,12,1.124890153,12,0.523822722,0.903276565,0.197650365,208,98,110,1,0.957361319,0.702300333,1.170500555,0.456398324,0.743441645,0.743441645,1.170500555,0.702300333,1,1,1
110,1,111,2,50,52,0,2079.715,54,1525.128,LESS,-808,1406,598,2,1,2,0.187481692,2,-1.222253018,-0.640053114,-0.551870225,102,50,52,1,-1.156811594,-1.170500555,-1.092467184,-0.399348534,-0.426014846,0.426014846,-1.092467184,-1.170500555,0,1,0
111,1,112,59,110,89,1,1666.103,64,1778.183,LESS,-742,1250,508,2,1,-21,-1.968557767,21,2.095290887,-0.125609888,-0.889337987,199,110,89,0,0.777856072,1.170500555,0.351150166,-0.399348534,-0.345781864,0.345781864,0.351150166,1.170500555,0,0,0
112,1,113,60,87,110,0,2426.928,64,901.849,LESS,-1404,1898,494,2,2,23,2.15603946,23,2.444506035,-0.125609888,-0.268577684,197,87,110,1,0.737966017,0.273116796,1.170500555,-0.399348534,-1.150542984,1.150542984,1.170500555,0.273116796,0,0,0
113,1,114,52,110,105,1,3263.299,74,903.194,LESS,-444,1734,1290,3,2,-5,-0.46870423,5,-0.698430296,0.388833339,0.413820916,215,110,105,0,1.096976512,1.170500555,0.975417129,0.456398324,0.016482205,0.016482205,0.975417129,1.170500555,1,1,1
114,1,115,30,80,96,0,1723.836,84,872.135,LESS,328,800,1128,2,2,16,1.499853537,16,1.222253018,0.903276565,-0.842233391,176,80,96,1,0.31912044,0,0.624266962,-0.399348534,0.95496496,0.95496496,0.624266962,0,1,0,1
115,1,116,24,80,86,0,1368.643,94,1116.496,LESS,1122,464,1586,1,2,6,0.562445076,6,-0.523822722,1.417719791,-1.132036846,166,80,86,1,0.119670165,0,0.234100111,-1.255095392,1.920192043,1.920192043,0.234100111,0,1,0,1
116,1,117,5,50,55,0,1990.443,74,1166.408,LESS,-670,1340,670,2,2,5,0.46870423,5,-0.698430296,0.388833339,-0.624707623,105,50,55,1,-1.096976512,-1.170500555,-0.975417129,-0.399348534,-0.258254975,0.258254975,-0.975417129,-1.170500555,1,0,0
117,1,118,34,80,74,0,2997.126,94,929.632,LESS,164,1510,1674,3,2,-6,-0.562445076,6,-0.523822722,1.417719791,0.196649251,154,80,74,0,-0.119670165,0,-0.234100111,0.456398324,0.755598157,0.755598157,-0.234100111,0,1,1,1
118,1,119,15,45,50,0,1573.53,54,1699.412,LESS,-4,802,798,2,1,5,0.46870423,5,-0.698430296,-0.640053114,-0.964868685,95,45,50,1,-1.296426786,-1.36558398,-1.170500555,-0.399348534,0.551368749,0.551368749,-1.170500555,-1.36558398,0,0,1
119,1,120,37,69,80,0,2306.153,64,1397.419,LESS,-982,1696,714,2,1,11,1.031149307,11,0.349215148,-0.125609888,-0.367118513,149,69,80,1,-0.219395302,-0.429183537,0,-0.399348534,-0.637538161,0.637538161,0,-0.429183537,1,0,0
120,1,121,48,128,110,0,1686.53,84,947.11,MORE,-156,1208,1052,2,2,-18,-1.687335229,18,1.571468165,0.903276565,-0.872671512,238,128,110,1,1.555712144,1.872800887,1.170500555,-0.399348534,0.366589761,0.366589761,1.170500555,1.872800887,1,1,1
121,1,122,8,50,58,1,2010.532,74,1007.719,MORE,10,942,952,3,2,8,0.749926769,8,-0.174607574,0.388833339,-0.608316924,108,50,58,0,-1.037141429,-1.170500555,-0.858367073,0.456398324,0.568387867,0.568387867,-0.858367073,-1.170500555,1,1,1
122,1,123,4,54,50,0,2244.929,64,1086.016,MORE,-1434,1996,562,2,1,-4,-0.374963384,4,-0.87303787,-0.125609888,-0.41707143,104,54,50,1,-1.116921539,-1.014433814,-1.170500555,-0.399348534,-1.187012521,1.187012521,-1.170500555,-1.014433814,0,1,0
123,1,124,37,80,69,0,2092.94,74,1731.996,MORE,-848,1684,836,3,1,-11,-1.031149307,11,0.349215148,0.388833339,-0.541079892,149,80,69,1,-0.219395302,0,-0.429183537,0.456398324,-0.474640895,0.474640895,-0.429183537,0,1,1,0
124,1,125,52,105,110,1,1361.319,94,676.792,MORE,628,574,1202,1,2,5,0.46870423,5,-0.698430296,1.417719791,-1.138012528,215,105,110,0,1.096976512,0.975417129,1.170500555,-1.255095392,1.319660332,1.319660332,1.170500555,0.975417129,1,0,1
125,1,126,5,55,50,1,1596.589,74,931.733,MORE,866,616,1482,1,2,-5,-0.46870423,5,-0.698430296,0.388833339,-0.946054751,105,55,50,1,-1.096976512,-0.975417129,-1.170500555,-1.255095392,1.608985326,1.608985326,-1.170500555,-0.975417129,1,0,1
126,1,127,30,96,80,0,2850.121,74,1650.773,MORE,-1778,2456,678,2,1,-16,-1.499853537,16,1.222253018,0.388833339,0.076707256,176,96,80,1,0.31912044,0.624266962,0,-0.399348534,-1.605196547,1.605196547,0,0.624266962,1,1,0
127,1,128,33,80,75,1,1380.897,94,1098.922,MORE,560,530,1090,1,2,-5,-0.46870423,5,-0.698430296,1.417719791,-1.122038756,155,80,75,1,-0.099725137,0,-0.195083426,-1.255095392,1.236996047,1.236996047,-0.195083426,0,1,0,1
128,1,129,48,110,128,1,1391.672,64,1794.924,MORE,-234,1162,928,1,1,18,1.687335229,18,1.571468165,-0.125609888,-1.113247389,238,110,128,0,1.555712144,1.170500555,1.872800887,-1.255095392,0.271768965,0.271768965,1.872800887,1.170500555,0,0,1
129,1,130,9,59,50,0,2101.903,74,1239.822,MORE,-990,1578,588,2,1,-9,-0.843667615,9,0,0.388833339,-0.533766943,109,59,50,1,-1.017196402,-0.819350388,-1.170500555,-0.399348534,-0.647263371,0.647263371,-1.170500555,-0.819350388,1,1,0
130,1,131,44,110,119,1,1582.34,54,1258.389,MORE,28,826,854,1,2,9,0.843667615,9,0,-0.640053114,-0.957680569,229,110,119,0,1.376206896,1.170500555,1.521650721,-1.255095392,0.590269589,0.590269589,1.521650721,1.170500555,0,0,1
131,1,132,2,52,50,0,2320.312,74,1463.68,MORE,-1118,1626,508,2,1,-2,-0.187481692,2,-1.222253018,0.388833339,-0.355566125,102,52,50,1,-1.156811594,-1.092467184,-1.170500555,-0.399348534,-0.80286673,0.80286673,-1.170500555,-1.092467184,1,1,0
132,1,133,8,58,50,0,2184.782,64,1365.006,MORE,-572,1342,770,2,1,-8,-0.749926769,8,-0.174607574,-0.125609888,-0.46614562,108,58,50,1,-1.037141429,-0.858367073,-1.170500555,-0.399348534,-0.139121154,0.139121154,-1.170500555,-0.858367073,0,1,0
133,1,134,44,119,110,0,2602.684,24,1035.977,MORE,-1200,2076,876,2,1,-9,-0.843667615,9,0,-2.183382793,-0.125177628,229,119,110,1,1.376206896,1.521650721,1.170500555,-0.399348534,-0.902550131,0.902550131,1.170500555,1.521650721,0,1,0
134,1,135,34,74,80,1,2890.742,64,1896.005,MORE,-574,1792,1218,3,1,6,0.562445076,6,-0.523822722,-0.125609888,0.1098501,154,74,80,0,-0.119670165,-0.234100111,0,0.456398324,-0.141552456,0.141552456,0,-0.234100111,0,1,0
135,1,136,24,86,80,1,1954.547,84,1049.551,MORE,274,1024,1298,1,2,-6,-0.562445076,6,-0.523822722,0.903276565,-0.65399532,166,86,80,1,0.119670165,0.234100111,0,-1.255095392,0.889319793,0.889319793,0,0.234100111,1,0,1
136,1,137,39,66,80,1,1901.984,64,1813.237,MORE,124,1098,1222,1,1,14,1.312371845,14,0.87303787,-0.125609888,-0.696881692,146,66,80,0,-0.279230385,-0.546233592,0,-1.255095392,0.706972108,0.706972108,0,-0.546233592,0,0,1
137,1,138,9,50,59,1,3133.506,44,953.615,MORE,-398,1646,1248,3,1,9,0.843667615,9,0,-1.15449634,0.307922264,109,50,59,0,-1.017196402,-1.170500555,-0.819350388,0.456398324,0.072402162,0.072402162,-0.819350388,-1.170500555,0,1,0
138,1,139,57,94,110,1,2545.418,64,2154.544,MORE,336,1248,1584,3,2,16,1.499853537,16,1.222253018,-0.125609888,-0.171901197,204,94,110,0,0.877581209,0.546233592,1.170500555,0.456398324,0.96469017,0.96469017,1.170500555,0.546233592,0,1,1
139,1,140,60,110,87,0,2023.468,74,1120.839,MORE,-952,1604,652,2,2,-23,-2.15603946,23,2.444506035,0.388833339,-0.597762387,197,110,87,1,0.737966017,1.170500555,0.273116796,-0.399348534,-0.601068624,0.601068624,0.273116796,1.170500555,1,1,0
140,1,141,33,75,80,1,3330.755,84,846.965,MORE,430,1490,1920,3,2,5,0.46870423,5,-0.698430296,0.903276565,0.468858549,155,75,80,0,-0.099725137,-0.195083426,0,0.456398324,1.078961387,1.078961387,0,-0.195083426,1,1,1
141,1,142,15,50,45,0,1866.57,54,2507.707,MORE,-1126,1720,594,2,1,-5,-0.46870423,5,-0.698430296,-0.640053114,-0.725776122,95,50,45,1,-1.296426786,-1.170500555,-1.36558398,-0.399348534,-0.81259194,0.81259194,-1.36558398,-1.170500555,0,1,0
142,1,143,59,89,110,1,1604.858,74,1110.665,MORE,294,784,1078,1,2,21,1.968557767,21,2.095290887,0.388833339,-0.939308039,199,89,110,0,0.777856072,0.351150166,1.170500555,-1.255095392,0.913632818,0.913632818,1.170500555,0.351150166,1,0,1
143,1,144,29,80,94,1,2458.127,70,1505.018,MORE,838,1266,2104,3,2,14,1.312371845,14,0.87303787,0.183056048,-0.24312229,174,80,94,0,0.279230385,0,0.546233592,0.456398324,1.574947092,1.574947092,0.546233592,0,0,1,1
144,1,145,55,110,98,0,4970.636,64,2027.965,MORE,-1374,2898,1524,4,1,-12,-1.124890153,12,0.523822722,-0.125609888,1.806844321,208,110,98,1,0.957361319,1.170500555,0.702300333,1.312145182,-1.114073446,1.114073446,0.702300333,1.170500555,0,1,0
145,1,146,29,94,80,0,3115.157,64,1281.616,MORE,-1762,2416,654,2,1,-14,-1.312371845,14,0.87303787,-0.125609888,0.292951238,174,94,80,1,0.279230385,0.546233592,0,-0.399348534,-1.585746127,1.585746127,0,0.546233592,0,1,0
146,1,147,57,110,94,0,3128.098,64,1306.006,MORE,-1426,2218,792,2,1,-16,-1.499853537,16,1.222253018,-0.125609888,0.303509854,204,110,94,1,0.877581209,1.170500555,0.546233592,-0.399348534,-1.177287311,1.177287311,0.546233592,1.170500555,0,0,0
147,1,148,39,80,66,0,3745.136,80,1356.805,MORE,-1382,2860,1478,2,2,-14,-1.312371845,14,0.87303787,0.697499274,0.806953741,146,80,66,1,-0.279230385,0,-0.546233592,-0.399348534,-1.123798656,1.123798656,-0.546233592,0,1,0,0
148,1,149,4,50,54,1,3673.352,64,1957.847,MORE,-686,2190,1504,3,1,4,0.374963384,4,-0.87303787,-0.125609888,0.748384875,104,50,54,0,-1.116921539,-1.170500555,-1.014433814,0.456398324,-0.277705395,0.277705395,-1.014433814,-1.170500555,0,1,0
149,1,150,55,98,110,1,4942.765,74,1805.4,MORE,-1618,3112,1494,2,2,12,1.124890153,12,0.523822722,0.388833339,1.784104256,208,98,110,0,0.957361319,0.702300333,1.170500555,-0.399348534,-1.410692349,1.410692349,1.170500555,0.702300333,1,0,0
150,1,151,2,50,52,0,2224.593,74,1510.151,MORE,-1022,1600,578,2,1,2,0.187481692,2,-1.222253018,0.388833339,-0.433663658,102,50,52,0,-1.156811594,-1.170500555,-1.092467184,-0.399348534,-0.686164211,0.686164211,-1.092467184,-1.170500555,1,0,0
151,1,152,59,110,89,1,2997.098,4,1262.236,MORE,-2028,3020,992,2,1,-21,-1.968557767,21,2.095290887,-3.212269245,0.196626405,199,110,89,1,0.777856072,1.170500555,0.351150166,-0.399348534,-1.909109356,1.909109356,0.351150166,1.170500555,0,0,0
152,1,153,60,87,110,1,1391.738,84,1035.328,MORE,460,696,1156,1,2,23,2.15603946,23,2.444506035,0.903276565,-1.113193539,197,87,110,0,0.737966017,0.273116796,1.170500555,-1.255095392,1.115430924,1.115430924,1.170500555,0.273116796,1,0,1
153,1,154,52,110,105,0,3340.985,100,835.78,MORE,-940,2234,1294,2,2,-5,-0.46870423,5,-0.698430296,1.726385727,0.477205248,215,110,105,1,1.096976512,1.170500555,0.975417129,-0.399348534,-0.586480809,0.586480809,0.975417129,1.170500555,1,0,0
154,1,155,30,80,96,1,1648.785,84,747.819,MORE,48,970,1018,1,2,16,1.499853537,16,1.222253018,0.903276565,-0.903467816,176,80,96,0,0.31912044,0,0.624266962,-1.255095392,0.614582614,0.614582614,0.624266962,0,1,0,1
155,1,156,24,80,86,0,1990.089,44,1589.569,MORE,-1548,2114,566,2,1,6,0.562445076,6,-0.523822722,-1.15449634,-0.624996453,166,80,86,0,0.119670165,0,0.234100111,-0.399348534,-1.325596762,1.325596762,0.234100111,0,0,0,0
156,1,157,5,50,55,1,2490.532,74,893.86,MORE,362,1096,1458,2,2,5,0.46870423,5,-0.698430296,0.388833339,-0.216682915,105,50,55,0,-1.096976512,-1.170500555,-0.975417129,-0.399348534,0.996297102,0.996297102,-0.975417129,-1.170500555,1,0,1
157,1,158,34,80,74,0,2508.017,64,2009.535,MORE,-1012,1672,660,2,1,-6,-0.562445076,6,-0.523822722,-0.125609888,-0.20241683,154,80,74,1,-0.119670165,0,-0.234100111,-0.399348534,-0.674007698,0.674007698,-0.234100111,0,0,0,0
158,1,159,15,45,50,1,2293.524,64,2147.895,MORE,-302,1312,1010,3,1,5,0.46870423,5,-0.698430296,-0.125609888,-0.377422566,95,45,50,0,-1.296426786,-1.36558398,-1.170500555,0.456398324,0.18910468,0.18910468,-1.170500555,-1.36558398,0,1,0
159,1,160,37,69,80,1,3004.818,24,800.012,MORE,-898,1828,930,3,2,11,1.031149307,11,0.349215148,-2.183382793,0.202925186,149,69,80,0,-0.219395302,-0.429183537,0,0.456398324,-0.535423457,0.535423457,0,-0.429183537,0,1,0
160,1,161,3,50,53,0,2773.406,54,1318.667,LESS,-514,1546,1032,4,1,3,0.281222538,3,-1.047645444,-0.640053114,0.014115166,103,50,53,1,-1.136866566,-1.170500555,-1.053450499,1.312145182,-0.068613382,0.068613382,-1.053450499,-1.170500555,0,1,1
161,1,162,20,50,40,1,2122.486,84,813.427,LESS,986,646,1632,1,2,-10,-0.937408461,10,0.174607574,0.903276565,-0.516973187,90,50,40,0,-1.396151924,-1.170500555,-1.560667406,-1.255095392,1.754863475,1.754863475,-1.560667406,-1.170500555,1,0,1
162,1,163,25,80,88,0,1541.291,64,889.138,LESS,-644,1088,444,2,1,8,0.749926769,8,-0.174607574,-0.125609888,-0.99117262,168,80,88,1,0.15956022,0,0.312133481,-0.399348534,-0.226648043,0.226648043,0.312133481,0,0,0,1
163,1,164,42,115,110,0,1792.184,4,970.264,LESS,-1446,1990,544,2,1,-5,-0.46870423,5,-0.698430296,-3.212269245,-0.786467971,225,115,110,0,1.296426786,1.36558398,1.170500555,-0.399348534,-1.201600336,1.201600336,1.170500555,1.36558398,0,0,0
164,1,165,53,103,110,0,1719.123,54,1986.11,LESS,-1332,1834,502,2,1,7,0.656185922,7,-0.349215148,-0.640053114,-0.846078747,213,103,110,1,1.057086457,0.897383758,1.170500555,-0.399348534,-1.063016095,1.063016095,1.170500555,0.897383758,0,0,0
165,1,166,26,90,80,1,5485.479,4,2758.424,LESS,-1090,3638,2548,4,1,-10,-0.937408461,10,0.174607574,-3.212269245,2.22690688,170,90,80,0,0.199450275,0.390166852,0,1.312145182,-0.768828495,0.768828495,0,0.390166852,0,1,0
166,1,167,35,80,72,1,4941.353,74,1431.467,LESS,-784,2636,1852,5,2,-8,-0.749926769,8,-0.174607574,0.388833339,1.782952199,152,80,72,0,-0.15956022,0,-0.312133481,2.16789204,-0.396839216,0.396839216,-0.312133481,0,1,1,0
167,1,168,28,93,80,1,1580.206,64,2648.327,LESS,-650,1388,738,3,1,-13,-1.218630999,13,0.698430296,-0.125609888,-0.959421709,173,93,80,0,0.259285357,0.507216907,0,0.456398324,-0.23394195,0.23394195,0,0.507216907,0,1,1
168,1,169,26,80,90,0,3148.962,64,1415.512,LESS,-82,1546,1464,4,1,10,0.937408461,10,0.174607574,-0.125609888,0.320532879,170,80,90,1,0.199450275,0,0.390166852,1.312145182,0.456547953,0.456547953,0.390166852,0,0,1,1
169,1,170,25,88,80,1,2129.2,64,1067.862,LESS,-166,1114,948,3,2,-8,-0.749926769,8,-0.174607574,-0.125609888,-0.511495206,168,88,80,0,0.15956022,0.312133481,0,0.456398324,0.354433249,0.354433249,0,0.312133481,0,1,1
170,1,171,36,80,70,0,1528.68,44,1224.553,LESS,-974,1490,516,2,1,-10,-0.937408461,10,0.174607574,-1.15449634,-1.001461988,150,80,70,0,-0.199450275,0,-0.390166852,-0.399348534,-0.627812951,0.627812951,-0.390166852,0,0,0,0
171,1,172,28,80,93,0,1442.214,94,877.346,LESS,284,786,1070,2,2,13,1.218630999,13,0.698430296,1.417719791,-1.072009959,173,80,93,1,0.259285357,0,0.507216907,-0.399348534,0.901476306,0.901476306,0.507216907,0,1,0,1
172,1,173,21,82,80,0,1628.017,34,1046.34,LESS,-990,1626,636,2,1,-2,-0.187481692,2,-1.222253018,-1.668939567,-0.920412514,162,82,80,0,0.039890055,0.07803337,0,-0.399348534,-0.647263371,0.647263371,0,0.07803337,0,0,0
173,1,174,19,50,41,1,2346.231,64,2004.1,LESS,-230,1232,1002,3,2,-9,-0.843667615,9,0,-0.125609888,-0.334418705,91,50,41,0,-1.376206896,-1.170500555,-1.521650721,0.456398324,0.27663157,0.27663157,-1.521650721,-1.170500555,0,1,1
174,1,175,56,96,110,0,3316.339,74,1293.82,LESS,-750,2054,1304,4,1,14,1.312371845,14,0.87303787,0.388833339,0.457096474,206,96,110,1,0.917471264,0.624266962,1.170500555,1.312145182,-0.355507074,0.355507074,1.170500555,0.624266962,1,1,0
175,1,176,23,80,85,0,3031.183,74,1120.025,LESS,-868,1766,898,1,1,5,0.46870423,5,-0.698430296,0.388833339,0.2244365,165,80,85,1,0.099725137,0,0.195083426,-1.255095392,-0.49895392,0.49895392,0.195083426,0,1,0,0
176,1,177,10,60,50,0,2266.764,64,1075.631,LESS,-902,1552,650,2,1,-10,-0.937408461,10,0.174607574,-0.125609888,-0.399256163,110,60,50,0,-0.997251374,-0.780333703,-1.170500555,-0.399348534,-0.540286062,0.540286062,-1.170500555,-0.780333703,1,0,0
177,1,178,19,41,50,0,1321.42,100,742.828,LESS,546,722,1268,3,2,9,0.843667615,9,0,1.726385727,-1.17056629,91,41,50,1,-1.376206896,-1.521650721,-1.170500555,0.456398324,1.21997693,1.21997693,-1.170500555,-1.521650721,1,1,1
178,1,179,56,110,96,1,2265.431,64,1102.483,LESS,-918,1634,716,3,2,-14,-1.312371845,14,0.87303787,-0.125609888,-0.400343763,206,110,96,0,0.917471264,1.170500555,0.624266962,0.456398324,-0.559736482,0.559736482,0.624266962,1.170500555,1,1,0
179,1,180,35,72,80,0,4164.13,64,1025.624,LESS,-510,2232,1722,4,1,8,0.749926769,8,-0.174607574,-0.125609888,1.1488127,152,72,80,1,-0.15956022,-0.312133481,0,1.312145182,-0.063750777,0.063750777,0,-0.312133481,0,1,1
180,1,181,11,49,50,0,2726.392,54,1155.84,LESS,-1320,2026,706,2,1,1,0.093740846,1,-1.396860592,-0.640053114,-0.024243753,99,49,50,1,-1.216646676,-1.20951724,-1.170500555,-0.399348534,-1.04842828,1.04842828,-1.170500555,-1.20951724,0,0,0
181,1,182,17,43,50,1,2464.949,84,739.11,LESS,-436,1472,1036,2,2,7,0.656185922,7,-0.349215148,0.903276565,-0.237556191,93,43,50,1,-1.336316841,-1.443617351,-1.170500555,-0.399348534,0.026207415,0.026207415,-1.170500555,-1.443617351,1,0,1
182,1,183,1,51,50,1,1844.314,74,1503.046,LESS,86,920,1006,1,2,-1,-0.093740846,1,-1.396860592,0.388833339,-0.743934886,101,51,50,0,-1.176756621,-1.131483869,-1.170500555,-1.255095392,0.660777361,0.660777361,-1.170500555,-1.131483869,1,0,1
183,1,184,41,112,110,1,4667.099,84,1290.065,LESS,802,1590,2392,4,2,-2,-0.187481692,2,-1.222253018,0.903276565,1.559187212,222,112,110,0,1.236591704,1.248533925,1.170500555,1.312145182,1.531183647,1.531183647,1.170500555,1.248533925,1,1,1
184,1,185,20,40,50,0,3192.227,80,1272.118,LESS,-358,1968,1610,2,2,10,0.937408461,10,0.174607574,0.697499274,0.355832973,90,40,50,1,-1.396151924,-1.560667406,-1.170500555,-0.399348534,0.121028211,0.121028211,-1.170500555,-1.560667406,1,0,1
185,1,186,1,50,51,0,2169.18,74,1218.199,LESS,-926,1538,612,2,1,1,0.093740846,1,-1.396860592,0.388833339,-0.478875357,101,50,51,1,-1.176756621,-1.170500555,-1.131483869,-0.399348534,-0.569461692,0.569461692,-1.131483869,-1.170500555,1,0,0
186,1,187,23,85,80,1,2349.446,74,2338.112,LESS,-870,1736,866,3,1,-5,-0.46870423,5,-0.698430296,0.388833339,-0.331795573,165,85,80,0,0.099725137,0.195083426,0,0.456398324,-0.501385223,0.501385223,0,0.195083426,1,1,0
187,1,188,11,50,49,0,3171.303,84,1148.621,LESS,-824,2006,1182,4,2,-1,-0.093740846,1,-1.396860592,0.903276565,0.338760994,99,50,49,0,-1.216646676,-1.170500555,-1.20951724,1.312145182,-0.445465266,0.445465266,-1.20951724,-1.170500555,1,1,0
188,1,189,17,50,43,0,2993.885,84,824.794,LESS,-1362,2340,978,2,2,-7,-0.656185922,7,-0.349215148,0.903276565,0.194004905,93,50,43,0,-1.336316841,-1.170500555,-1.443617351,-0.399348534,-1.099485632,1.099485632,-1.443617351,-1.170500555,1,0,0
189,1,190,21,80,82,0,2046.197,74,1904.786,LESS,-1160,1766,606,2,1,2,0.187481692,2,-1.222253018,0.388833339,-0.579217701,162,80,82,1,0.039890055,0,0.07803337,-0.399348534,-0.853924082,0.853924082,0.07803337,0,1,0,0
190,1,191,10,50,60,0,2000.771,84,944.253,LESS,-698,1600,902,2,2,10,0.937408461,10,0.174607574,0.903276565,-0.616280965,110,50,60,1,-0.997251374,-1.170500555,-0.780333703,-0.399348534,-0.29229321,0.29229321,-0.780333703,-1.170500555,1,0,0
191,1,192,3,53,50,1,3949.34,0,1103.534,LESS,-1192,2932,1740,4,1,-3,-0.281222538,3,-1.047645444,-3.418046536,0.97356464,103,53,50,0,-1.136866566,-1.053450499,-1.170500555,1.312145182,-0.892824921,0.892824921,-1.170500555,-1.053450499,0,1,0
192,1,193,45,122,110,1,2302.897,64,1668.531,LESS,-954,1710,756,3,2,-12,-1.124890153,12,0.523822722,-0.125609888,-0.369775097,232,122,110,0,1.436041979,1.638700776,1.170500555,0.456398324,-0.603499927,0.603499927,1.170500555,1.638700776,0,1,0
193,1,194,38,67,80,0,1967.521,64,1759.361,LESS,-996,1610,614,2,1,13,1.218630999,13,0.698430296,-0.125609888,-0.643409779,147,67,80,1,-0.259285357,-0.507216907,0,-0.399348534,-0.654557279,0.654557279,0,-0.507216907,0,0,0
194,1,195,38,80,67,0,5436.005,64,1471.998,LESS,-1502,3344,1842,3,2,-13,-1.218630999,13,0.698430296,-0.125609888,2.186540837,147,80,67,0,-0.259285357,0,-0.507216907,0.456398324,-1.269676805,1.269676805,-0.507216907,0,0,1,0
195,1,196,36,70,80,0,1555.042,74,1102.927,LESS,-608,1266,658,2,2,10,0.937408461,10,0.174607574,0.388833339,-0.979953122,150,70,80,1,-0.199450275,-0.390166852,0,-0.399348534,-0.182884598,0.182884598,0,-0.390166852,1,0,1
196,1,197,45,110,122,0,1991.723,74,1501.471,LESS,-158,1348,1190,2,2,12,1.124890153,12,0.523822722,0.388833339,-0.623663266,232,110,122,1,1.436041979,1.170500555,1.638700776,-0.399348534,0.364158459,0.364158459,1.638700776,1.170500555,1,0,1
197,1,198,42,110,115,0,3401.665,74,1125.329,LESS,-676,1924,1248,4,1,5,0.46870423,5,-0.698430296,0.388833339,0.526714314,225,110,115,1,1.296426786,1.170500555,1.36558398,1.312145182,-0.265548882,0.265548882,1.36558398,1.170500555,1,1,0
198,1,199,41,110,112,1,4202.816,74,712.398,LESS,-930,2248,1318,2,2,2,0.187481692,2,-1.222253018,0.388833339,1.180376769,222,110,112,1,1.236591704,1.170500555,1.248533925,-0.399348534,-0.574324297,0.574324297,1.248533925,1.170500555,1,0,0
199,1,200,53,110,103,1,2110.906,44,1689.99,LESS,-212,1486,1274,4,1,-7,-0.656185922,7,-0.349215148,-1.15449634,-0.526421357,213,110,103,0,1.057086457,1.170500555,0.897383758,1.312145182,0.298513292,0.298513292,0.897383758,1.170500555,0,1,1
200,1,201,3,50,53,1,3496.366,84,432.927,MORE,538,1100,1638,3,1,3,0.281222538,3,-1.047645444,0.903276565,0.603981257,103,50,53,0,-1.136866566,-1.170500555,-1.053450499,0.456398324,1.21025172,1.21025172,-1.053450499,-1.170500555,1,1,1
201,1,202,20,50,40,1,2849.513,44,1664.501,MORE,-398,1728,1330,4,1,-10,-0.937408461,10,0.174607574,-1.15449634,0.076211186,90,50,40,1,-1.396151924,-1.170500555,-1.560667406,1.312145182,0.072402162,0.072402162,-1.560667406,-1.170500555,0,1,0
202,1,203,25,80,88,1,1540.393,84,738.904,MORE,704,510,1214,1,2,8,0.749926769,8,-0.174607574,0.903276565,-0.991905302,168,80,88,0,0.15956022,0,0.312133481,-1.255095392,1.412049826,1.412049826,0.312133481,0,1,0,1
203,1,204,42,115,110,0,2342.863,94,908.769,MORE,-424,1676,1252,2,2,-5,-0.46870423,5,-0.698430296,1.417719791,-0.33716667,225,115,110,1,1.296426786,1.36558398,1.170500555,-0.399348534,0.040795229,0.040795229,1.170500555,1.36558398,1,0,0
204,1,205,53,103,110,1,2502.521,74,987.566,MORE,734,1164,1898,3,2,7,0.656185922,7,-0.349215148,0.388833339,-0.206901039,213,103,110,0,1.057086457,0.897383758,1.170500555,0.456398324,1.448519363,1.448519363,1.170500555,0.897383758,1,1,1
205,1,206,26,90,80,0,1799.627,74,1023.062,MORE,-412,1320,908,2,2,-10,-0.937408461,10,0.174607574,0.388833339,-0.780395196,170,90,80,1,0.199450275,0.390166852,0,-0.399348534,0.055383044,0.055383044,0,0.390166852,1,1,0
206,1,207,35,80,72,1,5352.23,74,1152.651,MORE,-1290,3068,1778,3,2,-8,-0.749926769,8,-0.174607574,0.388833339,2.118188463,152,80,72,1,-0.15956022,0,-0.312133481,0.456398324,-1.011958743,1.011958743,-0.312133481,0,1,1,0
207,1,208,28,93,80,0,2424.21,54,2050.051,MORE,-1682,2104,422,2,1,-13,-1.218630999,13,0.698430296,-0.640053114,-0.270795312,173,93,80,1,0.259285357,0.507216907,0,-0.399348534,-1.488494028,1.488494028,0,0.507216907,0,0,0
208,1,209,26,80,90,1,1269.404,94,2162.822,MORE,620,850,1470,1,2,10,0.937408461,10,0.174607574,1.417719791,-1.213006362,170,80,90,0,0.199450275,0,0.390166852,-1.255095392,1.309935122,1.309935122,0.390166852,0,1,0,1
209,1,210,25,88,80,0,2779.274,64,1320.794,MORE,154,1314,1468,4,1,-8,-0.749926769,8,-0.174607574,-0.125609888,0.018902892,168,88,80,1,0.15956022,0.312133481,0,1.312145182,0.743441645,0.743441645,0,0.312133481,0,1,1
210,1,211,36,80,70,0,2537.132,74,992.259,MORE,-1214,1742,528,2,1,-10,-0.937408461,10,0.174607574,0.388833339,-0.178661779,150,80,70,1,-0.199450275,0,-0.390166852,-0.399348534,-0.919569248,0.919569248,-0.390166852,0,1,0,0
211,1,212,28,80,93,1,2351.272,54,1543.057,MORE,124,1088,1212,3,2,13,1.218630999,13,0.698430296,-0.640053114,-0.330305732,173,80,93,0,0.259285357,0,0.507216907,0.456398324,0.706972108,0.706972108,0.507216907,0,0,1,1
212,1,213,21,82,80,0,2358.716,64,1835.591,MORE,-798,1616,818,2,1,-2,-0.187481692,2,-1.222253018,-0.125609888,-0.324232141,162,82,80,1,0.039890055,0.07803337,0,-0.399348534,-0.413858333,0.413858333,0,0.07803337,0,0,0
213,1,214,19,50,41,0,2684.724,94,777.501,MORE,-130,1620,1490,4,2,-9,-0.843667615,9,0,1.417719791,-0.058240849,91,50,41,1,-1.376206896,-1.170500555,-1.521650721,1.312145182,0.398196693,0.398196693,-1.521650721,-1.170500555,1,1,1
214,1,215,56,96,110,1,1983.477,54,1333.025,MORE,-206,1164,958,3,2,14,1.312371845,14,0.87303787,-0.640053114,-0.630391212,206,96,110,0,0.917471264,0.624266962,1.170500555,0.456398324,0.305807199,0.305807199,1.170500555,0.624266962,0,1,1
215,1,216,23,80,85,1,4650.79,74,1294.437,MORE,-186,2200,2014,3,2,5,0.46870423,5,-0.698430296,0.388833339,1.545880631,165,80,85,0,0.099725137,0,0.195083426,0.456398324,0.330120224,0.330120224,0.195083426,0,1,1,1
216,1,217,10,60,50,0,3835.065,74,1112.861,MORE,-1362,2464,1102,4,1,-10,-0.937408461,10,0.174607574,0.388833339,0.880327189,110,60,50,1,-0.997251374,-0.780333703,-1.170500555,1.312145182,-1.099485632,1.099485632,-1.170500555,-0.780333703,1,1,0
217,1,218,19,41,50,1,3849.206,74,1285.45,MORE,-844,2306,1462,3,2,9,0.843667615,9,0,0.388833339,0.89186489,91,41,50,0,-1.376206896,-1.521650721,-1.170500555,0.456398324,-0.46977829,0.46977829,-1.170500555,-1.521650721,1,1,0
218,1,219,56,110,96,0,3243.343,94,856.525,MORE,-1114,2346,1232,2,2,-14,-1.312371845,14,0.87303787,1.417719791,0.397538732,206,110,96,1,0.917471264,1.170500555,0.624266962,-0.399348534,-0.798004125,0.798004125,0.624266962,1.170500555,1,0,0
219,1,220,35,72,80,1,1644.584,74,911.53,MORE,-192,954,762,1,2,8,0.749926769,8,-0.174607574,0.388833339,-0.906895429,152,72,80,0,-0.15956022,-0.312133481,0,-1.255095392,0.322826317,0.322826317,0,-0.312133481,1,0,1
220,1,221,11,49,50,1,1274.981,84,1153.684,MORE,798,452,1250,1,2,1,0.093740846,1,-1.396860592,0.903276565,-1.208456064,99,49,50,0,-1.216646676,-1.20951724,-1.170500555,-1.255095392,1.526321042,1.526321042,-1.170500555,-1.20951724,1,0,1
221,1,222,17,43,50,1,2589.055,84,1447.478,MORE,1496,1084,2580,3,2,7,0.656185922,7,-0.349215148,0.903276565,-0.136297586,93,43,50,0,-1.336316841,-1.443617351,-1.170500555,0.456398324,2.374845606,2.374845606,-1.170500555,-1.443617351,1,1,1
222,1,223,1,51,50,0,2300.565,64,1864.028,MORE,-1120,1764,644,2,1,-1,-0.093740846,1,-1.396860592,-0.125609888,-0.371677785,101,51,50,1,-1.176756621,-1.131483869,-1.170500555,-0.399348534,-0.805298032,0.805298032,-1.170500555,-1.131483869,0,0,0
223,1,224,41,112,110,0,2922.026,84,666.538,MORE,-1002,1912,910,2,2,-2,-0.187481692,2,-1.222253018,0.903276565,0.135374846,222,112,110,1,1.236591704,1.248533925,1.170500555,-0.399348534,-0.661851186,0.661851186,1.170500555,1.248533925,1,0,0
224,1,225,20,40,50,1,1135.847,64,1704.19,MORE,478,398,876,1,2,10,0.937408461,10,0.174607574,-0.125609888,-1.321976077,90,40,50,0,-1.396151924,-1.560667406,-1.170500555,-1.255095392,1.137312646,1.137312646,-1.170500555,-1.560667406,0,0,1
225,1,226,1,50,51,1,1991.672,74,1875.281,MORE,104,964,1068,3,2,1,0.093740846,1,-1.396860592,0.388833339,-0.623704877,101,50,51,0,-1.176756621,-1.170500555,-1.131483869,0.456398324,0.682659083,0.682659083,-1.131483869,-1.170500555,1,1,1
226,1,227,23,85,80,0,1851.808,94,874.096,MORE,-572,1508,936,2,2,-5,-0.46870423,5,-0.698430296,1.417719791,-0.7378205,165,85,80,1,0.099725137,0.195083426,0,-0.399348534,-0.139121154,0.139121154,0,0.195083426,1,0,0
227,1,228,11,50,49,1,1321.034,64,1625.473,MORE,170,582,752,1,2,-1,-0.093740846,1,-1.396860592,-0.125609888,-1.170881229,99,50,49,1,-1.216646676,-1.170500555,-1.20951724,-1.255095392,0.762892065,0.762892065,-1.20951724,-1.170500555,0,0,1
228,1,229,17,50,43,1,4003.124,84,710.547,MORE,-558,2450,1892,5,2,-7,-0.656185922,7,-0.349215148,0.903276565,1.01744723,93,50,43,1,-1.336316841,-1.170500555,-1.443617351,2.16789204,-0.122102036,0.122102036,-1.443617351,-1.170500555,1,1,0
229,1,230,21,80,82,0,1954.281,64,1126.757,MORE,-966,1518,552,2,1,2,0.187481692,2,-1.222253018,-0.125609888,-0.65421235,162,80,82,0,0.039890055,0,0.07803337,-0.399348534,-0.618087741,0.618087741,0.07803337,0,0,0,0
230,1,231,10,50,60,1,2030.128,84,954.748,MORE,644,914,1558,3,2,10,0.937408461,10,0.174607574,0.903276565,-0.592328466,110,50,60,0,-0.997251374,-1.170500555,-0.780333703,0.456398324,1.339110751,1.339110751,-0.780333703,-1.170500555,1,1,1
231,1,232,3,53,50,0,1964.125,74,876.316,MORE,-798,1458,660,2,2,-3,-0.281222538,3,-1.047645444,0.388833339,-0.64618059,103,53,50,1,-1.136866566,-1.053450499,-1.170500555,-0.399348534,-0.413858333,0.413858333,-1.170500555,-1.053450499,1,0,0
232,1,233,45,122,110,0,2014.069,34,984.045,MORE,-1062,1572,510,2,1,-12,-1.124890153,12,0.523822722,-1.668939567,-0.605431071,232,122,110,1,1.436041979,1.638700776,1.170500555,-0.399348534,-0.73479026,0.73479026,1.170500555,1.638700776,0,0,0
233,1,234,38,67,80,1,1598.829,64,1315.51,MORE,160,694,854,1,2,13,1.218630999,13,0.698430296,-0.125609888,-0.944227125,147,67,80,0,-0.259285357,-0.507216907,0,-1.255095392,0.750735552,0.750735552,0,-0.507216907,0,0,1
234,1,235,38,80,67,1,1453.603,64,1718.613,MORE,170,724,894,1,1,-13,-1.218630999,13,0.698430296,-0.125609888,-1.062717627,147,80,67,1,-0.259285357,0,-0.507216907,-1.255095392,0.762892065,0.762892065,-0.507216907,0,0,0,1
235,1,236,36,70,80,1,1977.727,54,1440.858,MORE,-852,1508,656,3,2,10,0.937408461,10,0.174607574,-0.640053114,-0.635082661,150,70,80,0,-0.199450275,-0.390166852,0,0.456398324,-0.4795035,0.4795035,0,-0.390166852,0,1,0
236,1,237,45,110,122,1,1623.897,84,1477.973,MORE,822,576,1398,1,2,12,1.124890153,12,0.523822722,0.903276565,-0.923774039,232,110,122,0,1.436041979,1.170500555,1.638700776,-1.255095392,1.555496672,1.555496672,1.638700776,1.170500555,1,0,1
237,1,238,42,110,115,1,2901.364,64,2333.854,MORE,-650,1714,1064,3,2,5,0.46870423,5,-0.698430296,-0.125609888,0.118516634,225,110,115,0,1.296426786,1.170500555,1.36558398,0.456398324,-0.23394195,0.23394195,1.36558398,1.170500555,0,1,0
238,1,239,41,110,112,1,1565.164,74,810.788,MORE,142,794,936,1,2,2,0.187481692,2,-1.222253018,0.388833339,-0.97169454,222,110,112,0,1.236591704,1.170500555,1.248533925,-1.255095392,0.72885383,0.72885383,1.248533925,1.170500555,1,0,1
239,1,240,53,110,103,1,1559.884,94,647.066,MORE,772,710,1482,1,2,-7,-0.656185922,7,-0.349215148,1.417719791,-0.976002514,213,110,103,1,1.057086457,1.170500555,0.897383758,-1.255095392,1.49471411,1.49471411,0.897383758,1.170500555,1,0,1
240,2,1,49,110,131,1,6228.547,44,2706.716,MORE,-774,2818,2044,0,1,21,1.968557767,21,2.095290887,-0.238386647,-0.382701548,241,110,131,0,1.615547226,1.170500555,1.989850943,-1.24530331,0.086157659,0.086157659,1.989850943,1.170500555,0,0,0
241,2,2,13,47,50,1,6635.751,54,1508.988,MORE,-100,2964,2864,1,2,3,0.281222538,3,-1.047645444,0.386207188,-0.337703317,97,47,50,0,-1.256536731,-1.28755061,-1.170500555,-0.964934835,0.257853106,0.257853106,-1.170500555,-1.28755061,1,0,1
242,2,3,16,50,44,0,4766.744,64,1664.542,MORE,-2342,3374,1032,1,1,-6,-0.562445076,6,-0.523822722,1.010801022,-0.544238639,94,50,44,1,-1.316371814,-1.170500555,-1.404600665,-0.964934835,-0.313276261,0.313276261,-1.404600665,-1.170500555,1,0,0
243,2,4,7,57,50,0,10945.402,44,3357.675,MORE,-3794,6598,2804,3,1,-7,-0.656185922,7,-0.349215148,-0.238386647,0.138536291,107,57,50,1,-1.057086457,-0.897383758,-1.170500555,-0.404197885,-0.683160222,0.683160222,-1.170500555,-0.897383758,0,1,0
244,2,5,18,42,50,1,5673.265,54,1448.471,MORE,-2798,4022,1224,1,2,8,0.749926769,8,-0.174607574,0.386207188,-0.444063195,92,42,50,0,-1.356261869,-1.482634036,-1.170500555,-0.964934835,-0.429438166,0.429438166,-1.170500555,-1.482634036,1,0,0
245,2,6,51,108,110,1,46657.359,44,2199.183,MORE,19840,3150,22990,0,2,2,0.187481692,2,-1.222253018,-0.238386647,4.084899554,218,108,110,0,1.156811594,1.092467184,1.170500555,-1.24530331,5.337389049,5.337389049,1.170500555,1.092467184,0,0,1
246,2,7,31,78,80,0,7750.691,54,1752.105,MORE,-2098,4108,2010,3,2,2,0.187481692,2,-1.222253018,0.386207188,-0.214496452,158,78,80,0,-0.039890055,-0.07803337,0,-0.404197885,-0.251119452,0.251119452,0,-0.07803337,1,0,0
247,2,8,58,110,92,0,9776.843,44,1876.795,MORE,40,4390,4430,1,2,-18,-1.687335229,18,1.571468165,-0.238386647,0.009404238,202,110,92,1,0.837691154,1.170500555,0.468200222,-0.964934835,0.293516849,0.293516849,0.468200222,1.170500555,0,0,1
248,2,9,12,50,48,1,7758.235,54,1338.013,MORE,1078,2096,3174,1,2,-2,-0.187481692,2,-1.222253018,0.386207188,-0.213662799,98,50,48,1,-1.236591704,-1.170500555,-1.248533925,-0.964934835,0.557938028,0.557938028,-1.248533925,-1.170500555,1,0,1
249,2,10,54,110,101,0,44526.337,34,1508.46,MORE,-25146,28094,2948,0,1,-9,-0.843667615,9,0,-0.862980481,3.849410165,211,110,101,1,1.017196402,1.170500555,0.819350388,-1.24530331,-6.122390485,6.122390485,0.819350388,1.170500555,0,0,0
250,2,11,14,46,50,1,10806.455,44,1927.361,MORE,-1044,4480,3436,1,2,4,0.374963384,4,-0.87303787,-0.238386647,0.1231819,96,46,50,0,-1.276481759,-1.326567295,-1.170500555,-0.964934835,0.017377583,0.017377583,-1.170500555,-1.326567295,0,0,0
251,2,12,22,80,83,1,5936.281,44,1562.155,MORE,-1008,2684,1676,1,2,3,0.281222538,3,-1.047645444,-0.238386647,-0.414998513,163,80,83,0,0.059835082,0,0.117050055,-0.964934835,0.02654826,0.02654826,0.117050055,0,0,0,0
252,2,13,6,50,56,0,22118.048,34,1101.606,MORE,9542,2232,11774,1,2,6,0.562445076,6,-0.523822722,-0.862980481,1.373173746,106,50,56,0,-1.077031484,-1.170500555,-0.936400444,-0.964934835,2.714066023,2.714066023,-0.936400444,-1.170500555,0,0,1
253,2,14,13,50,47,0,7867.572,44,3369.01,MORE,-1188,4166,2978,3,2,-3,-0.281222538,3,-1.047645444,-0.238386647,-0.201580473,97,50,47,1,-1.256536731,-1.170500555,-1.28755061,-0.404197885,-0.019305124,0.019305124,-1.28755061,-1.170500555,0,0,0
254,2,15,46,110,124,1,24336.379,54,1630.879,MORE,-8906,12596,3690,0,2,14,1.312371845,14,0.87303787,0.386207188,1.618311249,234,110,124,0,1.475932034,1.170500555,1.716734147,-1.24530331,-1.985396317,1.985396317,1.716734147,1.170500555,1,0,0
255,2,16,27,91,80,0,12568.18,64,2302.546,MORE,-5716,7476,1760,2,1,-11,-1.031149307,11,0.349215148,1.010801022,0.317861985,171,91,80,1,0.219395302,0.429183537,0,-0.68456636,-1.172772463,1.172772463,0,0.429183537,1,0,0
256,2,17,40,64,80,1,7216.421,54,2637.44,MORE,1098,2618,3716,1,2,16,1.499853537,16,1.222253018,0.386207188,-0.27353616,144,64,80,0,-0.31912044,-0.624266962,0,-0.964934835,0.563032849,0.563032849,0,-0.624266962,1,0,1
257,2,18,22,83,80,0,24450.946,14,2532.688,MORE,7056,3328,10384,0,1,-3,-0.281222538,3,-1.047645444,-2.11216815,1.630971519,163,83,80,1,0.059835082,0.117050055,0,-1.24530331,2.080779847,2.080779847,0,0.117050055,0,0,1
258,2,19,54,101,110,1,20652.52,64,1312.765,MORE,-9126,12034,2908,0,2,9,0.843667615,9,0,1.010801022,1.211225023,211,101,110,0,1.017196402,0.819350388,1.170500555,-1.24530331,-2.041439342,2.041439342,1.170500555,0.819350388,1,0,0
259,2,20,6,56,50,0,9962.632,54,2276.246,MORE,-1074,3966,2892,0,2,-6,-0.562445076,6,-0.523822722,0.386207188,0.029934922,106,56,50,1,-1.077031484,-0.936400444,-1.170500555,-1.24530331,0.009735353,0.009735353,-1.170500555,-0.936400444,1,0,0
260,2,21,18,50,42,0,15264.738,54,1635.842,MORE,-880,4796,3916,0,2,-8,-0.749926769,8,-0.174607574,0.386207188,0.615846143,92,50,42,1,-1.356261869,-1.170500555,-1.482634036,-1.24530331,0.059155111,0.059155111,-1.482634036,-1.170500555,1,0,0
261,2,22,43,110,117,1,14577.04,44,2014.369,MORE,-3946,6904,2958,0,2,7,0.656185922,7,-0.349215148,-0.238386647,0.539851816,227,110,117,0,1.336316841,1.170500555,1.443617351,-1.24530331,-0.721880857,0.721880857,1.443617351,1.170500555,0,0,0
262,2,23,32,77,80,0,10502.538,44,1051.856,MORE,-2756,4920,2164,1,2,3,0.281222538,3,-1.047645444,-0.238386647,0.089597438,157,77,80,0,-0.059835082,-0.117050055,0,-0.964934835,-0.418739043,0.418739043,0,-0.117050055,1,0,0
263,2,24,27,80,91,1,8938.346,44,1513.951,MORE,-1476,4144,2668,0,2,11,1.031149307,11,0.349215148,-0.238386647,-0.083254189,171,80,91,0,0.219395302,0,0.429183537,-1.24530331,-0.092670537,0.092670537,0.429183537,0,0,0,0
264,2,25,16,44,50,1,8371.705,34,1023.203,MORE,-438,3020,2582,1,2,6,0.562445076,6,-0.523822722,-0.862980481,-0.145871066,94,44,50,0,-1.316371814,-1.404600665,-1.170500555,-0.964934835,0.171750641,0.171750641,-1.170500555,-1.404600665,0,0,1
265,2,26,7,50,57,0,8634.889,54,2300.298,MORE,1150,2756,3906,1,2,7,0.656185922,7,-0.349215148,0.386207188,-0.116787819,107,50,57,0,-1.057086457,-1.170500555,-0.897383758,-0.964934835,0.576279382,0.576279382,-0.897383758,-1.170500555,1,0,1
266,2,27,14,50,46,0,9256.349,54,2087.074,MORE,-3174,5374,2200,1,2,-4,-0.374963384,4,-0.87303787,0.386207188,-0.048113147,96,50,46,1,-1.276481759,-1.170500555,-1.326567295,-0.964934835,-0.52522079,0.52522079,-1.326567295,-1.170500555,1,0,0
267,2,28,51,110,108,0,98982.33,54,1930.567,MORE,-38214,41894,3680,2,1,-2,-0.187481692,2,-1.222253018,0.386207188,9.867090187,218,110,108,1,1.156811594,1.170500555,1.092467184,-0.68456636,-9.451346137,9.451346137,1.092467184,1.170500555,1,0,0
268,2,29,50,133,110,0,71123.695,44,3266.077,MORE,-23686,30474,6788,0,2,-23,-2.15603946,23,2.444506035,-0.238386647,6.788561231,243,133,110,1,1.655437281,2.067884313,1.170500555,-1.24530331,-5.750468596,5.750468596,1.170500555,2.067884313,0,0,0
269,2,30,49,131,110,1,14323.977,64,1098.639,MORE,-2602,5912,3310,7,2,-21,-1.968557767,21,2.095290887,1.010801022,0.511886994,241,131,110,1,1.615547226,1.989850943,1.170500555,0.717276015,-0.379508926,0.379508926,1.170500555,1.989850943,1,1,0
270,2,31,47,126,110,1,11246.8,54,1615.594,MORE,-4838,7190,2352,2,2,-16,-1.499853537,16,1.222253018,0.386207188,0.17184239,236,126,110,1,1.515822089,1.794767517,1.170500555,-0.68456636,-0.949109847,0.949109847,1.170500555,1.794767517,1,0,0
271,2,32,50,110,133,1,5729.582,64,903.808,MORE,-698,2656,1958,2,2,23,2.15603946,23,2.444506035,1.010801022,-0.437839863,243,110,133,0,1.655437281,1.170500555,2.067884313,-0.68456636,0.105517976,0.105517976,2.067884313,1.170500555,1,0,0
272,2,33,47,110,126,1,15507.063,54,2221.023,MORE,2616,4156,6772,4,2,16,1.499853537,16,1.222253018,0.386207188,0.642624358,236,110,126,0,1.515822089,1.170500555,1.794767517,-0.12382941,0.949729717,0.949729717,1.794767517,1.170500555,1,1,1
273,2,34,12,48,50,0,9584.002,54,1453.896,MORE,-2686,4780,2094,2,2,2,0.187481692,2,-1.222253018,0.386207188,-0.011905729,98,48,50,0,-1.236591704,-1.248533925,-1.170500555,-0.68456636,-0.400907172,0.400907172,-1.170500555,-1.248533925,1,0,0
274,2,35,32,80,77,1,15060.043,44,1704.187,MORE,-442,5714,5272,5,2,-3,-0.281222538,3,-1.047645444,-0.238386647,0.593226245,157,80,77,1,-0.059835082,0,-0.117050055,0.156539065,0.170731677,0.170731677,-0.117050055,0,0,1,1
275,2,36,43,117,110,1,13755.941,54,1722.052,MORE,-430,5400,4970,4,2,-7,-0.656185922,7,-0.349215148,0.386207188,0.449115962,227,117,110,1,1.336316841,1.443617351,1.170500555,-0.12382941,0.17378857,0.17378857,1.170500555,1.443617351,1,1,1
276,2,37,40,80,64,0,4962.179,74,1493.033,MORE,-338,2306,1968,2,2,-16,-1.499853537,16,1.222253018,1.635394856,-0.522642021,144,80,64,1,-0.31912044,0,-0.624266962,-0.68456636,0.197224744,0.197224744,-0.624266962,0,1,0,1
277,2,38,31,80,78,1,7058.905,44,1628.685,MORE,-1242,3130,1888,2,2,-2,-0.187481692,2,-1.222253018,-0.238386647,-0.290942524,158,80,78,1,-0.039890055,0,-0.07803337,-0.68456636,-0.033061139,0.033061139,-0.07803337,0,0,0,0
278,2,39,46,124,110,1,6745.102,54,2401.298,MORE,648,2616,3264,2,2,-14,-1.312371845,14,0.87303787,0.386207188,-0.325619443,234,124,110,1,1.475932034,1.716734147,1.170500555,-0.68456636,0.448399389,0.448399389,1.170500555,1.716734147,1,0,1
279,2,40,58,92,110,1,5223.511,74,2397.822,MORE,-12,3050,3038,2,1,18,1.687335229,18,1.571468165,1.635394856,-0.49376343,202,92,110,0,0.837691154,0.468200222,1.170500555,-0.68456636,0.280270316,0.280270316,1.170500555,0.468200222,1,0,1
280,2,41,49,110,131,0,4393.264,54,1958.711,LESS,-918,2668,1750,4,1,21,1.968557767,21,2.095290887,0.386207188,-0.585510187,241,110,131,1,1.615547226,1.170500555,1.989850943,-0.12382941,0.049474952,0.049474952,1.989850943,1.170500555,1,0,0
281,2,42,13,47,50,1,9018.968,44,2451.178,LESS,1000,3406,4406,4,2,3,0.281222538,3,-1.047645444,-0.238386647,-0.074345024,97,47,50,1,-1.256536731,-1.28755061,-1.170500555,-0.12382941,0.538068229,0.538068229,-1.170500555,-1.28755061,0,1,1
282,2,43,16,50,44,1,2271.286,64,1742.966,LESS,-210,1354,1144,1,2,-6,-0.562445076,6,-0.523822722,1.010801022,-0.820000166,94,50,44,0,-1.316371814,-1.170500555,-1.404600665,-0.964934835,0.229831594,0.229831594,-1.404600665,-1.170500555,1,0,1
283,2,44,7,57,50,0,13824.456,34,2131.072,LESS,1356,5574,6930,11,2,-7,-0.656185922,7,-0.349215148,-0.862980481,0.456687238,107,57,50,0,-1.057086457,-0.897383758,-1.170500555,1.838749915,0.628756032,0.628756032,-1.170500555,-0.897383758,0,1,1
284,2,45,18,42,50,0,2308.854,74,932.459,LESS,-698,1702,1004,2,2,8,0.749926769,8,-0.174607574,1.635394856,-0.8158487,92,42,50,1,-1.356261869,-1.482634036,-1.170500555,-0.68456636,0.105517976,0.105517976,-1.170500555,-1.482634036,1,0,1
285,2,46,51,108,110,0,6735.222,24,2393.238,LESS,-1646,3936,2290,2,1,2,0.187481692,2,-1.222253018,-1.487574315,-0.326711236,218,108,110,1,1.156811594,1.092467184,1.170500555,-0.68456636,-0.135976511,0.135976511,1.170500555,1.092467184,0,0,0
286,2,47,31,78,80,0,4220.918,54,1672.646,LESS,-1260,2626,1366,4,1,2,0.187481692,2,-1.222253018,0.386207188,-0.604555347,158,78,80,1,-0.039890055,-0.07803337,0,-0.12382941,-0.037646477,0.037646477,0,-0.07803337,1,1,0
287,2,48,58,110,92,1,4542.711,64,1656.103,LESS,884,1768,2652,2,2,-18,-1.687335229,18,1.571468165,1.010801022,-0.56899549,202,110,92,0,0.837691154,1.170500555,0.468200222,-0.68456636,0.50851827,0.50851827,0.468200222,1.170500555,1,0,1
288,2,49,12,50,48,1,10213.207,64,2050.486,LESS,-1040,5650,4610,5,2,-2,-0.187481692,2,-1.222253018,1.010801022,0.057624806,98,50,48,0,-1.236591704,-1.170500555,-1.248533925,0.156539065,0.018396547,0.018396547,-1.248533925,-1.170500555,1,1,0
289,2,50,54,110,101,0,12842.266,34,2003.719,LESS,-96,5570,5474,6,2,-9,-0.843667615,9,0,-0.862980481,0.348149962,211,110,101,0,1.017196402,1.170500555,0.819350388,0.43690754,0.25887207,0.25887207,0.819350388,1.170500555,0,1,1
290,2,51,14,46,50,0,5697.236,64,2140.884,LESS,332,3004,3336,2,2,4,0.374963384,4,-0.87303787,1.010801022,-0.44141427,96,46,50,1,-1.276481759,-1.326567295,-1.170500555,-0.68456636,0.367901227,0.367901227,-1.170500555,-1.326567295,1,0,1
291,2,52,22,80,83,1,9507.452,44,2118.243,LESS,-336,4594,4258,5,2,3,0.281222538,3,-1.047645444,-0.238386647,-0.020364916,163,80,83,1,0.059835082,0,0.117050055,0.156539065,0.197734226,0.197734226,0.117050055,0,0,1,1
292,2,53,6,50,56,0,2202.626,74,1487.098,LESS,-70,1430,1360,3,2,6,0.562445076,6,-0.523822722,1.635394856,-0.827587465,106,50,56,1,-1.077031484,-1.170500555,-0.936400444,-0.404197885,0.265495337,0.265495337,-0.936400444,-1.170500555,1,0,1
293,2,54,13,50,47,0,10523.383,34,1958.964,LESS,-1666,4070,2404,2,1,-3,-0.281222538,3,-1.047645444,-0.862980481,0.091900922,97,50,47,0,-1.256536731,-1.170500555,-1.28755061,-0.68456636,-0.141071331,0.141071331,-1.28755061,-1.170500555,0,0,0
294,2,55,46,110,124,0,5659.319,54,1844.987,LESS,-1344,3058,1714,4,1,14,1.312371845,14,0.87303787,0.386207188,-0.445604303,234,110,124,1,1.475932034,1.170500555,1.716734147,-0.12382941,-0.059044723,0.059044723,1.716734147,1.170500555,1,1,0
295,2,56,27,91,80,0,11711.122,34,1805.081,LESS,1348,4050,5398,6,2,-11,-1.031149307,11,0.349215148,-0.862980481,0.223152468,171,91,80,0,0.219395302,0.429183537,0,0.43690754,0.626718104,0.626718104,0,0.429183537,0,1,1
296,2,57,40,64,80,0,4957.49,74,1107.567,LESS,-1200,2784,1584,4,2,16,1.499853537,16,1.222253018,1.635394856,-0.523160181,144,64,80,1,-0.31912044,-0.624266962,0,-0.12382941,-0.022362016,0.022362016,0,-0.624266962,1,1,0
297,2,58,22,83,80,1,4295.431,54,1443.805,LESS,214,1914,2128,3,2,-3,-0.281222538,3,-1.047645444,0.386207188,-0.59632126,163,83,80,0,0.059835082,0.117050055,0,-0.404197885,0.337841787,0.337841787,0,0.117050055,1,0,1
298,2,59,54,101,110,0,3120.003,64,1850.169,LESS,-464,2398,1934,3,2,9,0.843667615,9,0,1.010801022,-0.726212374,211,101,110,1,1.017196402,0.819350388,1.170500555,-0.404197885,0.165127375,0.165127375,1.170500555,0.819350388,1,0,1
299,2,60,6,56,50,1,6435.686,54,2238.014,LESS,628,2624,3252,4,2,-6,-0.562445076,6,-0.523822722,0.386207188,-0.359811575,106,56,50,0,-1.077031484,-0.936400444,-1.170500555,-0.12382941,0.443304569,0.443304569,-1.170500555,-0.936400444,1,1,1
300,2,61,18,50,42,1,4288.92,54,3228.427,LESS,12,1926,1938,2,1,-8,-0.749926769,8,-0.174607574,0.386207188,-0.59704076,92,50,42,0,-1.356261869,-1.170500555,-1.482634036,-0.68456636,0.286384101,0.286384101,-1.482634036,-1.170500555,1,0,1
301,2,62,43,110,117,0,9699.076,74,1452.641,LESS,-3352,6362,3010,5,2,7,0.656185922,7,-0.349215148,1.635394856,0.000810567,227,110,117,1,1.336316841,1.170500555,1.443617351,0.156539065,-0.570564691,0.570564691,1.443617351,1.170500555,1,1,0
302,2,63,32,77,80,0,12993.588,44,1630.684,LESS,-1182,5796,4614,7,1,3,0.281222538,3,-1.047645444,-0.238386647,0.364871856,157,77,80,1,-0.059835082,-0.117050055,0,0.717276015,-0.017776678,0.017776678,0,-0.117050055,0,1,0
303,2,64,27,80,91,0,6368.911,74,1303.266,LESS,-272,3348,3076,4,2,11,1.031149307,11,0.349215148,1.635394856,-0.367190571,171,80,91,1,0.219395302,0,0.429183537,-0.12382941,0.214037651,0.214037651,0.429183537,0,1,0,1
304,2,65,16,44,50,0,5931.459,74,1220.198,LESS,-362,3042,2680,6,2,6,0.562445076,6,-0.523822722,1.635394856,-0.415531369,94,44,50,1,-1.316371814,-1.404600665,-1.170500555,0.43690754,0.191110959,0.191110959,-1.170500555,-1.404600665,1,1,1
305,2,66,7,50,57,0,13766.499,34,1932.302,LESS,-310,5368,5058,12,2,7,0.656185922,7,-0.349215148,-0.862980481,0.450282678,107,50,57,1,-1.057086457,-1.170500555,-0.897383758,2.11911839,0.204357492,0.204357492,-0.897383758,-1.170500555,0,1,1
306,2,67,14,50,46,1,3602.769,64,1430.108,LESS,1312,1330,2642,3,2,-4,-0.374963384,4,-0.87303787,1.010801022,-0.672864135,96,50,46,0,-1.276481759,-1.170500555,-1.326567295,-0.404197885,0.617547427,0.617547427,-1.326567295,-1.170500555,1,0,1
307,2,68,51,110,108,1,8029.58,44,1799.54,LESS,194,3022,3216,2,2,-2,-0.187481692,2,-1.222253018,-0.238386647,-0.183677718,218,110,108,0,1.156811594,1.170500555,1.092467184,-0.68456636,0.332746966,0.332746966,1.092467184,1.170500555,0,0,1
308,2,69,50,133,110,1,9357.582,44,3986.084,LESS,458,3508,3966,1,2,-23,-2.15603946,23,2.444506035,-0.238386647,-0.036926357,243,133,110,0,1.655437281,2.067884313,1.170500555,-0.964934835,0.399998596,0.399998596,1.170500555,2.067884313,0,0,1
309,2,70,49,131,110,1,14391.407,34,1880.438,LESS,924,5904,6828,6,2,-21,-1.968557767,21,2.095290887,-0.862980481,0.519338372,241,131,110,0,1.615547226,1.989850943,1.170500555,0.43690754,0.518707911,0.518707911,1.170500555,1.989850943,0,1,1
310,2,71,47,126,110,1,13627.4,24,1952.1,LESS,2036,4230,6266,4,2,-16,-1.499853537,16,1.222253018,-1.487574315,0.43491149,236,126,110,0,1.515822089,1.794767517,1.170500555,-0.12382941,0.801979925,0.801979925,1.170500555,1.794767517,0,0,1
311,2,72,50,110,133,0,4957.208,90,1779.016,LESS,-1454,3530,2076,3,2,23,2.15603946,23,2.444506035,2.634744991,-0.523191343,243,110,133,1,1.655437281,1.170500555,2.067884313,-0.404197885,-0.087066235,0.087066235,2.067884313,1.170500555,1,0,0
312,2,73,47,110,126,0,5640.168,74,1236.212,LESS,-1488,3630,2142,5,2,16,1.499853537,16,1.222253018,1.635394856,-0.447720591,236,110,126,1,1.515822089,1.170500555,1.794767517,0.156539065,-0.09572743,0.09572743,1.794767517,1.170500555,1,1,0
313,2,74,12,48,50,1,8963.665,64,1536.048,LESS,-2592,5632,3040,3,2,2,0.187481692,2,-1.222253018,1.010801022,-0.080456303,98,48,50,1,-1.236591704,-1.248533925,-1.170500555,-0.404197885,-0.376961516,0.376961516,-1.170500555,-1.248533925,1,0,0
314,2,75,32,80,77,0,12768.284,34,1704.979,LESS,-1760,6420,4660,4,2,-3,-0.281222538,3,-1.047645444,-0.862980481,0.339974553,157,80,77,0,-0.059835082,0,-0.117050055,-0.12382941,-0.165016987,0.165016987,-0.117050055,0,0,1,0
315,2,76,43,117,110,1,13402.299,34,1770.742,LESS,-2652,7602,4950,8,2,-7,-0.656185922,7,-0.349215148,-0.862980481,0.410036619,227,117,110,0,1.336316841,1.443617351,1.170500555,0.99764449,-0.392245977,0.392245977,1.170500555,1.443617351,0,1,0
316,2,77,40,80,64,0,8565.537,54,1287.286,LESS,-284,3972,3688,4,2,-16,-1.499853537,16,1.222253018,0.386207188,-0.124451588,144,80,64,0,-0.31912044,0,-0.624266962,-0.12382941,0.210980759,0.210980759,-0.624266962,0,1,1,1
317,2,78,31,80,78,1,8977.981,54,1892.798,LESS,1130,3416,4546,5,2,-2,-0.187481692,2,-1.222253018,0.386207188,-0.078874308,158,80,78,0,-0.039890055,0,-0.07803337,0.156539065,0.571184561,0.571184561,-0.07803337,0,1,1,1
318,2,79,46,124,110,1,19471.289,24,2425.003,LESS,950,6942,7892,11,2,-14,-1.312371845,14,0.87303787,-1.487574315,1.080692646,234,124,110,0,1.475932034,1.716734147,1.170500555,1.838749915,0.525331178,0.525331178,1.170500555,1.716734147,0,1,1
319,2,80,58,92,110,0,3362.804,64,1473.768,LESS,-692,1688,996,2,2,18,1.687335229,18,1.571468165,1.010801022,-0.699381558,202,92,110,1,0.837691154,0.468200222,1.170500555,-0.68456636,0.107046422,0.107046422,1.170500555,0.468200222,1,0,1
320,2,81,48,128,110,0,6980.156,74,1286.724,MORE,-548,2164,1616,5,2,-18,-1.687335229,18,1.571468165,1.635394856,-0.299644712,238,128,110,1,1.555712144,1.872800887,1.170500555,0.156539065,0.143729129,0.143729129,1.170500555,1.872800887,1,1,0
321,2,82,8,50,58,1,7323.464,54,1152.661,MORE,180,2692,2872,8,2,8,0.749926769,8,-0.174607574,0.386207188,-0.261707332,108,50,58,0,-1.037141429,-1.170500555,-0.858367073,0.99764449,0.329180592,0.329180592,-0.858367073,-1.170500555,1,1,1
322,2,83,4,54,50,1,12685.652,34,1611.108,MORE,-48,5540,5492,11,2,-4,-0.374963384,4,-0.87303787,-0.862980481,0.330843273,104,54,50,1,-1.116921539,-1.014433814,-1.170500555,1.838749915,0.271099639,0.271099639,-1.170500555,-1.014433814,0,1,1
323,2,84,37,80,69,0,6234.269,64,1158.75,MORE,-880,3384,2504,4,2,-11,-1.031149307,11,0.349215148,1.010801022,-0.382069236,149,80,69,1,-0.219395302,0,-0.429183537,-0.12382941,0.059155111,0.059155111,-0.429183537,0,1,1,0
324,2,85,52,105,110,1,7470.982,64,1301.8,MORE,122,3444,3566,3,2,5,0.46870423,5,-0.698430296,1.010801022,-0.2454058,215,105,110,0,1.096976512,0.975417129,1.170500555,-0.404197885,0.314405613,0.314405613,1.170500555,0.975417129,1,1,1
325,2,86,5,55,50,0,19803.463,14,1765.461,MORE,-4124,10918,6794,18,1,-5,-0.46870423,5,-0.698430296,-2.11216815,1.117399659,105,55,50,1,-1.096976512,-0.975417129,-1.170500555,3.80132924,-0.767224759,0.767224759,-1.170500555,-0.975417129,0,1,0
326,2,87,30,96,80,0,4605.276,54,1815.553,MORE,916,1932,2848,3,2,-16,-1.499853537,16,1.222253018,0.386207188,-0.562081721,176,96,80,1,0.31912044,0.624266962,0,-0.404197885,0.516669983,0.516669983,0,0.624266962,1,1,1
327,2,88,33,80,75,1,10068.237,34,1499.13,MORE,-1038,4528,3490,3,1,-5,-0.46870423,5,-0.698430296,-0.862980481,0.041604842,155,80,75,1,-0.099725137,0,-0.195083426,-0.404197885,0.018906029,0.018906029,-0.195083426,0,0,1,0
328,2,89,48,110,128,1,4717.351,64,2130.662,MORE,-882,2750,1868,3,2,18,1.687335229,18,1.571468165,1.010801022,-0.549696831,238,110,128,0,1.555712144,1.170500555,1.872800887,-0.404197885,0.058645629,0.058645629,1.872800887,1.170500555,1,1,0
329,2,90,9,59,50,0,10498.412,34,2495.783,MORE,-2006,5568,3562,8,1,-9,-0.843667615,9,0,-0.862980481,0.089141492,109,59,50,1,-1.017196402,-0.819350388,-1.170500555,0.99764449,-0.227683278,0.227683278,-1.170500555,-0.819350388,0,1,0
330,2,91,44,110,119,1,4786.207,54,1197.771,MORE,328,2112,2440,1,2,9,0.843667615,9,0,0.386207188,-0.542087873,229,110,119,0,1.376206896,1.170500555,1.521650721,-0.964934835,0.366882263,0.366882263,1.521650721,1.170500555,1,0,1
331,2,92,2,52,50,0,17514.257,44,1972.418,MORE,-7076,11884,4808,9,2,-2,-0.187481692,2,-1.222253018,-0.238386647,0.864430087,102,52,50,1,-1.156811594,-1.092467184,-1.170500555,1.278012965,-1.519220251,1.519220251,-1.170500555,-1.092467184,0,1,0
332,2,93,8,58,50,0,7383.357,54,2735.914,MORE,-486,3646,3160,4,1,-8,-0.749926769,8,-0.174607574,0.386207188,-0.255088834,108,58,50,1,-1.037141429,-0.858367073,-1.170500555,-0.12382941,0.159523073,0.159523073,-1.170500555,-0.858367073,1,1,1
333,2,94,44,119,110,0,19661.432,34,1301.864,MORE,-6016,11564,5548,7,1,-9,-0.843667615,9,0,-0.862980481,1.10170447,229,119,110,1,1.376206896,1.521650721,1.170500555,0.717276015,-1.249194769,1.249194769,1.170500555,1.521650721,0,1,0
334,2,95,34,74,80,1,11765.399,64,1349.447,MORE,-788,6156,5368,0,2,6,0.562445076,6,-0.523822722,1.010801022,0.229150368,154,74,80,0,-0.119670165,-0.234100111,0,-1.24530331,0.082591284,0.082591284,0,-0.234100111,1,0,0
335,2,96,24,86,80,0,11965.88,44,1244.369,MORE,-1194,5802,4608,5,1,-6,-0.562445076,6,-0.523822722,-0.238386647,0.251304597,166,86,80,1,0.119670165,0.234100111,0,0.156539065,-0.02083357,0.02083357,0,0.234100111,0,1,0
336,2,97,39,66,80,1,3989.236,74,933.976,MORE,-222,2226,2004,3,2,14,1.312371845,14,0.87303787,1.635394856,-0.630157454,146,66,80,0,-0.279230385,-0.546233592,0,-0.404197885,0.226774702,0.226774702,0,-0.546233592,1,1,1
337,2,98,9,50,59,0,9313.449,44,1556.543,MORE,-894,4894,4000,3,2,9,0.843667615,9,0,-0.238386647,-0.04180329,109,50,59,0,-1.017196402,-1.170500555,-0.819350388,-0.404197885,0.055588736,0.055588736,-0.819350388,-1.170500555,0,1,0
338,2,99,57,94,110,1,10580.194,64,1378.042,MORE,-334,4974,4640,5,2,16,1.499853537,16,1.222253018,1.010801022,0.098178843,204,94,110,0,0.877581209,0.546233592,1.170500555,0.156539065,0.198243708,0.198243708,1.170500555,0.546233592,1,1,1
339,2,100,60,110,87,0,6636.98,54,1463.95,MORE,-1810,3586,1776,2,1,-23,-2.15603946,23,2.444506035,0.386207188,-0.337567506,197,110,87,1,0.737966017,1.170500555,0.273116796,-0.68456636,-0.177754038,0.177754038,0.273116796,1.170500555,1,0,0
340,2,101,33,75,80,1,6202.516,54,1406.762,MORE,-1494,3456,1962,3,2,5,0.46870423,5,-0.698430296,0.386207188,-0.385578114,155,75,80,0,-0.099725137,-0.195083426,0,-0.404197885,-0.097255876,0.097255876,0,-0.195083426,1,1,0
341,2,102,15,50,45,1,28899.841,24,1851.009,MORE,-366,12188,11822,20,2,-5,-0.46870423,5,-0.698430296,-1.487574315,2.122598337,95,50,45,1,-1.296426786,-1.170500555,-1.36558398,4.36206619,0.190091995,0.190091995,-1.36558398,-1.170500555,0,1,1
342,2,103,59,89,110,1,9338.527,54,999.693,MORE,-174,3918,3744,3,2,21,1.968557767,21,2.095290887,0.386207188,-0.039032036,199,89,110,0,0.777856072,0.351150166,1.170500555,-0.404197885,0.239002271,0.239002271,1.170500555,0.351150166,1,1,1
343,2,104,29,80,94,1,4110.953,74,1388.961,MORE,396,2040,2436,3,2,14,1.312371845,14,0.87303787,1.635394856,-0.616707071,174,80,94,0,0.279230385,0,0.546233592,-0.404197885,0.384204652,0.384204652,0.546233592,0,1,0,1
344,2,105,55,110,98,0,5941.794,54,1108.923,MORE,-752,3174,2422,5,2,-12,-1.124890153,12,0.523822722,0.386207188,-0.414389296,208,110,98,1,0.957361319,1.170500555,0.702300333,0.156539065,0.091761961,0.091761961,0.702300333,1.170500555,1,1,0
345,2,106,29,94,80,0,2614.124,64,1645.33,MORE,110,1714,1824,3,2,-14,-1.312371845,14,0.87303787,1.010801022,-0.782114723,174,94,80,1,0.279230385,0.546233592,0,-0.404197885,0.311348721,0.311348721,0,0.546233592,1,0,1
346,2,107,57,110,94,0,5470.66,74,1045.761,MORE,-306,3116,2810,5,2,-16,-1.499853537,16,1.222253018,1.635394856,-0.466452137,204,110,94,1,0.877581209,1.170500555,0.546233592,0.156539065,0.205376456,0.205376456,0.546233592,1.170500555,1,1,1
347,2,108,39,80,66,0,11858.61,54,1564.235,MORE,-92,4986,4894,4,2,-14,-1.312371845,14,0.87303787,0.386207188,0.239450685,146,80,66,1,-0.279230385,0,-0.546233592,-0.12382941,0.259891034,0.259891034,-0.546233592,0,1,1,1
348,2,109,4,50,54,1,4419.104,54,1371.331,MORE,56,2164,2220,3,2,4,0.374963384,4,-0.87303787,0.386207188,-0.582654728,104,50,54,0,-1.116921539,-1.170500555,-1.014433814,-0.404197885,0.297592705,0.297592705,-1.014433814,-1.170500555,1,0,1
349,2,110,55,98,110,1,8740.806,24,2327.713,MORE,-44,3874,3830,9,2,12,1.124890153,12,0.523822722,-1.487574315,-0.105083421,208,98,110,0,0.957361319,0.702300333,1.170500555,1.278012965,0.272118603,0.272118603,1.170500555,0.702300333,0,1,1
350,2,111,2,50,52,0,11192.925,34,1615.539,MORE,-3272,6726,3454,2,1,2,0.187481692,2,-1.222253018,-0.862980481,0.165888913,102,50,52,0,-1.156811594,-1.170500555,-1.092467184,-0.68456636,-0.55018541,0.55018541,-1.092467184,-1.170500555,0,0,0
351,2,112,59,110,89,0,11204.062,34,2638.626,MORE,-3066,6246,3180,4,1,-21,-1.968557767,21,2.095290887,-0.862980481,0.167119612,199,110,89,1,0.777856072,1.170500555,0.351150166,-0.12382941,-0.49770876,0.49770876,0.351150166,1.170500555,0,1,0
352,2,113,60,87,110,1,7304.684,54,1306.144,MORE,-356,3222,2866,3,2,23,2.15603946,23,2.444506035,0.386207188,-0.263782623,197,87,110,0,0.737966017,0.273116796,1.170500555,-0.404197885,0.192639405,0.192639405,1.170500555,0.273116796,1,0,1
353,2,114,52,110,105,1,8140.553,34,1603.541,MORE,34,3522,3556,3,2,-5,-0.46870423,5,-0.698430296,-0.862980481,-0.171414605,215,110,105,1,1.096976512,1.170500555,0.975417129,-0.404197885,0.291988403,0.291988403,0.975417129,1.170500555,0,0,1
354,2,115,30,80,96,1,10329.606,44,1550.286,MORE,-1212,5220,4008,4,2,16,1.499853537,16,1.222253018,-0.238386647,0.070487522,176,80,96,0,0.31912044,0,0.624266962,-0.12382941,-0.025418908,0.025418908,0.624266962,0,0,1,0
355,2,116,24,80,86,1,6838.95,34,2177.724,MORE,490,2908,3398,3,2,6,0.562445076,6,-0.523822722,-0.862980481,-0.315248735,166,80,86,0,0.119670165,0,0.234100111,-0.404197885,0.408150308,0.408150308,0.234100111,0,0,0,1
356,2,117,5,50,55,1,7156.253,64,3211.713,MORE,758,3310,4068,3,2,5,0.46870423,5,-0.698430296,1.010801022,-0.280185047,105,50,55,0,-1.096976512,-1.170500555,-0.975417129,-0.404197885,0.476420902,0.476420902,-0.975417129,-1.170500555,1,0,1
357,2,118,34,80,74,0,23243.997,14,1990.092,MORE,-3182,11950,8768,17,1,-6,-0.562445076,6,-0.523822722,-2.11216815,1.497597165,154,80,74,1,-0.119670165,0,-0.234100111,3.520960765,-0.527258718,0.527258718,-0.234100111,0,0,1,0
358,2,119,15,45,50,1,8328.395,54,1783.434,MORE,-548,4172,3624,5,2,5,0.46870423,5,-0.698430296,0.386207188,-0.150657054,95,45,50,0,-1.296426786,-1.36558398,-1.170500555,0.156539065,0.143729129,0.143729129,-1.170500555,-1.36558398,1,1,1
359,2,120,37,69,80,1,2418.19,64,1362.421,MORE,-2,1124,1122,1,2,11,1.031149307,11,0.349215148,1.010801022,-0.803766484,149,69,80,0,-0.219395302,-0.429183537,0,-0.964934835,0.282817726,0.282817726,0,-0.429183537,1,0,1
360,2,121,48,128,110,1,10371.722,44,2409.062,LESS,882,4660,5542,5,2,-18,-1.687335229,18,1.571468165,-0.238386647,0.075141566,238,128,110,0,1.555712144,1.872800887,1.170500555,0.156539065,0.508008788,0.508008788,1.170500555,1.872800887,0,1,1
361,2,122,8,50,58,0,6100.871,74,1496.749,LESS,-578,3590,3012,5,2,8,0.749926769,8,-0.174607574,1.635394856,-0.396810433,108,50,58,1,-1.037141429,-1.170500555,-0.858367073,0.156539065,0.136086899,0.136086899,-0.858367073,-1.170500555,1,1,1
362,2,123,4,54,50,1,10341.341,44,1249.981,LESS,-1096,4662,3566,4,2,-4,-0.374963384,4,-0.87303787,-0.238386647,0.071784302,104,54,50,0,-1.116921539,-1.014433814,-1.170500555,-0.12382941,0.00413105,0.00413105,-1.170500555,-1.014433814,0,1,0
363,2,124,37,80,69,1,6921.445,74,1239.681,LESS,2918,2068,4986,2,2,-11,-1.031149307,11,0.349215148,1.635394856,-0.306132594,149,80,69,0,-0.219395302,0,-0.429183537,-0.68456636,1.026661505,1.026661505,-0.429183537,0,1,0,1
364,2,125,52,105,110,0,3024.208,74,1439.642,LESS,-750,2012,1262,2,2,5,0.46870423,5,-0.698430296,1.635394856,-0.736798236,215,105,110,1,1.096976512,0.975417129,1.170500555,-0.68456636,0.092271443,0.092271443,1.170500555,0.975417129,1,0,1
365,2,126,5,55,50,1,8126.898,34,1543.9,LESS,96,3714,3810,5,2,-5,-0.46870423,5,-0.698430296,-0.862980481,-0.172923556,105,55,50,0,-1.096976512,-0.975417129,-1.170500555,0.156539065,0.307782346,0.307782346,-1.170500555,-0.975417129,0,1,1
366,2,127,30,96,80,0,6204.749,64,1485.842,LESS,-1704,3484,1780,3,2,-16,-1.499853537,16,1.222253018,1.010801022,-0.385331355,176,96,80,0,0.31912044,0.624266962,0,-0.404197885,-0.15075149,0.15075149,0,0.624266962,1,0,0
367,2,128,33,80,75,0,4774.057,54,1705.605,LESS,-2044,3212,1168,2,1,-5,-0.46870423,5,-0.698430296,0.386207188,-0.543430513,155,80,75,0,-0.099725137,0,-0.195083426,-0.68456636,-0.237363437,0.237363437,-0.195083426,0,1,0,0
368,2,129,48,110,128,0,4717.593,64,1710.856,LESS,-1470,3024,1554,5,2,18,1.687335229,18,1.571468165,1.010801022,-0.549670089,238,110,128,1,1.555712144,1.170500555,1.872800887,0.156539065,-0.091142091,0.091142091,1.872800887,1.170500555,1,1,0
369,2,130,9,59,50,0,12861.619,44,1141.561,LESS,-1538,6498,4960,8,2,-9,-0.843667615,9,0,-0.238386647,0.350288572,109,59,50,0,-1.017196402,-0.819350388,-1.170500555,0.99764449,-0.108464481,0.108464481,-1.170500555,-0.819350388,0,1,0
370,2,131,44,110,119,0,8381.153,44,1091.35,LESS,-2634,5174,2540,2,1,9,0.843667615,9,0,-0.238386647,-0.144827011,229,110,119,1,1.376206896,1.170500555,1.521650721,-0.68456636,-0.387660639,0.387660639,1.521650721,1.170500555,0,0,0
371,2,132,2,52,50,1,7201.565,54,981.146,LESS,-3152,5152,2000,1,2,-2,-0.187481692,2,-1.222253018,0.386207188,-0.275177827,102,52,50,0,-1.156811594,-1.092467184,-1.170500555,-0.964934835,-0.519616487,0.519616487,-1.170500555,-1.092467184,1,0,0
372,2,133,8,58,50,1,6935.852,64,1981.256,LESS,536,2516,3052,3,2,-8,-0.749926769,8,-0.174607574,1.010801022,-0.304540543,108,58,50,0,-1.037141429,-0.858367073,-1.170500555,-0.404197885,0.419868395,0.419868395,-1.170500555,-0.858367073,1,0,1
373,2,134,44,119,110,1,8155.782,64,1353.353,LESS,1344,3230,4574,3,2,-9,-0.843667615,9,0,1.010801022,-0.169731718,229,119,110,0,1.376206896,1.521650721,1.170500555,-0.404197885,0.625699139,0.625699139,1.170500555,1.521650721,1,0,1
374,2,135,34,74,80,0,11231.186,44,1232.924,LESS,-2280,6098,3818,4,1,6,0.562445076,6,-0.523822722,-0.238386647,0.170116959,154,74,80,1,-0.119670165,-0.234100111,0,-0.12382941,-0.297482318,0.297482318,0,-0.234100111,0,1,0
375,2,136,24,86,80,1,13460.855,34,1694.064,LESS,-192,6134,5942,6,2,-6,-0.562445076,6,-0.523822722,-0.862980481,0.416507372,166,86,80,0,0.119670165,0.234100111,0,0.43690754,0.234416932,0.234416932,0,0.234100111,0,1,1
376,2,137,39,66,80,0,5129.368,74,941.8,LESS,-1288,3138,1850,2,2,14,1.312371845,14,0.87303787,1.635394856,-0.504166738,146,66,80,1,-0.279230385,-0.546233592,0,-0.68456636,-0.044779226,0.044779226,0,-0.546233592,1,0,0
377,2,138,9,50,59,0,3361.537,74,873.848,LESS,-1076,2344,1268,2,2,9,0.843667615,9,0,1.635394856,-0.699521568,109,50,59,1,-1.017196402,-1.170500555,-0.819350388,-0.68456636,0.009225871,0.009225871,-0.819350388,-1.170500555,1,0,0
378,2,139,57,94,110,0,13908.459,44,2340.302,LESS,-2680,7324,4644,10,1,16,1.499853537,16,1.222253018,-0.238386647,0.465970021,204,94,110,1,0.877581209,0.546233592,1.170500555,1.55838144,-0.399378726,0.399378726,1.170500555,0.546233592,0,1,0
379,2,140,60,110,87,1,6783.104,64,1301.281,LESS,-738,3230,2492,3,2,-23,-2.15603946,23,2.444506035,1.010801022,-0.321420018,197,110,87,0,0.737966017,1.170500555,0.273116796,-0.404197885,0.095328335,0.095328335,0.273116796,1.170500555,1,0,1
380,2,141,33,75,80,0,9203.481,24,1686.943,LESS,-3252,6470,3218,6,1,5,0.46870423,5,-0.698430296,-1.487574315,-0.053955346,155,75,80,1,-0.099725137,-0.195083426,0,0.43690754,-0.545090589,0.545090589,0,-0.195083426,0,1,0
381,2,142,15,50,45,1,5052.915,44,1003.969,LESS,264,2290,2554,3,2,-5,-0.46870423,5,-0.698430296,-0.238386647,-0.512615205,95,50,45,0,-1.296426786,-1.170500555,-1.36558398,-0.404197885,0.350578838,0.350578838,-1.36558398,-1.170500555,0,0,1
382,2,143,59,89,110,0,6342.498,64,1003.626,LESS,-3500,4610,1110,2,1,21,1.968557767,21,2.095290887,1.010801022,-0.37010935,199,89,110,1,0.777856072,0.351150166,1.170500555,-0.68456636,-0.608266362,0.608266362,1.170500555,0.351150166,1,0,0
383,2,144,29,80,94,0,3910.52,44,1509.731,LESS,-1330,2612,1282,2,1,14,1.312371845,14,0.87303787,-0.238386647,-0.638855995,174,80,94,1,0.279230385,0,0.546233592,-0.68456636,-0.055478349,0.055478349,0.546233592,0,0,0,0
384,2,145,55,110,98,1,4594.054,54,1203.888,LESS,-620,2484,1864,3,2,-12,-1.124890153,12,0.523822722,0.386207188,-0.563321813,208,110,98,0,0.957361319,1.170500555,0.702300333,-0.404197885,0.125387776,0.125387776,0.702300333,1.170500555,1,0,1
385,2,146,29,94,80,0,15601.451,24,1100.065,LESS,-2058,8070,6012,10,1,-14,-1.312371845,14,0.87303787,-1.487574315,0.65305474,174,94,80,0,0.279230385,0.546233592,0,1.55838144,-0.240929811,0.240929811,0,0.546233592,0,1,0
386,2,147,57,110,94,1,7309.275,24,1638.976,LESS,786,3044,3830,3,2,-16,-1.499853537,16,1.222253018,-1.487574315,-0.263275293,204,110,94,0,0.877581209,1.170500555,0.546233592,-0.404197885,0.48355365,0.48355365,0.546233592,1.170500555,0,0,1
387,2,148,39,80,66,1,5190.82,24,2606.4,LESS,704,2182,2886,3,1,-14,-1.312371845,14,0.87303787,-1.487574315,-0.497375961,146,80,66,0,-0.279230385,0,-0.546233592,-0.404197885,0.462664887,0.462664887,-0.546233592,0,0,0,1
388,2,149,4,50,54,0,20879.898,24,1616.398,LESS,-1756,10028,8272,21,1,4,0.374963384,4,-0.87303787,-1.487574315,1.236351514,104,50,54,1,-1.116921539,-1.170500555,-1.014433814,4.642434665,-0.163998023,0.163998023,-1.014433814,-1.170500555,0,1,0
389,2,150,55,98,110,0,4408.831,54,1312.763,LESS,-1082,2670,1588,5,2,12,1.124890153,12,0.523822722,0.386207188,-0.58378995,208,98,110,1,0.957361319,0.702300333,1.170500555,0.156539065,0.007697424,0.007697424,1.170500555,0.702300333,1,1,0
390,2,151,2,50,52,0,13117.59,34,1703.693,LESS,-2310,7062,4752,10,2,2,0.187481692,2,-1.222253018,-0.862980481,0.378574744,102,50,52,1,-1.156811594,-1.170500555,-1.092467184,1.55838144,-0.305124548,0.305124548,-1.092467184,-1.170500555,0,1,0
391,2,152,59,110,89,1,5613.966,74,1144.659,LESS,1096,2352,3448,3,2,-21,-1.968557767,21,2.095290887,1.635394856,-0.450616053,199,110,89,0,0.777856072,1.170500555,0.351150166,-0.404197885,0.562523366,0.562523366,0.351150166,1.170500555,1,0,1
392,2,153,60,87,110,0,5082.736,74,1092.619,LESS,-474,2826,2352,5,2,23,2.15603946,23,2.444506035,1.635394856,-0.509319824,197,87,110,1,0.737966017,0.273116796,1.170500555,0.156539065,0.162579965,0.162579965,1.170500555,0.273116796,1,1,1
393,2,154,52,110,105,0,8499.643,24,1508.222,LESS,-1162,4506,3344,6,1,-5,-0.46870423,5,-0.698430296,-1.487574315,-0.131733229,215,110,105,0,1.096976512,1.170500555,0.975417129,0.43690754,-0.012681857,0.012681857,0.975417129,1.170500555,0,1,0
394,2,155,30,80,96,0,7979.472,54,1411.614,LESS,-2612,5064,2452,6,2,16,1.499853537,16,1.222253018,0.386207188,-0.189214921,176,80,96,1,0.31912044,0,0.624266962,0.43690754,-0.382056336,0.382056336,0.624266962,0,1,1,0
395,2,156,24,80,86,1,15395.867,34,1630.552,LESS,848,6316,7164,6,2,6,0.562445076,6,-0.523822722,-0.862980481,0.630336602,166,80,86,1,0.119670165,0,0.234100111,0.43690754,0.499347593,0.499347593,0.234100111,0,0,1,1
396,2,157,5,50,55,0,8201.57,64,1107.142,LESS,-478,4210,3732,7,2,5,0.46870423,5,-0.698430296,1.010801022,-0.164671898,105,50,55,1,-1.096976512,-1.170500555,-0.975417129,0.717276015,0.161561001,0.161561001,-0.975417129,-1.170500555,1,1,1
397,2,158,34,80,74,1,6820.168,54,1301.198,LESS,-160,3166,3006,5,2,-6,-0.562445076,6,-0.523822722,0.386207188,-0.317324247,154,80,74,0,-0.119670165,0,-0.234100111,0.156539065,0.242568645,0.242568645,-0.234100111,0,1,1,1
398,2,159,15,45,50,0,8076.828,44,1552.155,LESS,-578,3810,3232,8,2,5,0.46870423,5,-0.698430296,-0.238386647,-0.17845656,95,45,50,1,-1.296426786,-1.36558398,-1.170500555,0.99764449,0.136086899,0.136086899,-1.170500555,-1.36558398,0,1,1
399,2,160,37,69,80,0,5123.042,64,1627.268,LESS,-730,3156,2426,5,2,11,1.031149307,11,0.349215148,1.010801022,-0.504865795,149,69,80,1,-0.219395302,-0.429183537,0,0.156539065,0.097366264,0.097366264,0,-0.429183537,1,1,1
400,2,161,3,50,53,1,7567.203,44,1533.445,MORE,-420,3358,2938,3,2,3,0.281222538,3,-1.047645444,-0.238386647,-0.234772862,103,50,53,0,-1.136866566,-1.170500555,-1.053450499,-0.404197885,0.17633598,0.17633598,-1.053450499,-1.170500555,0,0,1
401,2,162,20,50,40,0,3128.203,64,1377.761,MORE,144,1734,1878,2,2,-10,-0.937408461,10,0.174607574,1.010801022,-0.72530623,90,50,40,1,-1.396151924,-1.170500555,-1.560667406,-0.68456636,0.320009915,0.320009915,-1.560667406,-1.170500555,1,0,1
402,2,163,25,80,88,1,4282.243,44,1329.252,MORE,-336,2100,1764,3,2,8,0.749926769,8,-0.174607574,-0.238386647,-0.597778605,168,80,88,0,0.15956022,0,0.312133481,-0.404197885,0.197734226,0.197734226,0.312133481,0,0,0,1
403,2,164,42,115,110,1,11387.791,34,1121.898,MORE,912,3980,4892,5,2,-5,-0.46870423,5,-0.698430296,-0.862980481,0.187422654,225,115,110,1,1.296426786,1.36558398,1.170500555,0.156539065,0.515651019,0.515651019,1.170500555,1.36558398,0,1,1
404,2,165,53,103,110,1,6243.72,64,1364.308,MORE,408,2974,3382,5,2,7,0.656185922,7,-0.349215148,1.010801022,-0.38102485,213,103,110,0,1.057086457,0.897383758,1.170500555,0.156539065,0.387261545,0.387261545,1.170500555,0.897383758,1,1,1
405,2,166,26,90,80,1,7674.5,44,1880.84,MORE,-384,3688,3304,5,2,-10,-0.937408461,10,0.174607574,-0.238386647,-0.222915967,170,90,80,1,0.199450275,0.390166852,0,0.156539065,0.185506657,0.185506657,0,0.390166852,0,1,1
406,2,167,35,80,72,0,13351.711,24,1787.587,MORE,-1262,6590,5328,12,1,-8,-0.749926769,8,-0.174607574,-1.487574315,0.404446373,152,80,72,1,-0.15956022,0,-0.312133481,2.11911839,-0.038155959,0.038155959,-0.312133481,0,0,1,0
407,2,168,28,93,80,0,15023.755,14,1651.419,MORE,118,6602,6720,8,1,-13,-1.218630999,13,0.698430296,-2.11216815,0.589216226,173,93,80,1,0.259285357,0.507216907,0,0.99764449,0.313386649,0.313386649,0,0.507216907,0,1,1
408,2,169,26,80,90,1,4556.762,34,1129.431,MORE,-702,2474,1772,3,2,10,0.937408461,10,0.174607574,-0.862980481,-0.567442779,170,80,90,0,0.199450275,0,0.390166852,-0.404197885,0.104499012,0.104499012,0.390166852,0,0,0,0
409,2,170,25,88,80,0,8987.876,34,1461.971,MORE,218,3802,4020,6,1,-8,-0.749926769,8,-0.174607574,-0.862980481,-0.077780857,168,88,80,1,0.15956022,0.312133481,0,0.43690754,0.338860751,0.338860751,0,0.312133481,0,1,1
410,2,171,36,80,70,0,10619.167,34,1592.764,MORE,240,4480,4720,7,2,-10,-0.937408461,10,0.174607574,-0.862980481,0.102485569,150,80,70,1,-0.199450275,0,-0.390166852,0.717276015,0.344465053,0.344465053,-0.390166852,0,0,1,1
411,2,172,28,80,93,1,3456.776,64,1060.793,MORE,396,1676,2072,3,2,13,1.218630999,13,0.698430296,1.010801022,-0.688997147,173,80,93,0,0.259285357,0,0.507216907,-0.404197885,0.384204652,0.384204652,0.507216907,0,1,0,1
412,2,173,21,82,80,0,6730.993,24,1502.226,MORE,-2196,4254,2058,4,1,-2,-0.187481692,2,-1.222253018,-1.487574315,-0.327178564,162,82,80,1,0.039890055,0.07803337,0,-0.12382941,-0.276084072,0.276084072,0,0.07803337,0,1,0
413,2,174,19,50,41,0,6897.652,44,2064.669,MORE,-852,3814,2962,5,2,-9,-0.843667615,9,0,-0.238386647,-0.308761848,91,50,41,1,-1.376206896,-1.170500555,-1.521650721,0.156539065,0.066287859,0.066287859,-1.521650721,-1.170500555,0,1,0
414,2,175,56,96,110,1,7074.372,64,1301.852,MORE,-246,3104,2858,5,2,14,1.312371845,14,0.87303787,1.010801022,-0.289233338,206,96,110,0,0.917471264,0.624266962,1.170500555,0.156539065,0.220660917,0.220660917,1.170500555,0.624266962,1,1,1
415,2,176,23,80,85,1,4346.168,64,1809.837,MORE,-464,2432,1968,3,2,5,0.46870423,5,-0.698430296,1.010801022,-0.590714549,165,80,85,0,0.099725137,0,0.195083426,-0.404197885,0.165127375,0.165127375,0.195083426,0,1,0,1
416,2,177,10,60,50,0,15269.582,34,1646.819,MORE,-410,7206,6796,11,2,-10,-0.937408461,10,0.174607574,-0.862980481,0.616381431,110,60,50,1,-0.997251374,-0.780333703,-1.170500555,1.838749915,0.17888339,0.17888339,-1.170500555,-0.780333703,0,1,1
417,2,178,19,41,50,1,5680.574,44,1678.551,MORE,-932,2710,1778,4,1,9,0.843667615,9,0,-0.238386647,-0.443255511,91,41,50,0,-1.376206896,-1.521650721,-1.170500555,-0.12382941,0.045908578,0.045908578,-1.170500555,-1.521650721,0,1,0
418,2,179,56,110,96,0,6420.155,54,1306.589,MORE,-2052,4158,2106,4,1,-14,-1.312371845,14,0.87303787,0.386207188,-0.361527834,206,110,96,1,0.917471264,1.170500555,0.624266962,-0.12382941,-0.239401365,0.239401365,0.624266962,1.170500555,1,1,0
419,2,180,35,72,80,1,7512.655,54,2780.489,MORE,188,3574,3762,5,2,8,0.749926769,8,-0.174607574,0.386207188,-0.24080071,152,72,80,0,-0.15956022,-0.312133481,0,0.156539065,0.33121852,0.33121852,0,-0.312133481,1,1,1
420,2,181,11,49,50,1,4470.683,54,1448.036,MORE,864,2056,2920,3,2,1,0.093740846,1,-1.396860592,0.386207188,-0.576954972,99,49,50,0,-1.216646676,-1.20951724,-1.170500555,-0.404197885,0.50342345,0.50342345,-1.170500555,-1.20951724,1,0,1
421,2,182,17,43,50,0,15616.594,24,1045.636,MORE,-954,7230,6276,6,1,7,0.656185922,7,-0.349215148,-1.487574315,0.654728123,93,43,50,0,-1.336316841,-1.443617351,-1.170500555,0.43690754,0.040304275,0.040304275,-1.170500555,-1.443617351,0,1,0
422,2,183,1,51,50,0,5593.92,54,1699.497,MORE,-1080,3150,2070,4,1,-1,-0.093740846,1,-1.396860592,0.386207188,-0.452831244,101,51,50,1,-1.176756621,-1.131483869,-1.170500555,-0.12382941,0.008206907,0.008206907,-1.170500555,-1.131483869,1,1,0
423,2,184,41,112,110,1,7397.905,44,1633.376,MORE,-3206,5038,1832,3,2,-2,-0.187481692,2,-1.222253018,-0.238386647,-0.253481202,222,112,110,1,1.236591704,1.248533925,1.170500555,-0.404197885,-0.533372502,0.533372502,1.170500555,1.248533925,0,0,0
424,2,185,20,40,50,1,4188.963,24,1771.923,MORE,468,1800,2268,3,2,10,0.937408461,10,0.174607574,-1.487574315,-0.608086546,90,40,50,0,-1.396151924,-1.560667406,-1.170500555,-0.404197885,0.402546006,0.402546006,-1.170500555,-1.560667406,0,0,1
425,2,186,1,50,51,1,11009.734,54,1889.552,MORE,-1722,5472,3750,5,2,1,0.093740846,1,-1.396860592,0.386207188,0.145645323,101,50,51,0,-1.176756621,-1.170500555,-1.131483869,0.156539065,-0.155336828,0.155336828,-1.131483869,-1.170500555,1,1,0
426,2,187,23,85,80,1,12227.283,14,1341.159,MORE,1324,5110,6434,11,1,-5,-0.46870423,5,-0.698430296,-2.11216815,0.280191034,165,85,80,1,0.099725137,0.195083426,0,1.838749915,0.620604319,0.620604319,0,0.195083426,0,1,1
427,2,188,11,50,49,0,6611.683,44,1258.425,MORE,-992,3896,2904,7,2,-1,-0.093740846,1,-1.396860592,-0.238386647,-0.34036296,99,50,49,1,-1.216646676,-1.170500555,-1.20951724,0.717276015,0.030624116,0.030624116,-1.20951724,-1.170500555,0,1,0
428,2,189,17,50,43,0,6072.679,34,1209.646,MORE,-1668,3734,2066,6,1,-7,-0.656185922,7,-0.349215148,-0.862980481,-0.3999258,93,50,43,1,-1.336316841,-1.170500555,-1.443617351,0.43690754,-0.141580813,0.141580813,-1.443617351,-1.170500555,0,1,0
429,2,190,21,80,82,1,6999.655,54,1150.075,MORE,504,2996,3500,4,2,2,0.187481692,2,-1.222253018,0.386207188,-0.297489968,162,80,82,0,0.039890055,0,0.07803337,-0.12382941,0.411716683,0.411716683,0.07803337,0,1,1,1
430,2,191,10,50,60,1,3228.329,44,1556.749,MORE,-18,1594,1576,3,2,10,0.937408461,10,0.174607574,-0.238386647,-0.714241768,110,50,60,0,-0.997251374,-1.170500555,-0.780333703,-0.404197885,0.27874187,0.27874187,-0.780333703,-1.170500555,0,0,1
431,2,192,3,53,50,0,4967.049,44,1459.518,MORE,-1312,2980,1668,4,1,-3,-0.281222538,3,-1.047645444,-0.238386647,-0.52210386,103,53,50,1,-1.136866566,-1.053450499,-1.170500555,-0.12382941,-0.05089301,0.05089301,-1.170500555,-1.053450499,0,1,0
432,2,193,45,122,110,1,12912.862,14,2235.743,MORE,-498,5646,5148,13,2,-12,-1.124890153,12,0.523822722,-2.11216815,0.355951199,232,122,110,1,1.436041979,1.638700776,1.170500555,2.399486865,0.15646618,0.15646618,1.170500555,1.638700776,0,1,1
433,2,194,38,67,80,1,5397.382,34,1108.579,MORE,-198,2578,2380,3,1,13,1.218630999,13,0.698430296,-0.862980481,-0.47454975,147,67,80,0,-0.259285357,-0.507216907,0,-0.404197885,0.232888486,0.232888486,0,-0.507216907,0,0,1
434,2,195,38,80,67,0,9558.551,34,2063.309,MORE,-3332,5878,2546,6,1,-13,-1.218630999,13,0.698430296,-0.862980481,-0.014718201,147,80,67,1,-0.259285357,0,-0.507216907,0.43690754,-0.565469871,0.565469871,-0.507216907,0,0,1,0
435,2,196,36,70,80,1,6003.087,54,1487.019,MORE,-1058,3280,2222,3,2,10,0.937408461,10,0.174607574,0.386207188,-0.40761609,150,70,80,0,-0.199450275,-0.390166852,0,-0.404197885,0.013811209,0.013811209,0,-0.390166852,1,0,0
436,2,197,45,110,122,1,18304.296,24,1284.804,MORE,-90,7862,7772,12,2,12,1.124890153,12,0.523822722,-1.487574315,0.951733645,232,110,122,0,1.436041979,1.170500555,1.638700776,2.11911839,0.260400517,0.260400517,1.638700776,1.170500555,0,1,1
437,2,198,42,110,115,1,4058.755,44,1207.067,MORE,-764,2288,1524,3,2,5,0.46870423,5,-0.698430296,-0.238386647,-0.62247523,225,110,115,0,1.296426786,1.170500555,1.36558398,-0.404197885,0.088705069,0.088705069,1.36558398,1.170500555,0,0,0
438,2,199,41,110,112,1,23107.279,4,1648.195,MORE,1230,8836,10066,16,1,2,0.187481692,2,-1.222253018,-2.736761984,1.482489091,222,110,112,0,1.236591704,1.170500555,1.248533925,3.24059229,0.596658663,0.596658663,1.248533925,1.170500555,0,1,1
439,2,200,53,110,103,0,7476.425,34,1024.117,MORE,-1526,3894,2368,3,1,-7,-0.656185922,7,-0.349215148,-0.862980481,-0.24480432,213,110,103,1,1.057086457,1.170500555,0.897383758,-0.404197885,-0.105407588,0.105407588,0.897383758,1.170500555,0,1,0
440,2,201,3,50,53,0,7575.096,44,1030.752,LESS,-162,2970,2808,4,1,3,0.281222538,3,-1.047645444,-0.238386647,-0.233900644,103,50,53,1,-1.136866566,-1.170500555,-1.053450499,-0.12382941,0.242059163,0.242059163,-1.053450499,-1.170500555,0,0,1
441,2,202,20,50,40,1,4658.442,44,1261.478,LESS,798,1774,2572,3,2,-10,-0.937408461,10,0.174607574,-0.238386647,-0.556206593,90,50,40,0,-1.396151924,-1.170500555,-1.560667406,-0.404197885,0.486610542,0.486610542,-1.560667406,-1.170500555,0,0,1
442,2,203,25,80,88,0,7008.028,24,1411.532,LESS,-1900,4164,2264,4,1,8,0.749926769,8,-0.174607574,-1.487574315,-0.296564706,168,80,88,1,0.15956022,0,0.312133481,-0.12382941,-0.20068073,0.20068073,0.312133481,0,0,0,0
443,2,204,42,115,110,0,13829.928,34,1767.426,LESS,-1408,7024,5616,17,2,-5,-0.46870423,5,-0.698430296,-0.862980481,0.457291923,225,115,110,0,1.296426786,1.36558398,1.170500555,3.520960765,-0.075348148,0.075348148,1.170500555,1.36558398,0,1,0
444,2,205,53,103,110,0,2747.496,54,897.099,LESS,-874,1640,766,2,1,7,0.656185922,7,-0.349215148,0.386207188,-0.7673764,213,103,110,1,1.057086457,0.897383758,1.170500555,-0.68456636,0.060683557,0.060683557,1.170500555,0.897383758,1,0,0
445,2,206,26,90,80,1,12428.383,14,1017.809,LESS,-212,5774,5562,8,1,-10,-0.937408461,10,0.174607574,-2.11216815,0.302413665,170,90,80,0,0.199450275,0.390166852,0,0.99764449,0.229322112,0.229322112,0,0.390166852,0,1,1
446,2,207,35,80,72,0,4775.54,54,1336.203,LESS,-938,2780,1842,5,2,-8,-0.749926769,8,-0.174607574,0.386207188,-0.543266634,152,80,72,0,-0.15956022,0,-0.312133481,0.156539065,0.044380131,0.044380131,-0.312133481,0,1,1,0
447,2,208,28,93,80,1,6153.953,24,1286.201,LESS,50,2856,2906,3,1,-13,-1.218630999,13,0.698430296,-1.487574315,-0.390944586,173,93,80,0,0.259285357,0.507216907,0,-0.404197885,0.296064259,0.296064259,0,0.507216907,0,0,1
448,2,209,26,80,90,0,5461.167,34,1180.818,LESS,-1368,3390,2022,4,1,10,0.937408461,10,0.174607574,-0.862980481,-0.467501164,170,80,90,1,0.199450275,0,0.390166852,-0.12382941,-0.065158507,0.065158507,0.390166852,0,0,0,0
449,2,210,25,88,80,1,7037.482,34,1047.218,LESS,-24,3290,3266,5,2,-8,-0.749926769,8,-0.174607574,-0.862980481,-0.293309881,168,88,80,0,0.15956022,0.312133481,0,0.156539065,0.277213424,0.277213424,0,0.312133481,0,1,1
450,2,211,36,80,70,1,15416.275,24,1488.248,LESS,-1306,7394,6088,9,2,-10,-0.937408461,10,0.174607574,-1.487574315,0.632591796,150,80,70,0,-0.199450275,0,-0.390166852,1.278012965,-0.049364564,0.049364564,-0.390166852,0,0,1,0
451,2,212,28,80,93,0,5270.916,64,1166.473,LESS,-1236,3076,1840,3,2,13,1.218630999,13,0.698430296,1.010801022,-0.488524923,173,80,93,1,0.259285357,0,0.507216907,-0.404197885,-0.031532693,0.031532693,0.507216907,0,1,0,0
452,2,213,21,82,80,1,5931.903,44,2847.458,LESS,-252,2740,2488,3,2,-2,-0.187481692,2,-1.222253018,-0.238386647,-0.415482305,162,82,80,0,0.039890055,0.07803337,0,-0.404197885,0.219132471,0.219132471,0,0.07803337,0,0,1
453,2,214,19,50,41,1,4572.768,54,1150.262,LESS,254,1826,2080,3,2,-9,-0.843667615,9,0,0.386207188,-0.56567403,91,50,41,0,-1.376206896,-1.170500555,-1.521650721,-0.404197885,0.348031427,0.348031427,-1.521650721,-1.170500555,1,0,1
454,2,215,56,96,110,0,5824.12,54,1561.204,LESS,-406,3000,2594,3,2,14,1.312371845,14,0.87303787,0.386207188,-0.427392906,206,96,110,1,0.917471264,0.624266962,1.170500555,-0.404197885,0.179902354,0.179902354,1.170500555,0.624266962,1,0,1
455,2,216,23,80,85,1,8615.398,34,1549.492,LESS,-1462,4776,3314,1,1,5,0.46870423,5,-0.698430296,-0.862980481,-0.118941679,165,80,85,1,0.099725137,0,0.195083426,-0.964934835,-0.089104163,0.089104163,0.195083426,0,0,0,0
456,2,217,10,60,50,1,8031.564,54,2373.862,LESS,-890,4518,3628,7,2,-10,-0.937408461,10,0.174607574,0.386207188,-0.183458475,110,60,50,0,-0.997251374,-0.780333703,-1.170500555,0.717276015,0.0566077,0.0566077,-1.170500555,-0.780333703,1,1,0
457,2,218,19,41,50,0,2722.327,74,1037.644,LESS,-428,1780,1352,2,2,9,0.843667615,9,0,1.635394856,-0.77015771,91,41,50,1,-1.376206896,-1.521650721,-1.170500555,-0.68456636,0.174298052,0.174298052,-1.170500555,-1.521650721,1,0,1
458,2,219,56,110,96,1,14101.24,24,1250.156,LESS,-554,5964,5410,6,2,-14,-1.312371845,14,0.87303787,-1.487574315,0.487273358,206,110,96,0,0.917471264,1.170500555,0.624266962,0.43690754,0.142200683,0.142200683,0.624266962,1.170500555,0,1,1
459,2,220,35,72,80,0,8237.123,44,2094.912,LESS,374,3212,3586,3,2,8,0.749926769,8,-0.174607574,-0.238386647,-0.1607431,152,72,80,1,-0.15956022,-0.312133481,0,-0.404197885,0.37860035,0.37860035,0,-0.312133481,0,0,1
460,2,221,11,49,50,0,5628.714,44,2480.792,LESS,-1736,3184,1448,3,2,1,0.093740846,1,-1.396860592,-0.238386647,-0.44898632,99,49,50,1,-1.216646676,-1.20951724,-1.170500555,-0.404197885,-0.158903203,0.158903203,-1.170500555,-1.20951724,0,0,0
461,2,222,17,43,50,0,7812.105,64,1425.118,LESS,-1746,4616,2870,5,2,7,0.656185922,7,-0.349215148,1.010801022,-0.207709875,93,43,50,1,-1.336316841,-1.443617351,-1.170500555,0.156539065,-0.161450613,0.161450613,-1.170500555,-1.443617351,1,1,0
462,2,223,1,51,50,0,13191.96,44,1584.338,LESS,-2464,7318,4854,13,2,-1,-0.093740846,1,-1.396860592,-0.238386647,0.386793029,101,51,50,0,-1.176756621,-1.131483869,-1.170500555,2.399486865,-0.344354665,0.344354665,-1.170500555,-1.131483869,0,1,0
463,2,224,41,112,110,0,7394.705,44,1160.77,LESS,-960,3946,2986,7,2,-2,-0.187481692,2,-1.222253018,-0.238386647,-0.253834819,222,112,110,0,1.236591704,1.248533925,1.170500555,0.717276015,0.038775829,0.038775829,1.170500555,1.248533925,0,1,0
464,2,225,20,40,50,0,13209.633,54,1259.044,LESS,-2778,7456,4678,3,1,10,0.937408461,10,0.174607574,0.386207188,0.38874599,90,40,50,1,-1.396151924,-1.560667406,-1.170500555,-0.404197885,-0.424343346,0.424343346,-1.170500555,-1.560667406,1,0,0
465,2,226,1,50,51,0,9956.088,34,1204.728,LESS,-1024,4602,3578,9,1,1,0.093740846,1,-1.396860592,-0.862980481,0.029211774,101,50,51,1,-1.176756621,-1.170500555,-1.131483869,1.278012965,0.022472404,0.022472404,-1.131483869,-1.170500555,0,1,0
466,2,227,23,85,80,0,11160.33,14,1258.591,LESS,-2834,6548,3714,8,1,-5,-0.46870423,5,-0.698430296,-2.11216815,0.16228699,165,85,80,0,0.099725137,0.195083426,0,0.99764449,-0.438608843,0.438608843,0,0.195083426,0,1,0
467,2,228,11,50,49,1,10567.69,64,1840.249,LESS,-1146,5246,4100,1,2,-1,-0.093740846,1,-1.396860592,1.010801022,0.096797084,99,50,49,0,-1.216646676,-1.170500555,-1.20951724,-0.964934835,-0.008606001,0.008606001,-1.20951724,-1.170500555,1,0,0
468,2,229,17,50,43,1,3856.248,54,1227.17,LESS,854,1680,2534,3,2,-7,-0.656185922,7,-0.349215148,0.386207188,-0.644853343,93,50,43,0,-1.336316841,-1.170500555,-1.443617351,-0.404197885,0.50087604,0.50087604,-1.443617351,-1.170500555,1,0,1
469,2,230,21,80,82,0,9273.443,44,1585.888,LESS,-1488,5022,3534,8,2,2,0.187481692,2,-1.222253018,-0.238386647,-0.046224168,162,80,82,1,0.039890055,0,0.07803337,0.99764449,-0.09572743,0.09572743,0.07803337,0,0,1,0
470,2,231,10,50,60,0,2950.943,64,1224.711,LESS,-936,1904,968,2,2,10,0.937408461,10,0.174607574,1.010801022,-0.744894413,110,50,60,1,-0.997251374,-1.170500555,-0.780333703,-0.68456636,0.044889613,0.044889613,-0.780333703,-1.170500555,1,0,0
471,2,232,3,53,50,0,13342.428,24,1103.06,LESS,-2072,6530,4458,11,1,-3,-0.281222538,3,-1.047645444,-1.487574315,0.403420552,103,53,50,0,-1.136866566,-1.053450499,-1.170500555,1.838749915,-0.244496185,0.244496185,-1.170500555,-1.053450499,0,1,0
472,2,233,45,122,110,1,7723.314,34,1580.542,LESS,-1168,4268,3100,2,1,-12,-1.124890153,12,0.523822722,-0.862980481,-0.217521758,232,122,110,0,1.436041979,1.638700776,1.170500555,-0.68456636,-0.014210303,0.014210303,1.170500555,1.638700776,0,0,0
473,2,234,38,67,80,0,4339.511,54,1562.554,LESS,-1908,3014,1106,2,1,13,1.218630999,13,0.698430296,0.386207188,-0.591450183,147,67,80,1,-0.259285357,-0.507216907,0,-0.68456636,-0.202718658,0.202718658,0,-0.507216907,1,0,0
474,2,235,38,80,67,1,5191.56,44,1596.709,LESS,-546,2698,2152,3,2,-13,-1.218630999,13,0.698430296,-0.238386647,-0.497294187,147,80,67,0,-0.259285357,0,-0.507216907,-0.404197885,0.144238611,0.144238611,-0.507216907,0,0,0,1
475,2,236,36,70,80,0,4657.154,54,1790.136,LESS,-818,2896,2078,5,2,10,0.937408461,10,0.174607574,0.386207188,-0.556348924,150,70,80,1,-0.199450275,-0.390166852,0,0.156539065,0.074949054,0.074949054,0,-0.390166852,1,1,0
476,2,237,45,110,122,0,5824.51,74,1387.272,LESS,-692,3428,2736,4,2,12,1.124890153,12,0.523822722,1.635394856,-0.427349809,232,110,122,1,1.436041979,1.170500555,1.638700776,-0.12382941,0.107046422,0.107046422,1.638700776,1.170500555,1,0,1
477,2,238,42,110,115,0,18900.494,14,1333.54,LESS,-5986,11370,5384,16,1,5,0.46870423,5,-0.698430296,-2.11216815,1.017616729,225,110,115,1,1.296426786,1.170500555,1.36558398,3.24059229,-1.241552539,1.241552539,1.36558398,1.170500555,0,1,0
478,2,239,41,110,112,0,4334.927,34,1463.1,LESS,-2122,3016,894,1,1,2,0.187481692,2,-1.222253018,-0.862980481,-0.59195674,222,110,112,1,1.236591704,1.170500555,1.248533925,-0.964934835,-0.257233237,0.257233237,1.248533925,1.170500555,0,0,0
479,2,240,53,110,103,0,8621.08,34,1427.842,LESS,-1614,4718,3104,6,1,-7,-0.656185922,7,-0.349215148,-0.862980481,-0.118313788,213,110,103,0,1.057086457,1.170500555,0.897383758,0.43690754,-0.127824798,0.127824798,0.897383758,1.170500555,0,1,0
480,3,1,49,110,131,1,8280.333,64,2093.214,MORE,18,3296,3314,4,2,21,1.968557767,21,2.095290887,0.028021569,2.854670222,241,110,131,0,1.615547226,1.170500555,1.989850943,1.089895216,-0.22660486,0.22660486,1.989850943,1.170500555,0,1,0
481,3,2,13,47,50,1,7167.467,34,1448.205,MORE,-292,2888,2596,3,1,3,0.281222538,3,-1.047645444,-1.599037289,2.184901195,97,47,50,0,-1.256536731,-1.28755061,-1.170500555,0.30438515,-0.515758662,0.515758662,-1.170500555,-1.28755061,0,1,0
482,3,3,16,50,44,1,8070.478,24,695.884,MORE,900,2506,3406,3,2,-6,-0.562445076,6,-0.523822722,-2.141390242,2.728370758,94,50,44,1,-1.316371814,-1.170500555,-1.404600665,0.30438515,0.596084344,0.596084344,-1.404600665,-1.170500555,0,1,1
483,3,4,7,57,50,0,4998.854,64,2642.301,MORE,-1910,2998,1088,2,1,-7,-0.656185922,7,-0.349215148,0.028021569,0.879739728,107,57,50,1,-1.057086457,-0.897383758,-1.170500555,-0.481124915,-2.024954956,2.024954956,-1.170500555,-0.897383758,0,1,0
484,3,5,18,42,50,1,7020.031,44,495.796,MORE,1330,1908,3238,2,2,8,0.749926769,8,-0.174607574,-1.056684336,2.09616808,92,42,50,0,-1.356261869,-1.482634036,-1.170500555,-0.481124915,0.99716865,0.99716865,-1.170500555,-1.482634036,0,1,1
485,3,6,51,108,110,1,5506.326,34,624.838,MORE,210,2122,2332,3,2,2,0.187481692,2,-1.222253018,-1.599037289,1.185157476,218,108,110,0,1.156811594,1.092467184,1.170500555,0.30438515,-0.047516054,0.047516054,1.170500555,1.092467184,0,1,0
486,3,7,31,78,80,1,5346.013,64,2813.196,MORE,-208,2114,1906,2,2,2,0.187481692,2,-1.222253018,0.028021569,1.088674448,158,78,80,0,-0.039890055,-0.07803337,0,-0.481124915,-0.437407309,0.437407309,0,-0.07803337,0,0,0
487,3,8,58,110,92,0,6129.209,64,1953.808,MORE,-256,2718,2462,4,2,-18,-1.687335229,18,1.571468165,0.028021569,1.560034363,202,110,92,1,0.837691154,1.170500555,0.468200222,1.089895216,-0.48217951,0.48217951,0.468200222,1.170500555,0,1,0
488,3,9,12,50,48,0,9167.056,14,1568.307,MORE,-1590,4804,3214,5,1,-2,-0.187481692,2,-1.222253018,-2.683743194,3.388336991,98,50,48,1,-1.236591704,-1.170500555,-1.248533925,1.875405281,-1.726473612,1.726473612,-1.248533925,-1.170500555,0,1,0
489,3,10,54,110,101,1,7253.443,74,2011.646,MORE,-150,2000,1850,1,2,-9,-0.843667615,9,0,0.570374522,2.236645126,211,110,101,1,1.017196402,1.170500555,0.819350388,-1.266634981,-0.383307565,0.383307565,0.819350388,1.170500555,1,0,0
490,3,11,14,46,50,1,5005.184,54,2332.678,MORE,-898,2864,1966,3,1,4,0.374963384,4,-0.87303787,-0.514331383,0.883549385,96,46,50,0,-1.276481759,-1.326567295,-1.170500555,0.30438515,-1.081007706,1.081007706,-1.170500555,-1.326567295,0,1,0
491,3,12,22,80,83,1,5040.511,24,730.267,MORE,904,1734,2638,3,2,3,0.281222538,3,-1.047645444,-2.141390242,0.904810642,163,80,83,0,0.059835082,0,0.117050055,0.30438515,0.599815361,0.599815361,0.117050055,0,0,1,1
492,3,13,6,50,56,0,7641.814,74,1677.633,MORE,-1182,3486,2304,6,1,6,0.562445076,6,-0.523822722,0.570374522,2.470382941,106,50,56,0,-1.077031484,-1.170500555,-0.936400444,2.660915347,-1.345909899,1.345909899,-0.936400444,-1.170500555,1,1,0
493,3,14,13,50,47,1,3350.826,74,1996.401,MORE,1162,1110,2272,1,2,-3,-0.281222538,3,-1.047645444,0.570374522,-0.112112042,97,50,47,1,-1.256536731,-1.170500555,-1.28755061,-1.266634981,0.840465944,0.840465944,-1.28755061,-1.170500555,1,0,1
494,3,15,46,110,124,1,3213.827,64,2802.476,MORE,-1592,2546,954,1,1,14,1.312371845,14,0.87303787,0.028021569,-0.194563736,234,110,124,0,1.475932034,1.170500555,1.716734147,-1.266634981,-1.728339121,1.728339121,1.716734147,1.170500555,0,0,0
495,3,16,27,91,80,0,5841.773,24,1498.958,MORE,-1996,3898,1902,4,1,-11,-1.031149307,11,0.349215148,-2.141390242,1.387043428,171,91,80,1,0.219395302,0.429183537,0,1.089895216,-2.105171817,2.105171817,0,0.429183537,0,1,0
496,3,17,40,64,80,1,2625.496,64,1514.057,MORE,504,1062,1566,1,2,16,1.499853537,16,1.222253018,0.028021569,-0.548645793,144,64,80,0,-0.31912044,-0.624266962,0,-1.266634981,0.226713681,0.226713681,0,-0.624266962,0,0,0
497,3,18,22,83,80,1,4849.473,64,3237.113,MORE,-788,2846,2058,3,1,-3,-0.281222538,3,-1.047645444,0.028021569,0.789836031,163,83,80,1,0.059835082,0.117050055,0,0.30438515,-0.978404744,0.978404744,0,0.117050055,0,1,0
498,3,19,54,101,110,1,3451.203,44,725.606,MORE,182,996,1178,1,2,9,0.843667615,9,0,-1.056684336,-0.05170099,211,101,110,0,1.017196402,0.819350388,1.170500555,-1.266634981,-0.073633171,0.073633171,1.170500555,0.819350388,0,0,0
499,3,20,6,56,50,0,7469.588,64,2444.55,MORE,-1608,3994,2386,2,1,-6,-0.562445076,6,-0.523822722,0.028021569,2.366730174,106,56,50,1,-1.077031484,-0.936400444,-1.170500555,-0.481124915,-1.743263188,1.743263188,-1.170500555,-0.936400444,0,0,0
500,3,21,18,50,42,0,3372.03,100,3686.445,MORE,1102,1362,2464,2,2,-8,-0.749926769,8,-0.174607574,1.980492199,-0.099350593,92,50,42,1,-1.356261869,-1.170500555,-1.482634036,-0.481124915,0.784500692,0.784500692,-1.482634036,-1.170500555,1,0,1
501,3,22,43,110,117,0,6138.022,74,3234.987,MORE,-1782,4238,2456,4,1,7,0.656185922,7,-0.349215148,0.570374522,1.565338393,227,110,117,0,1.336316841,1.170500555,1.443617351,1.089895216,-1.905562418,1.905562418,1.443617351,1.170500555,1,1,0
502,3,23,32,77,80,0,6402.819,64,1929.011,MORE,-410,2906,2496,3,1,3,0.281222538,3,-1.047645444,0.028021569,1.724704237,157,77,80,0,-0.059835082,-0.117050055,0,0.30438515,-0.625823657,0.625823657,0,-0.117050055,0,1,0
503,3,24,27,80,91,1,4444.338,44,771.748,MORE,758,1500,2258,3,2,11,1.031149307,11,0.349215148,-1.056684336,0.546008944,171,80,91,0,0.219395302,0,0.429183537,0.30438515,0.463633248,0.463633248,0.429183537,0,0,1,1
504,3,25,16,44,50,1,2608.586,64,3031.079,MORE,-366,1402,1036,1,1,6,0.562445076,6,-0.523822722,0.028021569,-0.558822934,94,44,50,0,-1.316371814,-1.404600665,-1.170500555,-1.266634981,-0.584782472,0.584782472,-1.170500555,-1.404600665,0,0,0
505,3,26,7,50,57,1,5440.032,74,2403.739,MORE,1292,2226,3518,3,2,7,0.656185922,7,-0.349215148,0.570374522,1.145258991,107,50,57,0,-1.057086457,-1.170500555,-0.897383758,0.30438515,0.96172399,0.96172399,-0.897383758,-1.170500555,1,1,1
506,3,27,14,50,46,0,5260.323,64,2340.049,MORE,-1358,2904,1546,4,1,-4,-0.374963384,4,-0.87303787,0.028021569,1.037102643,96,50,46,1,-1.276481759,-1.170500555,-1.326567295,1.089895216,-1.510074638,1.510074638,-1.326567295,-1.170500555,0,1,0
507,3,28,51,110,108,1,2857.7,100,3203.394,MORE,1722,1028,2750,1,2,-2,-0.187481692,2,-1.222253018,1.980492199,-0.408895771,218,110,108,1,1.156811594,1.170500555,1.092467184,-1.266634981,1.362808296,1.362808296,1.092467184,1.170500555,1,0,1
508,3,29,50,133,110,0,4622.699,84,2694.95,MORE,414,1764,2178,2,2,-23,-2.15603946,23,2.444506035,1.112727475,0.65335401,243,133,110,1,1.655437281,2.067884313,1.170500555,-0.481124915,0.142765803,0.142765803,1.170500555,2.067884313,1,1,0
509,3,30,49,131,110,0,4792.599,84,1396.167,MORE,-832,2770,1938,2,2,-21,-1.968557767,21,2.095290887,1.112727475,0.755606893,241,131,110,1,1.615547226,1.989850943,1.170500555,-0.481124915,-1.019445929,1.019445929,1.170500555,1.989850943,1,1,0
510,3,31,47,126,110,0,6148.765,64,1855.807,MORE,-58,2686,2628,4,2,-16,-1.499853537,16,1.222253018,0.028021569,1.571803977,236,126,110,1,1.515822089,1.794767517,1.170500555,1.089895216,-0.297494179,0.297494179,1.170500555,1.794767517,0,1,0
511,3,32,50,110,133,1,4290.5,74,2130.272,MORE,-488,1778,1290,3,2,23,2.15603946,23,2.444506035,0.570374522,0.45342284,243,110,133,0,1.655437281,1.170500555,2.067884313,0.30438515,-0.698578485,0.698578485,2.067884313,1.170500555,1,1,0
512,3,33,47,110,126,0,5208.041,54,4222.279,MORE,190,2208,2398,3,2,16,1.499853537,16,1.222253018,-0.514331383,1.005637162,236,110,126,0,1.515822089,1.170500555,1.794767517,0.30438515,-0.066171137,0.066171137,1.794767517,1.170500555,0,1,0
513,3,34,12,48,50,1,3034.445,74,2301.546,MORE,-36,1736,1700,1,1,2,0.187481692,2,-1.222253018,0.570374522,-0.302523282,98,48,50,0,-1.236591704,-1.248533925,-1.170500555,-1.266634981,-0.276973587,0.276973587,-1.170500555,-1.248533925,1,0,0
514,3,35,32,80,77,0,3584.427,44,3358.849,MORE,-314,1486,1172,3,2,-3,-0.281222538,3,-1.047645444,-1.056684336,0.028478752,157,80,77,1,-0.059835082,0,-0.117050055,0.30438515,-0.536279254,0.536279254,-0.117050055,0,0,1,0
515,3,36,43,117,110,0,6892.869,34,2022.415,MORE,-3180,4760,1580,3,1,-7,-0.656185922,7,-0.349215148,-1.599037289,2.019636701,227,117,110,1,1.336316841,1.443617351,1.170500555,0.30438515,-3.209552789,3.209552789,1.170500555,1.443617351,0,1,0
516,3,37,40,80,64,1,2476.989,64,1989.747,MORE,512,846,1358,1,2,-16,-1.499853537,16,1.222253018,0.028021569,-0.63802348,144,80,64,1,-0.31912044,0,-0.624266962,-1.266634981,0.234175715,0.234175715,-0.624266962,0,0,0,1
517,3,38,31,80,78,0,5866.721,54,3422.964,MORE,-820,2724,1904,4,1,-2,-0.187481692,2,-1.222253018,-0.514331383,1.402058171,158,80,78,1,-0.039890055,0,-0.07803337,1.089895216,-1.008252879,1.008252879,-0.07803337,0,0,1,0
518,3,39,46,124,110,1,7484.359,74,1121.826,MORE,632,2860,3492,4,2,-14,-1.312371845,14,0.87303787,0.570374522,2.375619975,234,124,110,1,1.475932034,1.716734147,1.170500555,1.089895216,0.346106219,0.346106219,1.170500555,1.716734147,1,1,1
519,3,40,58,92,110,1,2500.835,84,2785.633,MORE,-486,2920,2434,1,1,18,1.687335229,18,1.571468165,1.112727475,-0.623671965,202,92,110,0,0.837691154,0.468200222,1.170500555,-1.266634981,-0.696712976,0.696712976,1.170500555,0.468200222,1,0,0
520,3,41,49,110,131,1,4612.844,54,2462.211,LESS,-438,2672,2234,4,1,21,1.968557767,21,2.095290887,-0.514331383,0.647422861,241,110,131,1,1.615547226,1.170500555,1.989850943,1.089895216,-0.651940775,0.651940775,1.989850943,1.170500555,0,1,0
521,3,42,13,47,50,0,3098.964,74,2212.285,LESS,-502,1882,1380,2,2,3,0.281222538,3,-1.047645444,0.570374522,-0.263693065,97,47,50,1,-1.256536731,-1.28755061,-1.170500555,-0.481124915,-0.711637043,0.711637043,-1.170500555,-1.28755061,1,0,0
522,3,43,16,50,44,0,3949.32,64,1554.12,LESS,-912,2184,1272,2,2,-6,-0.562445076,6,-0.523822722,0.028021569,0.248086531,94,50,44,0,-1.316371814,-1.170500555,-1.404600665,-0.481124915,-1.094066265,1.094066265,-1.404600665,-1.170500555,0,0,0
523,3,44,7,57,50,1,3992.314,74,1978.8,LESS,1146,1526,2672,3,2,-7,-0.656185922,7,-0.349215148,0.570374522,0.273962107,107,57,50,0,-1.057086457,-0.897383758,-1.170500555,0.30438515,0.825541877,0.825541877,-1.170500555,-0.897383758,1,1,1
524,3,45,18,42,50,0,3063.877,84,1990.023,LESS,810,1516,2326,2,2,8,0.749926769,8,-0.174607574,1.112727475,-0.28480988,92,42,50,1,-1.356261869,-1.482634036,-1.170500555,-0.481124915,0.512136466,0.512136466,-1.170500555,-1.482634036,1,0,1
525,3,46,51,108,110,1,6334.299,54,1883.484,LESS,300,2936,3236,5,2,2,0.187481692,2,-1.222253018,-0.514331383,1.683466052,218,108,110,1,1.156811594,1.092467184,1.170500555,1.875405281,0.036431824,0.036431824,1.170500555,1.092467184,0,1,1
526,3,47,31,78,80,0,3503.517,34,1894.717,LESS,-2058,2898,840,2,1,2,0.187481692,2,-1.222253018,-1.599037289,-0.02021625,158,78,80,1,-0.039890055,-0.07803337,0,-0.481124915,-2.163002577,2.163002577,0,-0.07803337,0,0,0
527,3,48,58,110,92,1,5757.464,64,1905.616,LESS,1954,1690,3644,3,2,-18,-1.687335229,18,1.571468165,0.028021569,1.336302766,202,110,92,0,0.837691154,1.170500555,0.468200222,0.30438515,1.57920727,1.57920727,0.468200222,1.170500555,0,1,1
528,3,49,12,50,48,1,4202.759,74,1797.498,LESS,1674,1438,3112,3,2,-2,-0.187481692,2,-1.222253018,0.570374522,0.400616658,98,50,48,0,-1.236591704,-1.170500555,-1.248533925,0.30438515,1.318036094,1.318036094,-1.248533925,-1.170500555,1,1,1
529,3,50,54,110,101,1,3362.251,34,2235.186,LESS,-246,2244,1998,3,1,-9,-0.843667615,9,0,-1.599037289,-0.105236002,211,110,101,0,1.017196402,1.170500555,0.819350388,0.30438515,-0.472851968,0.472851968,0.819350388,1.170500555,0,1,0
530,3,51,14,46,50,0,4765.607,34,1568.435,LESS,-746,2338,1592,2,1,4,0.374963384,4,-0.87303787,-1.599037289,0.739361986,96,46,50,1,-1.276481759,-1.326567295,-1.170500555,-0.481124915,-0.939229068,0.939229068,-1.170500555,-1.326567295,0,0,0
531,3,52,22,80,83,0,4393.51,44,1769.991,LESS,-328,1530,1202,3,1,3,0.281222538,3,-1.047645444,-1.056684336,0.51541854,163,80,83,1,0.059835082,0,0.117050055,0.30438515,-0.549337813,0.549337813,0.117050055,0,0,1,0
532,3,53,6,50,56,0,2648.53,64,4160.237,LESS,-1542,2048,506,2,1,6,0.562445076,6,-0.523822722,0.028021569,-0.534782974,106,50,56,1,-1.077031484,-1.170500555,-0.936400444,-0.481124915,-1.681701411,1.681701411,-0.936400444,-1.170500555,0,0,0
533,3,54,13,50,47,1,3205.018,54,1604.865,LESS,110,1154,1264,2,2,-3,-0.281222538,3,-1.047645444,-0.514331383,-0.199865359,97,50,47,0,-1.256536731,-1.170500555,-1.28755061,-0.481124915,-0.140791473,0.140791473,-1.28755061,-1.170500555,0,0,1
534,3,55,46,110,124,0,2249.129,44,2250.827,LESS,-558,1112,554,2,1,14,1.312371845,14,0.87303787,-1.056684336,-0.775159101,234,110,124,1,1.475932034,1.170500555,1.716734147,-0.481124915,-0.763871279,0.763871279,1.716734147,1.170500555,0,0,0
535,3,56,27,91,80,1,3368.787,64,2044.698,LESS,478,976,1454,3,2,-11,-1.031149307,11,0.349215148,0.028021569,-0.101302365,171,91,80,0,0.219395302,0.429183537,0,0.30438515,0.202462072,0.202462072,0,0.429183537,0,1,1
536,3,57,40,64,80,0,1595.809,64,1788.87,LESS,-858,1178,320,2,1,16,1.499853537,16,1.222253018,0.028021569,-1.16835424,144,64,80,1,-0.31912044,-0.624266962,0,-0.481124915,-1.043697538,1.043697538,0,-0.624266962,0,0,0
537,3,58,22,83,80,0,2598.623,74,2876.996,LESS,-990,1536,546,2,1,-3,-0.281222538,3,-1.047645444,0.570374522,-0.564819081,163,83,80,0,0.059835082,0.117050055,0,-0.481124915,-1.166821093,1.166821093,0,0.117050055,1,0,0
538,3,59,54,101,110,1,3256.513,44,1213.877,LESS,472,1144,1616,3,2,9,0.843667615,9,0,-1.056684336,-0.168873527,211,101,110,1,1.017196402,0.819350388,1.170500555,0.30438515,0.196865547,0.196865547,1.170500555,0.819350388,0,1,1
539,3,60,6,56,50,1,2950.898,74,2144.099,LESS,968,800,1768,3,2,-6,-0.562445076,6,-0.523822722,0.570374522,-0.35280534,106,56,50,0,-1.077031484,-0.936400444,-1.170500555,0.30438515,0.65951163,0.65951163,-1.170500555,-0.936400444,1,1,1
540,3,61,18,50,42,0,2088.328,64,2299.789,LESS,-1402,1866,464,2,1,-8,-0.749926769,8,-0.174607574,0.028021569,-0.871935829,92,50,42,0,-1.356261869,-1.170500555,-1.482634036,-0.481124915,-1.551115823,1.551115823,-1.482634036,-1.170500555,1,0,0
541,3,62,43,110,117,0,2892.78,34,1750.508,LESS,-814,1716,902,3,1,7,0.656185922,7,-0.349215148,-1.599037289,-0.387783169,227,110,117,1,1.336316841,1.170500555,1.443617351,0.30438515,-1.002656354,1.002656354,1.443617351,1.170500555,0,1,0
542,3,63,32,77,80,1,3153.39,64,1526.588,LESS,978,1088,2066,3,2,3,0.281222538,3,-1.047645444,0.028021569,-0.230937235,157,77,80,1,-0.059835082,-0.117050055,0,0.30438515,0.668839172,0.668839172,0,-0.117050055,1,1,1
543,3,64,27,80,91,0,3489.703,64,1926.183,LESS,-1156,2242,1086,4,1,11,1.031149307,11,0.349215148,0.028021569,-0.028530089,171,80,91,1,0.219395302,0,0.429183537,1.089895216,-1.32165829,1.32165829,0.429183537,0,1,1,0
544,3,65,16,44,50,0,1597.213,64,1797.361,LESS,-688,1060,372,2,1,6,0.562445076,6,-0.523822722,0.028021569,-1.167509254,94,44,50,1,-1.316371814,-1.404600665,-1.170500555,-0.481124915,-0.885129324,0.885129324,-1.170500555,-1.404600665,1,0,0
545,3,66,7,50,57,0,2715.458,74,2136.612,LESS,-672,1294,622,2,1,7,0.656185922,7,-0.349215148,0.570374522,-0.494502921,107,50,57,1,-1.057086457,-1.170500555,-0.897383758,-0.481124915,-0.870205257,0.870205257,-0.897383758,-1.170500555,1,0,0
546,3,67,14,50,46,1,3544.648,64,3482.712,LESS,-24,1412,1388,3,1,-4,-0.374963384,4,-0.87303787,0.028021569,0.004538096,96,50,46,0,-1.276481759,-1.170500555,-1.326567295,0.30438515,-0.265780536,0.265780536,-1.326567295,-1.170500555,1,1,1
547,3,68,51,110,108,1,5488.943,64,2176.056,LESS,1046,1348,2394,2,1,-2,-0.187481692,2,-1.222253018,0.028021569,1.174695664,218,110,108,0,1.156811594,1.170500555,1.092467184,-0.481124915,0.732266457,0.732266457,1.092467184,1.170500555,1,0,1
548,3,69,50,133,110,1,2793.11,74,2037.879,LESS,1170,964,2134,3,2,-23,-2.15603946,23,2.444506035,0.570374522,-0.447768719,243,133,110,0,1.655437281,2.067884313,1.170500555,0.30438515,0.847927978,0.847927978,1.170500555,2.067884313,1,1,1
549,3,70,49,131,110,1,3888.358,64,713.33,LESS,-88,1246,1158,3,2,-21,-1.968557767,21,2.095290887,0.028021569,0.211397064,241,131,110,0,1.615547226,1.989850943,1.170500555,0.30438515,-0.325476805,0.325476805,1.170500555,1.989850943,1,1,0
550,3,71,47,126,110,1,3968.847,64,2568.112,LESS,-176,1850,1674,3,2,-16,-1.499853537,16,1.222253018,0.028021569,0.259838691,236,126,110,0,1.515822089,1.794767517,1.170500555,0.30438515,-0.407559174,0.407559174,1.170500555,1.794767517,1,1,0
551,3,72,50,110,133,0,5034.733,74,1963.237,LESS,-1102,2552,1450,4,1,23,2.15603946,23,2.444506035,0.570374522,0.901333202,243,110,133,1,1.655437281,1.170500555,2.067884313,1.089895216,-1.271289563,1.271289563,2.067884313,1.170500555,1,1,0
552,3,73,47,110,126,0,2112.499,74,1582.693,LESS,-314,790,476,2,1,16,1.499853537,16,1.222253018,0.570374522,-0.857388716,236,110,126,1,1.515822089,1.170500555,1.794767517,-0.481124915,-0.536279254,0.536279254,1.794767517,1.170500555,1,0,0
553,3,74,12,48,50,0,2296.662,100,2962.217,LESS,1076,1276,2352,2,2,2,0.187481692,2,-1.222253018,1.980492199,-0.746551766,98,48,50,1,-1.236591704,-1.248533925,-1.170500555,-0.481124915,0.760249083,0.760249083,-1.170500555,-1.248533925,1,0,1
554,3,75,32,80,77,0,3646.655,74,2014.852,LESS,-596,1720,1124,2,2,-3,-0.281222538,3,-1.047645444,0.570374522,0.06593015,157,80,77,0,-0.059835082,0,-0.117050055,-0.481124915,-0.799315938,0.799315938,-0.117050055,0,1,0,0
555,3,76,43,117,110,1,4058.004,74,2567.62,LESS,216,1396,1612,3,1,-7,-0.656185922,7,-0.349215148,0.570374522,0.31349708,227,117,110,0,1.336316841,1.443617351,1.170500555,0.30438515,-0.041919528,0.041919528,1.170500555,1.443617351,1,1,1
556,3,77,40,80,64,1,4104.806,74,2524.782,LESS,1586,1138,2724,3,2,-16,-1.499853537,16,1.222253018,0.570374522,0.34166447,144,80,64,0,-0.31912044,0,-0.624266962,0.30438515,1.235953725,1.235953725,-0.624266962,0,1,1,1
557,3,78,31,80,78,0,2157.565,64,1353.501,LESS,-410,912,502,2,1,-2,-0.187481692,2,-1.222253018,0.028021569,-0.830266123,158,80,78,0,-0.039890055,0,-0.07803337,-0.481124915,-0.625823657,0.625823657,-0.07803337,0,0,0,0
558,3,79,46,124,110,1,5902.977,44,585.043,LESS,1246,1836,3082,5,2,-14,-1.312371845,14,0.87303787,-1.056684336,1.423878539,234,124,110,0,1.475932034,1.716734147,1.170500555,1.875405281,0.918817297,0.918817297,1.170500555,1.716734147,0,1,1
559,3,80,58,92,110,0,3965.283,34,2883.59,LESS,-1384,2458,1074,2,1,18,1.687335229,18,1.571468165,-1.599037289,0.257693728,202,92,110,1,0.837691154,0.468200222,1.170500555,-0.481124915,-1.534326247,1.534326247,1.170500555,0.468200222,0,0,0
560,3,81,48,128,110,0,3428.153,84,1380.24,MORE,-1710,2526,816,2,2,-18,-1.687335229,18,1.571468165,1.112727475,-0.065573438,238,128,110,1,1.555712144,1.872800887,1.170500555,-0.481124915,-1.838404116,1.838404116,1.170500555,1.872800887,1,1,0
561,3,82,8,50,58,1,2432.49,84,1798.524,MORE,1666,922,2588,1,2,8,0.749926769,8,-0.174607574,1.112727475,-0.664804828,108,50,58,0,-1.037141429,-1.170500555,-0.858367073,-1.266634981,1.310574061,1.310574061,-0.858367073,-1.170500555,1,0,1
562,3,83,4,54,50,0,4460.86,34,1331.93,MORE,-682,2266,1584,4,1,-4,-0.374963384,4,-0.87303787,-1.599037289,0.555952571,104,54,50,1,-1.116921539,-1.014433814,-1.170500555,1.089895216,-0.879532799,0.879532799,-1.170500555,-1.014433814,0,1,0
563,3,84,37,80,69,0,3493.201,64,1771.068,MORE,-860,1664,804,2,1,-11,-1.031149307,11,0.349215148,0.028021569,-0.026424847,149,80,69,1,-0.219395302,0,-0.429183537,-0.481124915,-1.045563047,1.045563047,-0.429183537,0,0,1,0
564,3,85,52,105,110,1,3374.089,100,2104.57,MORE,1774,1098,2872,3,2,5,0.46870423,5,-0.698430296,1.980492199,-0.098111401,215,105,110,0,1.096976512,0.975417129,1.170500555,0.30438515,1.411311514,1.411311514,1.170500555,0.975417129,1,1,1
565,3,86,5,55,50,0,2623.875,74,1835.011,MORE,-476,1114,638,2,1,-5,-0.46870423,5,-0.698430296,0.570374522,-0.549621378,105,55,50,1,-1.096976512,-0.975417129,-1.170500555,-0.481124915,-0.687385434,0.687385434,-1.170500555,-0.975417129,1,1,0
566,3,87,30,96,80,0,4936.822,64,2353.125,MORE,-342,1510,1168,3,1,-16,-1.499853537,16,1.222253018,0.028021569,0.842406291,176,96,80,1,0.31912044,0.624266962,0,0.30438515,-0.562396371,0.562396371,0,0.624266962,0,1,0
567,3,88,33,80,75,0,6600.851,54,1804.855,MORE,-1336,3460,2124,6,1,-5,-0.46870423,5,-0.698430296,-0.514331383,1.843888128,155,80,75,1,-0.099725137,0,-0.195083426,2.660915347,-1.489554046,1.489554046,-0.195083426,0,0,1,0
568,3,89,48,110,128,1,3039.455,74,2355.125,MORE,530,1438,1968,1,2,18,1.687335229,18,1.571468165,0.570374522,-0.299508055,238,110,128,0,1.555712144,1.170500555,1.872800887,-1.266634981,0.25096529,0.25096529,1.872800887,1.170500555,1,0,1
569,3,90,9,59,50,0,4171.929,54,2003.006,MORE,-1048,2398,1350,4,1,-9,-0.843667615,9,0,-0.514331383,0.382061882,109,59,50,1,-1.017196402,-0.819350388,-1.170500555,1.089895216,-1.220920836,1.220920836,-1.170500555,-0.819350388,0,1,0
570,3,91,44,110,119,1,2621.556,84,1079.648,MORE,1342,698,2040,1,2,9,0.843667615,9,0,1.112727475,-0.551017048,229,110,119,0,1.376206896,1.170500555,1.521650721,-1.266634981,1.0083617,1.0083617,1.521650721,1.170500555,1,0,1
571,3,92,2,52,50,0,4225.163,24,1745.363,MORE,-258,1688,1430,3,1,-2,-0.187481692,2,-1.222253018,-2.141390242,0.414100317,102,52,50,1,-1.156811594,-1.092467184,-1.170500555,0.30438515,-0.484045019,0.484045019,-1.170500555,-1.092467184,0,1,0
572,3,93,8,58,50,1,1730.156,74,1233.163,MORE,812,422,1234,1,2,-8,-0.749926769,8,-0.174607574,0.570374522,-1.08749863,108,58,50,1,-1.037141429,-0.858367073,-1.170500555,-1.266634981,0.514001974,0.514001974,-1.170500555,-0.858367073,1,0,1
573,3,94,44,119,110,0,2161.17,74,2439.168,MORE,-716,1292,576,2,1,-9,-0.843667615,9,0,0.570374522,-0.828096484,229,119,110,1,1.376206896,1.521650721,1.170500555,-0.481124915,-0.911246442,0.911246442,1.170500555,1.521650721,1,1,0
574,3,95,34,74,80,0,5793.635,74,957.006,MORE,-56,2004,1948,4,1,6,0.562445076,6,-0.523822722,0.570374522,1.358071978,154,74,80,0,-0.119670165,-0.234100111,0,1.089895216,-0.295628671,0.295628671,0,-0.234100111,1,1,0
575,3,96,24,86,80,0,6880.526,64,2708.064,MORE,-1168,3814,2646,6,1,-6,-0.562445076,6,-0.523822722,0.028021569,2.012208171,166,86,80,1,0.119670165,0.234100111,0,2.660915347,-1.33285134,1.33285134,0,0.234100111,0,1,0
576,3,97,39,66,80,1,1503.644,100,2019.125,MORE,1486,476,1962,1,2,14,1.312371845,14,0.87303787,1.980492199,-1.223822969,146,66,80,0,-0.279230385,-0.546233592,0,-1.266634981,1.142678305,1.142678305,0,-0.546233592,1,0,1
577,3,98,9,50,59,1,3599.021,84,2006.084,MORE,1912,424,2336,1,2,9,0.843667615,9,0,1.112727475,0.037262028,109,50,59,0,-1.017196402,-1.170500555,-0.819350388,-1.266634981,1.540031594,1.540031594,-0.819350388,-1.170500555,1,0,1
578,3,99,57,94,110,1,4647.386,84,1317.462,MORE,1458,1258,2716,2,2,16,1.499853537,16,1.222253018,1.112727475,0.668211673,204,94,110,0,0.877581209,0.546233592,1.170500555,-0.481124915,1.116561187,1.116561187,1.170500555,0.546233592,1,0,1
579,3,100,60,110,87,0,2104.608,74,1374.452,MORE,134,1244,1378,2,2,-23,-2.15603946,23,2.444506035,0.570374522,-0.862137848,197,110,87,1,0.737966017,1.170500555,0.273116796,-0.481124915,-0.118405373,0.118405373,0.273116796,1.170500555,1,0,0
580,3,101,33,75,80,1,3663.508,24,1678.636,MORE,520,1286,1806,3,2,5,0.46870423,5,-0.698430296,-2.141390242,0.076072986,155,75,80,0,-0.099725137,-0.195083426,0,0.30438515,0.241637748,0.241637748,0,-0.195083426,0,1,1
581,3,102,15,50,45,1,1428.75,64,1692.418,MORE,564,452,1016,1,2,-5,-0.46870423,5,-0.698430296,0.028021569,-1.268897292,95,50,45,1,-1.296426786,-1.170500555,-1.36558398,-1.266634981,0.282678933,0.282678933,-1.36558398,-1.170500555,0,0,1
582,3,103,59,89,110,1,1818.229,94,1936.556,MORE,2126,510,2636,1,2,21,1.968557767,21,2.095290887,1.655080427,-1.034492637,199,89,110,0,0.777856072,0.351150166,1.170500555,-1.266634981,1.739640992,1.739640992,1.170500555,0.351150166,1,0,1
583,3,104,29,80,94,1,2621.649,84,1159.634,MORE,1088,1060,2148,3,2,14,1.312371845,14,0.87303787,1.112727475,-0.550961077,174,80,94,0,0.279230385,0,0.546233592,0.30438515,0.771442133,0.771442133,0.546233592,0,1,1,1
584,3,105,55,110,98,0,1861.231,74,1896.784,MORE,504,798,1302,2,2,-12,-1.124890153,12,0.523822722,0.570374522,-1.008612245,208,110,98,1,0.957361319,1.170500555,0.702300333,-0.481124915,0.226713681,0.226713681,0.702300333,1.170500555,1,0,1
585,3,106,29,94,80,0,1986.401,84,3523.269,MORE,2630,906,3536,2,2,-14,-1.312371845,14,0.87303787,1.112727475,-0.933279735,174,94,80,1,0.279230385,0.546233592,0,-0.481124915,2.209749109,2.209749109,0,0.546233592,1,0,1
586,3,107,57,110,94,1,2072.406,84,2357.011,MORE,2132,554,2686,3,2,-16,-1.499853537,16,1.222253018,1.112727475,-0.88151835,204,110,94,1,0.877581209,1.170500555,0.546233592,0.30438515,1.745237517,1.745237517,0.546233592,1.170500555,1,1,1
587,3,108,39,80,66,0,2149.11,64,1502.045,MORE,-410,1000,590,2,1,-14,-1.312371845,14,0.87303787,0.028021569,-0.835354694,146,80,66,1,-0.279230385,0,-0.546233592,-0.481124915,-0.625823657,0.625823657,-0.546233592,0,0,0,0
588,3,109,4,50,54,1,1708.406,34,434.293,MORE,764,186,950,1,2,4,0.374963384,4,-0.87303787,-1.599037289,-1.100588684,104,50,54,0,-1.116921539,-1.170500555,-1.014433814,-1.266634981,0.469229773,0.469229773,-1.014433814,-1.170500555,0,0,1
589,3,110,55,98,110,1,1849.511,74,1565.848,MORE,1596,386,1982,1,2,12,1.124890153,12,0.523822722,0.570374522,-1.015665828,208,98,110,0,0.957361319,0.702300333,1.170500555,-1.266634981,1.245281267,1.245281267,1.170500555,0.702300333,1,0,1
590,3,111,2,50,52,1,1632.089,74,2265.239,MORE,802,376,1178,1,2,2,0.187481692,2,-1.222253018,0.570374522,-1.146519428,102,50,52,0,-1.156811594,-1.170500555,-1.092467184,-1.266634981,0.504674432,0.504674432,-1.092467184,-1.170500555,1,0,1
591,3,112,59,110,89,0,1427.93,74,1739.304,MORE,-220,896,676,2,2,-21,-1.968557767,21,2.095290887,0.570374522,-1.269390802,199,110,89,1,0.777856072,1.170500555,0.351150166,-0.481124915,-0.448600359,0.448600359,0.351150166,1.170500555,1,0,0
592,3,113,60,87,110,1,2591.58,64,1398.915,MORE,1400,734,2134,3,2,23,2.15603946,23,2.444506035,0.028021569,-0.569057852,197,87,110,0,0.737966017,0.273116796,1.170500555,0.30438515,1.062461444,1.062461444,1.170500555,0.273116796,0,1,1
593,3,114,52,110,105,1,3163.686,34,565.792,MORE,546,924,1470,3,2,-5,-0.46870423,5,-0.698430296,-1.599037289,-0.224740675,215,110,105,1,1.096976512,1.170500555,0.975417129,0.30438515,0.265889357,0.265889357,0.975417129,1.170500555,0,1,1
594,3,115,30,80,96,1,2995.507,100,3384.773,MORE,3212,322,3534,1,2,16,1.499853537,16,1.222253018,1.980492199,-0.325957789,176,80,96,0,0.31912044,0,0.624266962,-1.266634981,2.752612053,2.752612053,0.624266962,0,1,0,1
595,3,116,24,80,86,1,2408.271,44,2135.296,MORE,396,584,980,1,1,6,0.562445076,6,-0.523822722,-1.056684336,-0.679380829,166,80,86,0,0.119670165,0,0.234100111,-1.266634981,0.125976228,0.125976228,0.234100111,0,0,0,0
596,3,117,5,50,55,1,1715.706,74,490.818,MORE,526,404,930,1,2,5,0.46870423,5,-0.698430296,0.570374522,-1.096195241,105,50,55,0,-1.096976512,-1.170500555,-0.975417129,-1.266634981,0.247234273,0.247234273,-0.975417129,-1.170500555,1,0,1
597,3,118,34,80,74,0,4161.494,54,1424.305,MORE,-884,2220,1336,4,1,-6,-0.562445076,6,-0.523822722,-0.514331383,0.375781665,154,80,74,1,-0.119670165,0,-0.234100111,1.089895216,-1.067949147,1.067949147,-0.234100111,0,0,1,0
598,3,119,15,45,50,1,4250.03,74,1698.354,MORE,3926,438,4364,1,2,5,0.46870423,5,-0.698430296,0.570374522,0.429066311,95,45,50,0,-1.296426786,-1.36558398,-1.170500555,-1.266634981,3.418598551,3.418598551,-1.170500555,-1.36558398,1,0,1
599,3,120,37,69,80,1,1883.502,44,686.689,MORE,1256,416,1672,1,2,11,1.031149307,11,0.349215148,-1.056684336,-0.995208631,149,69,80,0,-0.219395302,-0.429183537,0,-1.266634981,0.928144839,0.928144839,0,-0.429183537,0,0,1
600,3,121,48,128,110,1,2874.212,74,2566.818,LESS,10,1122,1132,1,2,-18,-1.687335229,18,1.571468165,0.570374522,-0.398958163,238,128,110,0,1.555712144,1.872800887,1.170500555,-1.266634981,-0.234066893,0.234066893,1.170500555,1.872800887,1,0,1
601,3,122,8,50,58,0,1905.035,74,1705.291,LESS,-10,1086,1076,2,1,8,0.749926769,8,-0.174607574,0.570374522,-0.982249177,108,50,58,1,-1.037141429,-1.170500555,-0.858367073,-0.481124915,-0.252721977,0.252721977,-0.858367073,-1.170500555,1,0,1
602,3,123,4,54,50,0,3598.064,54,1511.513,LESS,-262,1902,1640,2,2,-4,-0.374963384,4,-0.87303787,-0.514331383,0.036686066,104,54,50,0,-1.116921539,-1.014433814,-1.170500555,-0.481124915,-0.487776036,0.487776036,-1.170500555,-1.014433814,0,0,0
603,3,124,37,80,69,1,4363.497,20,2500.996,LESS,-1356,3222,1866,4,1,-11,-1.031149307,11,0.349215148,-2.358331423,0.497355469,149,80,69,0,-0.219395302,0,-0.429183537,1.089895216,-1.50820913,1.50820913,-0.429183537,0,0,1,0
604,3,125,52,105,110,0,3112.865,34,1713.532,LESS,-940,1434,494,2,1,5,0.46870423,5,-0.698430296,-1.599037289,-0.255326865,215,105,110,1,1.096976512,0.975417129,1.170500555,-0.481124915,-1.120183383,1.120183383,1.170500555,0.975417129,0,0,0
605,3,126,5,55,50,0,1884.503,84,1365.648,LESS,242,482,724,2,2,-5,-0.46870423,5,-0.698430296,1.112727475,-0.994606188,105,55,50,0,-1.096976512,-0.975417129,-1.170500555,-0.481124915,-0.017667919,0.017667919,-1.170500555,-0.975417129,1,0,1
606,3,127,30,96,80,0,1983.844,64,1289.754,LESS,88,924,1012,2,2,-16,-1.499853537,16,1.222253018,0.028021569,-0.934818644,176,96,80,0,0.31912044,0.624266962,0,-0.481124915,-0.161312066,0.161312066,0,0.624266962,1,0,1
607,3,128,33,80,75,1,3481.898,74,1122.545,LESS,992,1050,2042,2,2,-5,-0.46870423,5,-0.698430296,0.570374522,-0.033227463,155,80,75,0,-0.099725137,0,-0.195083426,-0.481124915,0.68189773,0.68189773,-0.195083426,0,1,0,1
608,3,129,48,110,128,0,1740.578,34,1259.018,LESS,-522,952,430,2,1,18,1.687335229,18,1.571468165,-1.599037289,-1.081226237,238,110,128,1,1.555712144,1.170500555,1.872800887,-0.481124915,-0.730292127,0.730292127,1.872800887,1.170500555,0,0,0
609,3,130,9,59,50,1,2775.34,74,2039.082,LESS,998,912,1910,3,2,-9,-0.843667615,9,0,0.570374522,-0.458463443,109,59,50,0,-1.017196402,-0.819350388,-1.170500555,0.30438515,0.687494256,0.687494256,-1.170500555,-0.819350388,1,1,1
610,3,131,44,110,119,0,3192.21,24,1241.249,LESS,-58,1230,1172,4,1,9,0.843667615,9,0,-2.141390242,-0.207573745,229,110,119,1,1.376206896,1.170500555,1.521650721,1.089895216,-0.297494179,0.297494179,1.521650721,1.170500555,0,1,1
611,3,132,2,52,50,0,2788.262,64,1998.193,LESS,-122,1248,1126,4,1,-2,-0.187481692,2,-1.222253018,0.028021569,-0.450686447,102,52,50,0,-1.156811594,-1.092467184,-1.170500555,1.089895216,-0.357190448,0.357190448,-1.170500555,-1.092467184,1,1,0
612,3,133,8,58,50,0,2021.154,54,1230.317,LESS,-652,1154,502,2,1,-8,-0.749926769,8,-0.174607574,-0.514331383,-0.912363935,108,58,50,0,-1.037141429,-0.858367073,-1.170500555,-0.481124915,-0.851550173,0.851550173,-1.170500555,-0.858367073,0,0,0
613,3,134,44,119,110,0,2046.904,44,1541.174,LESS,-102,912,810,2,1,-9,-0.843667615,9,0,-1.056684336,-0.896866514,229,119,110,0,1.376206896,1.521650721,1.170500555,-0.481124915,-0.338535364,0.338535364,1.170500555,1.521650721,0,0,0
614,3,135,34,74,80,0,2458.908,54,2183.71,LESS,-78,952,874,3,2,6,0.562445076,6,-0.523822722,-0.514331383,-0.648905377,154,74,80,1,-0.119670165,-0.234100111,0,0.30438515,-0.316149263,0.316149263,0,-0.234100111,0,1,1
615,3,136,24,86,80,0,11284.041,54,2586.765,LESS,-1900,3162,1262,5,1,-6,-0.562445076,6,-0.523822722,-0.514331383,4.662426581,166,86,80,0,0.119670165,0.234100111,0,1.875405281,-2.015627414,2.015627414,0,0.234100111,0,1,0
616,3,137,39,66,80,0,2205.452,84,1902.58,LESS,548,1084,1632,2,2,14,1.312371845,14,0.87303787,1.112727475,-0.801445736,146,66,80,1,-0.279230385,-0.546233592,0,-0.481124915,0.267754866,0.267754866,0,-0.546233592,1,0,1
617,3,138,9,50,59,1,2938.959,74,2685.017,LESS,-704,1814,1110,3,1,9,0.843667615,9,0,0.570374522,-0.359990727,109,50,59,1,-1.017196402,-1.170500555,-0.819350388,0.30438515,-0.900053392,0.900053392,-0.819350388,-1.170500555,1,1,0
618,3,139,57,94,110,0,2075.831,44,1203.137,LESS,-446,844,398,2,1,16,1.499853537,16,1.222253018,-1.056684336,-0.879457043,204,94,110,1,0.877581209,0.546233592,1.170500555,-0.481124915,-0.659402808,0.659402808,1.170500555,0.546233592,0,0,0
619,3,140,60,110,87,1,6006.701,74,1325.269,LESS,628,1806,2434,2,2,-23,-2.15603946,23,2.444506035,0.570374522,1.486303955,197,110,87,0,0.737966017,1.170500555,0.273116796,-0.481124915,0.342375202,0.342375202,0.273116796,1.170500555,1,0,1
620,3,141,33,75,80,0,5185.448,64,2990.763,LESS,-476,2754,2278,6,2,5,0.46870423,5,-0.698430296,0.028021569,0.992039755,155,75,80,1,-0.099725137,-0.195083426,0,2.660915347,-0.687385434,0.687385434,0,-0.195083426,1,1,0
621,3,142,15,50,45,0,2171.165,74,2199.569,LESS,-94,1346,1252,4,1,-5,-0.46870423,5,-0.698430296,0.570374522,-0.822081078,95,50,45,0,-1.296426786,-1.170500555,-1.36558398,1.089895216,-0.33107333,0.33107333,-1.36558398,-1.170500555,1,1,0
622,3,143,59,89,110,0,2231.588,74,1318.379,LESS,-282,1378,1096,2,2,21,1.968557767,21,2.095290887,0.570374522,-0.785716004,199,89,110,1,0.777856072,0.351150166,1.170500555,-0.481124915,-0.50643112,0.50643112,1.170500555,0.351150166,1,0,0
623,3,144,29,80,94,0,6749.729,34,2101.397,LESS,-1696,3744,2048,5,1,14,1.312371845,14,0.87303787,-1.599037289,1.933489098,174,80,94,1,0.279230385,0,0.546233592,1.875405281,-1.825345557,1.825345557,0.546233592,0,0,1,0
624,3,145,55,110,98,1,1702.985,74,1857.417,LESS,1536,438,1974,1,2,-12,-1.124890153,12,0.523822722,0.570374522,-1.103851267,208,110,98,0,0.957361319,1.170500555,0.702300333,-1.266634981,1.189316015,1.189316015,0.702300333,1.170500555,1,0,1
625,3,146,29,94,80,1,4327.1,84,1458.464,LESS,1724,912,2636,3,2,-14,-1.312371845,14,0.87303787,1.112727475,0.475450241,174,94,80,0,0.279230385,0.546233592,0,0.30438515,1.364673804,1.364673804,0,0.546233592,1,1,1
626,3,147,57,110,94,1,2781.398,64,3004.275,LESS,326,730,1056,1,1,-16,-1.499853537,16,1.222253018,0.028021569,-0.454817487,204,110,94,0,0.877581209,1.170500555,0.546233592,-1.266634981,0.060683434,0.060683434,0.546233592,1.170500555,1,0,1
627,3,148,39,80,66,0,2153.141,74,1749.562,LESS,-126,852,726,2,2,-14,-1.312371845,14,0.87303787,0.570374522,-0.83292867,146,80,66,0,-0.279230385,0,-0.546233592,-0.481124915,-0.360921464,0.360921464,-0.546233592,0,1,0,0
628,3,149,4,50,54,0,5509.326,34,1680.692,LESS,-560,2588,2028,6,1,4,0.374963384,4,-0.87303787,-1.599037289,1.186963001,104,50,54,1,-1.116921539,-1.170500555,-1.014433814,2.660915347,-0.765736787,0.765736787,-1.014433814,-1.170500555,0,1,0
629,3,150,55,98,110,0,3790.565,64,1435.275,LESS,-566,1872,1306,4,1,12,1.124890153,12,0.523822722,0.028021569,0.152541171,208,98,110,1,0.957361319,0.702300333,1.170500555,1.089895216,-0.771333312,0.771333312,1.170500555,0.702300333,0,1,0
630,3,151,2,50,52,0,1935.545,64,1712.199,LESS,-174,1184,1010,2,2,2,0.187481692,2,-1.222253018,0.028021569,-0.96388699,102,50,52,1,-1.156811594,-1.170500555,-1.092467184,-0.481124915,-0.405693666,0.405693666,-1.092467184,-1.170500555,0,0,0
631,3,152,59,110,89,1,5071.439,74,2358.602,LESS,442,1892,2334,5,2,-21,-1.968557767,21,2.095290887,0.570374522,0.923424399,199,110,89,0,0.777856072,1.170500555,0.351150166,1.875405281,0.168882921,0.168882921,0.351150166,1.170500555,1,1,1
632,3,153,60,87,110,0,1970.037,34,1063.484,LESS,-174,754,580,2,1,23,2.15603946,23,2.444506035,-1.599037289,-0.943128271,197,87,110,1,0.737966017,0.273116796,1.170500555,-0.481124915,-0.405693666,0.405693666,1.170500555,0.273116796,0,0,0
633,3,154,52,110,105,0,1915.188,74,1313.122,LESS,-342,818,476,2,2,-5,-0.46870423,5,-0.698430296,0.570374522,-0.976138679,215,110,105,0,1.096976512,1.170500555,0.975417129,-0.481124915,-0.562396371,0.562396371,0.975417129,1.170500555,1,0,0
634,3,155,30,80,96,0,1806.863,84,1586.736,LESS,682,924,1606,2,2,16,1.499853537,16,1.222253018,1.112727475,-1.041333168,176,80,96,1,0.31912044,0,0.624266962,-0.481124915,0.392743929,0.392743929,0.624266962,0,1,0,1
635,3,156,24,80,86,0,3215.543,44,1895.31,LESS,288,1226,1514,4,2,6,0.562445076,6,-0.523822722,-1.056684336,-0.193530976,166,80,86,1,0.119670165,0,0.234100111,1.089895216,0.025238774,0.025238774,0.234100111,0,0,1,1
636,3,157,5,50,55,0,3040.316,44,2008.127,LESS,-526,1054,528,2,1,5,0.46870423,5,-0.698430296,-1.056684336,-0.29898987,105,50,55,1,-1.096976512,-1.170500555,-0.975417129,-0.481124915,-0.734023144,0.734023144,-0.975417129,-1.170500555,0,0,0
637,3,158,34,80,74,1,2795.694,44,514.926,LESS,204,1060,1264,3,2,-6,-0.562445076,6,-0.523822722,-1.056684336,-0.44621356,154,80,74,0,-0.119670165,0,-0.234100111,0.30438515,-0.053112579,0.053112579,-0.234100111,0,0,1,1
638,3,159,15,45,50,0,2434.871,64,1658.349,LESS,-762,1248,486,2,1,5,0.46870423,5,-0.698430296,0.028021569,-0.663371843,95,45,50,1,-1.296426786,-1.36558398,-1.170500555,-0.481124915,-0.954153135,0.954153135,-1.170500555,-1.36558398,1,0,0
639,3,160,37,69,80,0,2171.063,74,1331.854,LESS,-946,1526,580,2,1,11,1.031149307,11,0.349215148,0.570374522,-0.822142466,149,69,80,1,-0.219395302,-0.429183537,0,-0.481124915,-1.125779908,1.125779908,0,-0.429183537,1,0,0
640,3,161,3,50,53,1,3463.021,74,2280.503,MORE,1518,686,2204,1,2,3,0.281222538,3,-1.047645444,0.570374522,-0.044588426,103,50,53,0,-1.136866566,-1.170500555,-1.053450499,-1.266634981,1.172526439,1.172526439,-1.053450499,-1.170500555,1,0,1
641,3,162,20,50,40,1,4614.063,64,2201.647,MORE,-88,1838,1750,4,2,-10,-0.937408461,10,0.174607574,0.028021569,0.648156506,90,50,40,1,-1.396151924,-1.170500555,-1.560667406,1.089895216,-0.325476805,0.325476805,-1.560667406,-1.170500555,0,1,0
642,3,163,25,80,88,1,3670.417,54,1477.123,MORE,122,1190,1312,3,2,8,0.749926769,8,-0.174607574,-0.514331383,0.080231109,168,80,88,0,0.15956022,0,0.312133481,0.30438515,-0.129598423,0.129598423,0.312133481,0,0,1,0
643,3,164,42,115,110,0,1955.291,74,1578.065,MORE,514,796,1310,2,2,-5,-0.46870423,5,-0.698430296,0.570374522,-0.952003026,225,115,110,1,1.296426786,1.36558398,1.170500555,-0.481124915,0.236041223,0.236041223,1.170500555,1.36558398,1,0,1
644,3,165,53,103,110,1,2539.423,34,1759.713,MORE,1236,550,1786,1,2,7,0.656185922,7,-0.349215148,-1.599037289,-0.600448103,213,103,110,0,1.057086457,0.897383758,1.170500555,-1.266634981,0.909489755,0.909489755,1.170500555,0.897383758,0,0,1
645,3,166,26,90,80,0,2504.688,84,1093.269,MORE,398,1086,1484,2,1,-10,-0.937408461,10,0.174607574,1.112727475,-0.62135307,170,90,80,1,0.199450275,0.390166852,0,-0.481124915,0.127841736,0.127841736,0,0.390166852,1,0,0
646,3,167,35,80,72,0,2264.841,84,1741.521,MORE,770,1288,2058,2,1,-8,-0.749926769,8,-0.174607574,1.112727475,-0.765702966,152,80,72,1,-0.15956022,0,-0.312133481,-0.481124915,0.474826298,0.474826298,-0.312133481,0,1,0,1
647,3,168,28,93,80,0,3871.268,74,1606.846,MORE,-258,1842,1584,4,2,-13,-1.218630999,13,0.698430296,0.570374522,0.201111592,173,93,80,1,0.259285357,0.507216907,0,1.089895216,-0.484045019,0.484045019,0,0.507216907,0,1,0
648,3,169,26,80,90,0,2988.316,74,1559.854,MORE,386,1152,1538,4,2,10,0.937408461,10,0.174607574,0.570374522,-0.330285632,170,80,90,0,0.199450275,0,0.390166852,1.089895216,0.116648686,0.116648686,0.390166852,0,0,1,0
649,3,170,25,88,80,0,3182.992,54,1493.888,MORE,-668,1498,830,4,1,-8,-0.749926769,8,-0.174607574,-0.514331383,-0.213121521,168,88,80,1,0.15956022,0.312133481,0,1.089895216,-0.86647424,0.86647424,0,0.312133481,0,1,0
650,3,171,36,80,70,1,2879.908,34,1709.7,MORE,370,1056,1426,3,2,-10,-0.937408461,10,0.174607574,-1.599037289,-0.395530073,150,80,70,1,-0.199450275,0,-0.390166852,0.30438515,0.101724618,0.101724618,-0.390166852,0,0,1,0
651,3,172,28,80,93,1,3832.523,74,2177.333,MORE,1418,1566,2984,2,2,13,1.218630999,13,0.698430296,0.570374522,0.17779324,173,80,93,0,0.259285357,0,0.507216907,-0.481124915,1.079251019,1.079251019,0.507216907,0,1,0,1
652,3,173,21,82,80,0,3374.473,100,4651.848,MORE,1268,2042,3310,2,2,-2,-0.187481692,2,-1.222253018,1.980492199,-0.097880294,162,82,80,1,0.039890055,0.07803337,0,-0.481124915,0.939337889,0.939337889,0,0.07803337,1,0,1
653,3,174,19,50,41,0,4296.539,84,1582.231,MORE,1024,1548,2572,5,2,-9,-0.843667615,9,0,1.112727475,0.457057361,91,50,41,1,-1.376206896,-1.170500555,-1.521650721,1.875405281,0.711745865,0.711745865,-1.521650721,-1.170500555,1,1,1
654,3,175,56,96,110,1,1664.744,54,2043.099,MORE,1326,446,1772,1,2,14,1.312371845,14,0.87303787,-0.514331383,-1.126866291,206,96,110,0,0.917471264,0.624266962,1.170500555,-1.266634981,0.993437633,0.993437633,1.170500555,0.624266962,0,0,1
655,3,176,23,80,85,1,1615.953,84,1679.48,MORE,2236,378,2614,1,2,5,0.46870423,5,-0.698430296,1.112727475,-1.156230743,165,80,85,0,0.099725137,0,0.195083426,-1.266634981,1.842243954,1.842243954,0.195083426,0,1,0,1
656,3,177,10,60,50,1,3923.588,64,587.925,MORE,1430,1124,2554,3,2,-10,-0.937408461,10,0.174607574,0.028021569,0.232599943,110,60,50,1,-0.997251374,-0.780333703,-1.170500555,0.30438515,1.09044407,1.09044407,-1.170500555,-0.780333703,0,1,1
657,3,178,19,41,50,1,4026.835,64,2635.274,MORE,1678,978,2656,2,2,9,0.843667615,9,0,0.028021569,0.29473828,91,41,50,0,-1.376206896,-1.521650721,-1.170500555,-0.481124915,1.321767111,1.321767111,-1.170500555,-1.521650721,0,0,1
658,3,179,56,110,96,0,1902.077,80,1842.434,MORE,1032,772,1804,2,2,-14,-1.312371845,14,0.87303787,0.895786294,-0.984029424,206,110,96,1,0.917471264,1.170500555,0.624266962,-0.481124915,0.719207898,0.719207898,0.624266962,1.170500555,1,0,1
659,3,180,35,72,80,1,5104.126,74,1437.154,MORE,1506,1544,3050,5,2,8,0.749926769,8,-0.174607574,0.570374522,0.943096794,152,72,80,0,-0.15956022,-0.312133481,0,1.875405281,1.161333389,1.161333389,0,-0.312133481,1,1,1
660,3,181,11,49,50,1,2092.791,74,1386.898,MORE,682,438,1120,1,2,1,0.093740846,1,-1.396860592,0.570374522,-0.86924981,99,49,50,0,-1.216646676,-1.20951724,-1.170500555,-1.266634981,0.392743929,0.392743929,-1.170500555,-1.20951724,1,0,1
661,3,182,17,43,50,1,1598.885,100,2419.735,MORE,1888,432,2320,1,2,7,0.656185922,7,-0.349215148,1.980492199,-1.166502975,93,43,50,0,-1.336316841,-1.443617351,-1.170500555,-1.266634981,1.517645493,1.517645493,-1.170500555,-1.443617351,1,0,1
662,3,183,1,51,50,0,3318.872,34,1467.4,MORE,-386,1384,998,4,1,-1,-0.093740846,1,-1.396860592,-1.599037289,-0.131343288,101,51,50,1,-1.176756621,-1.131483869,-1.170500555,1.089895216,-0.603437556,0.603437556,-1.170500555,-1.131483869,0,1,0
663,3,184,41,112,110,0,4246.255,74,1777.479,MORE,-62,1762,1700,4,2,-2,-0.187481692,2,-1.222253018,0.570374522,0.426794359,222,112,110,1,1.236591704,1.248533925,1.170500555,1.089895216,-0.301225196,0.301225196,1.170500555,1.248533925,1,1,0
664,3,185,20,40,50,1,4098.269,84,2000.221,MORE,2356,764,3120,2,2,10,0.937408461,10,0.174607574,1.112727475,0.337730232,90,40,50,0,-1.396151924,-1.560667406,-1.170500555,-0.481124915,1.954174458,1.954174458,-1.170500555,-1.560667406,1,0,1
665,3,186,1,50,51,0,4183.034,74,2559.068,MORE,392,1538,1930,4,2,1,0.093740846,1,-1.396860592,0.570374522,0.388745333,101,50,51,0,-1.176756621,-1.170500555,-1.131483869,1.089895216,0.122245211,0.122245211,-1.131483869,-1.170500555,1,1,0
666,3,187,23,85,80,1,1733.372,64,1625.643,MORE,468,452,920,1,2,-5,-0.46870423,5,-0.698430296,0.028021569,-1.085563107,165,85,80,1,0.099725137,0.195083426,0,-1.266634981,0.19313453,0.19313453,0,0.195083426,0,0,0
667,3,188,11,50,49,1,4202.163,74,1909.819,MORE,1920,1210,3130,3,2,-1,-0.093740846,1,-1.396860592,0.570374522,0.40025796,99,50,49,1,-1.216646676,-1.170500555,-1.20951724,0.30438515,1.547493627,1.547493627,-1.20951724,-1.170500555,1,1,1
668,3,189,17,50,43,0,2356.3,64,1376.661,MORE,30,818,848,2,1,-7,-0.656185922,7,-0.349215148,0.028021569,-0.710659138,93,50,43,1,-1.336316841,-1.170500555,-1.443617351,-0.481124915,-0.215411809,0.215411809,-1.443617351,-1.170500555,0,0,0
669,3,190,21,80,82,1,1870.494,84,2322.063,MORE,1732,420,2152,1,2,2,0.187481692,2,-1.222253018,1.112727475,-1.003037387,162,80,82,0,0.039890055,0,0.07803337,-1.266634981,1.372135838,1.372135838,0.07803337,0,1,0,1
670,3,191,10,50,60,1,1738.671,74,1528.101,MORE,572,414,986,1,2,10,0.937408461,10,0.174607574,0.570374522,-1.082373949,110,50,60,0,-0.997251374,-1.170500555,-0.780333703,-1.266634981,0.290140967,0.290140967,-0.780333703,-1.170500555,1,0,1
671,3,192,3,53,50,1,2082.474,74,676.898,MORE,1618,466,2084,1,2,-3,-0.281222538,3,-1.047645444,0.570374522,-0.875459009,103,53,50,1,-1.136866566,-1.053450499,-1.170500555,-1.266634981,1.265801859,1.265801859,-1.170500555,-1.053450499,1,0,1
672,3,193,45,122,110,1,2463.471,74,1944.794,MORE,694,820,1514,3,2,-12,-1.124890153,12,0.523822722,0.570374522,-0.646159174,232,122,110,1,1.436041979,1.638700776,1.170500555,0.30438515,0.403936979,0.403936979,1.170500555,1.638700776,1,1,1
673,3,194,38,67,80,1,1543.887,44,550.76,MORE,328,342,670,1,2,13,1.218630999,13,0.698430296,-1.056684336,-1.199603058,147,67,80,0,-0.259285357,-0.507216907,0,-1.266634981,0.062548942,0.062548942,0,-0.507216907,0,0,0
674,3,195,38,80,67,0,2664.14,64,2502.693,MORE,1194,988,2182,2,2,-13,-1.218630999,13,0.698430296,0.028021569,-0.525388227,147,80,67,1,-0.259285357,0,-0.507216907,-0.481124915,0.870314079,0.870314079,-0.507216907,0,0,0,1
675,3,196,36,70,80,1,6240.445,74,1659.608,MORE,3326,1806,5132,7,2,10,0.937408461,10,0.174607574,0.570374522,1.626980813,150,70,80,0,-0.199450275,-0.390166852,0,3.446425412,2.858946031,2.858946031,0,-0.390166852,1,1,1
676,3,197,45,110,122,1,2168.694,74,1675.265,MORE,728,702,1430,1,2,12,1.124890153,12,0.523822722,0.570374522,-0.823568228,232,110,122,0,1.436041979,1.170500555,1.638700776,-1.266634981,0.435650622,0.435650622,1.638700776,1.170500555,1,0,1
677,3,198,42,110,115,0,2788.367,84,3251.119,MORE,168,1236,1404,2,2,5,0.46870423,5,-0.698430296,1.112727475,-0.450623253,225,110,115,0,1.296426786,1.170500555,1.36558398,-0.481124915,-0.08669173,0.08669173,1.36558398,1.170500555,1,0,0
678,3,199,41,110,112,1,1900.364,44,1973.901,MORE,864,556,1420,1,2,2,0.187481692,2,-1.222253018,-1.056684336,-0.985060379,222,110,112,0,1.236591704,1.170500555,1.248533925,-1.266634981,0.562505193,0.562505193,1.248533925,1.170500555,0,0,1
679,3,200,53,110,103,1,2711.223,24,794.877,MORE,1332,496,1828,1,2,-7,-0.656185922,7,-0.349215148,-2.141390242,-0.49705172,213,110,103,1,1.057086457,1.170500555,0.897383758,-1.266634981,0.999034158,0.999034158,0.897383758,1.170500555,0,0,1
680,3,201,3,50,53,0,6490.153,4,2419.003,LESS,-1286,3734,2448,6,1,3,0.281222538,3,-1.047645444,-3.226096147,1.777265469,103,50,53,1,-1.136866566,-1.170500555,-1.053450499,2.660915347,-1.442916336,1.442916336,-1.053450499,-1.170500555,0,1,0
681,3,202,20,50,40,1,2569.653,64,2289.132,LESS,828,864,1692,3,2,-10,-0.937408461,10,0.174607574,0.028021569,-0.582254432,90,50,40,0,-1.396151924,-1.170500555,-1.560667406,0.30438515,0.528926042,0.528926042,-1.560667406,-1.170500555,0,0,1
682,3,203,25,80,88,1,1734.384,74,2104.83,LESS,646,292,938,1,2,8,0.749926769,8,-0.174607574,0.570374522,-1.084954044,168,80,88,1,0.15956022,0,0.312133481,-1.266634981,0.359164777,0.359164777,0.312133481,0,1,0,1
683,3,204,42,115,110,0,1816.44,74,2077.924,LESS,-708,1152,444,2,1,-5,-0.46870423,5,-0.698430296,0.570374522,-1.035569331,225,115,110,0,1.296426786,1.36558398,1.170500555,-0.481124915,-0.903784408,0.903784408,1.170500555,1.36558398,1,0,0
684,3,205,53,103,110,1,3418.283,74,1528.432,LESS,1692,860,2552,3,2,7,0.656185922,7,-0.349215148,0.570374522,-0.071513615,213,103,110,1,1.057086457,0.897383758,1.170500555,0.30438515,1.33482567,1.33482567,1.170500555,0.897383758,1,1,1
685,3,206,26,90,80,1,3388.941,74,2391.054,LESS,3004,928,3932,3,2,-10,-0.937408461,10,0.174607574,0.570374522,-0.08917285,170,90,80,0,0.199450275,0.390166852,0,0.30438515,2.558599179,2.558599179,0,0.390166852,1,1,1
686,3,207,35,80,72,1,3212.035,64,2240.492,LESS,760,1050,1810,3,2,-8,-0.749926769,8,-0.174607574,0.028021569,-0.195642236,152,80,72,0,-0.15956022,0,-0.312133481,0.30438515,0.465498756,0.465498756,-0.312133481,0,0,1,1
687,3,208,28,93,80,1,4191.488,84,1339.696,LESS,1226,1530,2756,2,2,-13,-1.218630999,13,0.698430296,1.112727475,0.393833301,173,93,80,0,0.259285357,0.507216907,0,-0.481124915,0.900162213,0.900162213,0,0.507216907,1,0,1
688,3,209,26,80,90,0,2193.673,84,3333.662,LESS,678,1268,1946,2,2,10,0.937408461,10,0.174607574,1.112727475,-0.808534828,170,80,90,1,0.199450275,0,0.390166852,-0.481124915,0.389012912,0.389012912,0.390166852,0,1,0,1
689,3,210,25,88,80,1,2866.639,74,2208.019,LESS,818,860,1678,3,2,-8,-0.749926769,8,-0.174607574,0.570374522,-0.403515909,168,88,80,0,0.15956022,0.312133481,0,0.30438515,0.5195985,0.5195985,0,0.312133481,1,1,1
690,3,211,36,80,70,1,4461.154,24,1265.066,LESS,722,1442,2164,4,1,-10,-0.937408461,10,0.174607574,-2.141390242,0.556129512,150,80,70,0,-0.199450275,0,-0.390166852,1.089895216,0.430054097,0.430054097,-0.390166852,0,0,1,1
691,3,212,28,80,93,0,1790.712,34,1075.205,LESS,-180,722,542,2,1,13,1.218630999,13,0.698430296,-1.599037289,-1.051053511,173,80,93,1,0.259285357,0,0.507216907,-0.481124915,-0.411290191,0.411290191,0.507216907,0,0,0,0
692,3,213,21,82,80,1,3086.176,74,1783.226,LESS,2194,872,3066,3,2,-2,-0.187481692,2,-1.222253018,0.570374522,-0.271389415,162,82,80,0,0.039890055,0.07803337,0,0.30438515,1.803068278,1.803068278,0,0.07803337,1,1,1
693,3,214,19,50,41,1,2421.588,84,1955.117,LESS,912,492,1404,1,2,-9,-0.843667615,9,0,1.112727475,-0.671366105,91,50,41,0,-1.376206896,-1.170500555,-1.521650721,-1.266634981,0.607277394,0.607277394,-1.521650721,-1.170500555,1,0,1
694,3,215,56,96,110,0,5495.088,74,694.074,LESS,-712,2462,1750,3,1,14,1.312371845,14,0.87303787,0.570374522,1.178393981,206,96,110,1,0.917471264,0.624266962,1.170500555,0.30438515,-0.907515425,0.907515425,1.170500555,0.624266962,1,1,0
695,3,216,23,80,85,1,7992.571,54,1763.038,LESS,908,1574,2482,5,2,5,0.46870423,5,-0.698430296,-0.514331383,2.681483087,165,80,85,1,0.099725137,0,0.195083426,1.875405281,0.603546378,0.603546378,0.195083426,0,0,1,1
696,3,217,10,60,50,0,1895.259,100,1574.092,LESS,770,894,1664,2,2,-10,-0.937408461,10,0.174607574,1.980492199,-0.98813278,110,60,50,0,-0.997251374,-0.780333703,-1.170500555,-0.481124915,0.474826298,0.474826298,-1.170500555,-0.780333703,1,0,1
697,3,218,19,41,50,0,1717.528,84,2354.441,LESS,342,980,1322,2,1,9,0.843667615,9,0,1.112727475,-1.095098685,91,41,50,1,-1.376206896,-1.521650721,-1.170500555,-0.481124915,0.075607501,0.075607501,-1.170500555,-1.521650721,1,0,1
698,3,219,56,110,96,0,5673.799,34,2130.811,LESS,-344,2320,1976,5,1,-14,-1.312371845,14,0.87303787,-1.599037289,1.285949691,206,110,96,0,0.917471264,1.170500555,0.624266962,1.875405281,-0.56426188,0.56426188,0.624266962,1.170500555,0,1,0
699,3,220,35,72,80,0,1735.755,64,2372.104,LESS,-710,1188,478,2,1,8,0.749926769,8,-0.174607574,0.028021569,-1.084128919,152,72,80,1,-0.15956022,-0.312133481,0,-0.481124915,-0.905649917,0.905649917,0,-0.312133481,0,0,0
700,3,221,11,49,50,0,1521.761,74,2239.381,LESS,-378,744,366,1,1,1,0.093740846,1,-1.396860592,0.570374522,-1.212919405,99,49,50,1,-1.216646676,-1.20951724,-1.170500555,-1.266634981,-0.595975523,0.595975523,-1.170500555,-1.20951724,1,0,0
701,3,222,17,43,50,0,1839.842,64,1914.332,LESS,-478,912,434,2,1,7,0.656185922,7,-0.349215148,0.028021569,-1.021485035,93,43,50,1,-1.336316841,-1.443617351,-1.170500555,-0.481124915,-0.689250943,0.689250943,-1.170500555,-1.443617351,0,0,0
702,3,223,1,51,50,0,2040.446,64,2298.321,LESS,1302,778,2080,3,2,-1,-0.093740846,1,-1.396860592,0.028021569,-0.900753207,101,51,50,0,-1.176756621,-1.131483869,-1.170500555,0.30438515,0.971051532,0.971051532,-1.170500555,-1.131483869,0,1,1
703,3,224,41,112,110,0,3775.151,64,2183.401,LESS,-786,1800,1014,4,1,-2,-0.187481692,2,-1.222253018,0.028021569,0.143264385,222,112,110,0,1.236591704,1.248533925,1.170500555,1.089895216,-0.976539236,0.976539236,1.170500555,1.248533925,0,1,0
704,3,225,20,40,50,1,4915.342,74,1552.67,LESS,2028,1584,3612,5,2,10,0.937408461,10,0.174607574,0.570374522,0.829478734,90,40,50,1,-1.396151924,-1.560667406,-1.170500555,1.875405281,1.648231081,1.648231081,-1.170500555,-1.560667406,1,1,1
705,3,226,1,50,51,0,1945.35,64,1462.16,LESS,922,636,1558,2,2,1,0.093740846,1,-1.396860592,0.028021569,-0.957985934,101,50,51,1,-1.176756621,-1.170500555,-1.131483869,-0.481124915,0.616604936,0.616604936,-1.131483869,-1.170500555,0,0,1
706,3,227,23,85,80,1,2987.049,34,438.105,LESS,1136,866,2002,3,2,-5,-0.46870423,5,-0.698430296,-1.599037289,-0.331048165,165,85,80,0,0.099725137,0.195083426,0,0.30438515,0.816214335,0.816214335,0,0.195083426,0,1,1
707,3,228,11,50,49,1,2836.683,64,2155.881,LESS,1208,638,1846,3,2,-1,-0.093740846,1,-1.396860592,0.028021569,-0.421544676,99,50,49,0,-1.216646676,-1.170500555,-1.20951724,0.30438515,0.883372637,0.883372637,-1.20951724,-1.170500555,0,1,1
708,3,229,17,50,43,0,3238.171,64,2482.647,LESS,-254,1222,968,4,1,-7,-0.656185922,7,-0.349215148,0.028021569,-0.179912505,93,50,43,0,-1.336316841,-1.170500555,-1.443617351,1.089895216,-0.480314002,0.480314002,-1.443617351,-1.170500555,0,1,0
709,3,230,21,80,82,0,3324.511,64,2010.851,LESS,-536,1066,530,2,1,2,0.187481692,2,-1.222253018,0.028021569,-0.127949503,162,80,82,1,0.039890055,0,0.07803337,-0.481124915,-0.743350686,0.743350686,0.07803337,0,0,0,0
710,3,231,10,50,60,0,1673.779,64,2594.459,LESS,94,666,760,2,2,10,0.937408461,10,0.174607574,0.028021569,-1.121428652,110,50,60,1,-0.997251374,-1.170500555,-0.780333703,-0.481124915,-0.155715541,0.155715541,-0.780333703,-1.170500555,0,0,1
711,3,232,3,53,50,1,4260.273,54,2178.278,LESS,1224,1474,2698,6,1,-3,-0.281222538,3,-1.047645444,-0.514331383,0.435230974,103,53,50,0,-1.136866566,-1.053450499,-1.170500555,2.660915347,0.898296705,0.898296705,-1.170500555,-1.053450499,0,1,1
712,3,233,45,122,110,1,3245.341,64,2896.612,LESS,854,788,1642,3,2,-12,-1.124890153,12,0.523822722,0.028021569,-0.175597301,232,122,110,0,1.436041979,1.638700776,1.170500555,0.30438515,0.553177651,0.553177651,1.170500555,1.638700776,0,1,1
713,3,234,38,67,80,0,2464.32,54,1865.773,LESS,-902,1430,528,2,1,13,1.218630999,13,0.698430296,-0.514331383,-0.645648211,147,67,80,1,-0.259285357,-0.507216907,0,-0.481124915,-1.084738723,1.084738723,0,-0.507216907,0,0,0
714,3,235,38,80,67,1,3971.055,74,1965.186,LESS,1282,756,2038,3,2,-13,-1.218630999,13,0.698430296,0.570374522,0.261167557,147,80,67,0,-0.259285357,0,-0.507216907,0.30438515,0.952396448,0.952396448,-0.507216907,0,1,1,1
715,3,236,36,70,80,0,4124.874,44,2985.083,LESS,504,1674,2178,4,2,10,0.937408461,10,0.174607574,-1.056684336,0.353742227,150,70,80,1,-0.199450275,-0.390166852,0,1.089895216,0.226713681,0.226713681,0,-0.390166852,0,1,1
716,3,237,45,110,122,0,3063.151,64,2776.515,LESS,-294,1234,940,4,1,12,1.124890153,12,0.523822722,0.028021569,-0.285246817,232,110,122,1,1.436041979,1.170500555,1.638700776,1.089895216,-0.51762417,0.51762417,1.638700776,1.170500555,0,1,0
717,3,238,42,110,115,0,2784.731,64,1489.454,LESS,268,1194,1462,4,2,5,0.46870423,5,-0.698430296,0.028021569,-0.452811549,225,110,115,1,1.296426786,1.170500555,1.36558398,1.089895216,0.00658369,0.00658369,1.36558398,1.170500555,1,1,1
718,3,239,41,110,112,0,2274.323,34,1716.964,LESS,-90,810,720,1,2,2,0.187481692,2,-1.222253018,-1.599037289,-0.759996305,222,110,112,1,1.236591704,1.170500555,1.248533925,-1.266634981,-0.327342313,0.327342313,1.248533925,1.170500555,0,0,0
719,3,240,53,110,103,1,3210.26,44,2620.281,LESS,674,868,1542,3,2,-7,-0.656185922,7,-0.349215148,-1.056684336,-0.196710505,213,110,103,0,1.057086457,1.170500555,0.897383758,0.30438515,0.385281895,0.385281895,0.897383758,1.170500555,0,1,1
720,4,1,49,110,131,0,14824.897,44,1530.58,LESS,-1953,7328,5375,9,1,21,1.968557767,21,2.095290887,-1.433188165,1.51480143,241,110,131,1,1.615547226,1.170500555,1.989850943,1.632751962,-1.947480828,1.947480828,1.989850943,1.170500555,0,1,0
721,4,2,13,47,50,1,2083.157,24,3022.352,LESS,-610,1601,991,1,1,3,0.281222538,3,-1.047645444,-2.355594063,-0.729229893,97,47,50,1,-1.256536731,-1.28755061,-1.170500555,-1.176283671,-0.745395708,0.745395708,-1.170500555,-1.28755061,0,0,0
722,4,3,16,50,44,0,9357.174,24,2561.157,LESS,-312,4269,3957,8,1,-6,-0.562445076,6,-0.523822722,-2.355594063,0.551844905,94,50,44,0,-1.316371814,-1.170500555,-1.404600665,1.281622508,-0.478663492,0.478663492,-1.404600665,-1.170500555,0,1,0
723,4,4,7,57,50,0,2825.048,24,1130.726,LESS,-482,1793,1311,4,1,-7,-0.656185922,7,-0.349215148,-2.355594063,-0.598570608,107,57,50,0,-1.057086457,-0.897383758,-1.170500555,-0.122895309,-0.630826165,0.630826165,-1.170500555,-0.897383758,0,0,0
724,4,5,18,42,50,0,1900.572,94,1804.716,LESS,575,1174,1749,2,2,8,0.749926769,8,-0.174607574,0.872826581,-0.761386134,92,42,50,1,-1.356261869,-1.482634036,-1.170500555,-0.825154217,0.315267633,0.315267633,-1.170500555,-1.482634036,1,0,1
725,4,6,51,108,110,0,4876.995,54,2334.397,LESS,10,2688,2698,5,2,2,0.187481692,2,-1.222253018,-0.971985216,-0.237188776,218,108,110,1,1.156811594,1.092467184,1.170500555,0.228234145,-0.190449487,0.190449487,1.170500555,1.092467184,0,1,1
726,4,7,31,78,80,0,1821.439,100,3741.038,LESS,-1175,2270,1095,2,2,2,0.187481692,2,-1.222253018,1.149548351,-0.775322765,158,78,80,1,-0.039890055,-0.07803337,0,-0.825154217,-1.251112828,1.251112828,0,-0.07803337,1,0,0
727,4,8,58,110,92,1,7493.308,34,2644.093,LESS,-553,3221,2668,4,1,-18,-1.687335229,18,1.571468165,-1.894391114,0.22358725,202,110,92,0,0.837691154,1.170500555,0.468200222,-0.122895309,-0.694376458,0.694376458,0.468200222,1.170500555,0,0,0
728,4,9,12,50,48,0,4593.317,54,2363.908,LESS,-620,2250,1630,6,1,-2,-0.187481692,2,-1.222253018,-0.971985216,-0.287149167,98,50,48,0,-1.236591704,-1.170500555,-1.248533925,0.579363599,-0.754346453,0.754346453,-1.248533925,-1.170500555,0,1,0
729,4,10,54,110,101,0,2388.264,54,3199.133,LESS,-387,1458,1071,3,1,-9,-0.843667615,9,0,-0.971985216,-0.6754955,211,110,101,0,1.017196402,1.170500555,0.819350388,-0.474024763,-0.545794083,0.545794083,0.819350388,1.170500555,0,0,0
730,4,11,14,46,50,0,4057.351,94,2576.55,LESS,-281,2393,2112,4,2,4,0.374963384,4,-0.87303787,0.872826581,-0.381541651,96,46,50,1,-1.276481759,-1.326567295,-1.170500555,-0.122895309,-0.450916181,0.450916181,-1.170500555,-1.326567295,1,0,0
731,4,12,22,80,83,0,3000.593,44,1497.269,LESS,-1314,1982,668,2,1,3,0.281222538,3,-1.047645444,-1.433188165,-0.567654227,163,80,83,1,0.059835082,0,0.117050055,-0.825154217,-1.375528191,1.375528191,0.117050055,0,0,0,0
732,4,13,6,50,56,0,3201.176,100,3448.166,LESS,463,1783,2246,2,2,6,0.562445076,6,-0.523822722,1.149548351,-0.532328241,106,50,56,1,-1.077031484,-1.170500555,-0.936400444,-0.825154217,0.215019284,0.215019284,-0.936400444,-1.170500555,1,0,1
733,4,14,13,50,47,0,8467.339,54,1834.319,LESS,531,3761,4292,7,2,-3,-0.281222538,3,-1.047645444,-0.971985216,0.395130232,97,50,47,0,-1.256536731,-1.170500555,-1.28755061,0.930493053,0.275884353,0.275884353,-1.28755061,-1.170500555,0,1,1
734,4,15,46,110,124,0,15422.37,100,1283.064,LESS,57,6739,6796,8,2,14,1.312371845,14,0.87303787,1.149548351,1.620026315,234,110,124,1,1.475932034,1.170500555,1.716734147,1.281622508,-0.148380983,0.148380983,1.716734147,1.170500555,1,1,1
735,4,16,27,91,80,0,22416.61,54,1533.115,LESS,-2411,10582,8171,7,2,-11,-1.031149307,11,0.349215148,-0.971985216,2.851827752,171,91,80,0,0.219395302,0.429183537,0,0.930493053,-2.357424971,2.357424971,0,0.429183537,0,1,0
736,4,17,40,64,80,0,2357.467,100,1297.533,LESS,-301,1493,1192,2,2,16,1.499853537,16,1.222253018,1.149548351,-0.680919361,144,64,80,1,-0.31912044,-0.624266962,0,-0.825154217,-0.468817672,0.468817672,0,-0.624266962,1,0,0
737,4,18,22,83,80,1,19852.526,4,1919.425,LESS,-228,8911,8683,14,1,-3,-0.281222538,3,-1.047645444,-3.277999962,2.400250118,163,83,80,0,0.059835082,0.117050055,0,3.388399232,-0.40347723,0.40347723,0,0.117050055,0,1,0
738,4,19,54,101,110,1,14929.605,44,1996.82,LESS,1529,5437,6966,8,2,9,0.843667615,9,0,-1.433188165,1.533242242,211,101,110,1,1.017196402,0.819350388,1.170500555,1.281622508,1.169168753,1.169168753,1.170500555,0.819350388,0,1,1
739,4,20,6,56,50,1,6802.71,54,1100.304,LESS,669,2482,3151,5,2,-6,-0.562445076,6,-0.523822722,-0.971985216,0.101961511,106,56,50,0,-1.077031484,-0.936400444,-1.170500555,0.228234145,0.399404641,0.399404641,-1.170500555,-0.936400444,0,1,1
740,4,21,18,50,42,1,5623.276,64,1561.025,LESS,89,2407,2496,7,2,-8,-0.749926769,8,-0.174607574,-0.510782266,-0.105756339,92,50,42,0,-1.356261869,-1.170500555,-1.482634036,0.930493053,-0.119738598,0.119738598,-1.482634036,-1.170500555,0,1,1
741,4,22,43,110,117,0,8088.222,54,2527.484,LESS,-186,3518,3332,6,1,7,0.656185922,7,-0.349215148,-0.971985216,0.328361453,227,110,117,1,1.336316841,1.170500555,1.443617351,0.579363599,-0.365884099,0.365884099,1.443617351,1.170500555,0,1,0
742,4,23,32,77,80,0,8348.753,44,1847.758,LESS,2973,1988,4961,3,1,3,0.281222538,3,-1.047645444,-1.433188165,0.374245275,157,77,80,1,-0.059835082,-0.117050055,0,-0.474024763,2.461656402,2.461656402,0,-0.117050055,0,0,1
743,4,24,27,80,91,0,2068.719,94,2033.362,LESS,-827,1386,559,2,1,11,1.031149307,11,0.349215148,0.872826581,-0.731772664,171,80,91,1,0.219395302,0,0.429183537,-0.825154217,-0.939626885,0.939626885,0.429183537,0,1,0,0
744,4,25,16,44,50,0,2864.606,74,1149.124,LESS,-261,1344,1083,3,1,6,0.562445076,6,-0.523822722,-0.049579317,-0.591603789,94,44,50,1,-1.316371814,-1.404600665,-1.170500555,-0.474024763,-0.43301469,0.43301469,-1.170500555,-1.404600665,1,0,0
745,4,26,7,50,57,0,1555.129,74,1582.205,LESS,-144,866,722,2,2,7,0.656185922,7,-0.349215148,-0.049579317,-0.822224364,107,50,57,1,-1.057086457,-1.170500555,-0.897383758,-0.825154217,-0.328290968,0.328290968,-0.897383758,-1.170500555,1,0,0
746,4,27,14,50,46,0,2010.556,74,1388.074,LESS,-781,1318,537,2,1,-4,-0.374963384,4,-0.87303787,-0.049579317,-0.742016131,96,50,46,0,-1.276481759,-1.170500555,-1.326567295,-0.825154217,-0.898453456,0.898453456,-1.326567295,-1.170500555,1,0,0
747,4,28,51,110,108,0,25299.521,84,1577.093,LESS,1691,9624,11315,15,1,-2,-0.187481692,2,-1.222253018,0.411623632,3.359556099,218,110,108,0,1.156811594,1.170500555,1.092467184,3.739528686,1.31417083,1.31417083,1.092467184,1.170500555,1,1,1
748,4,29,50,133,110,0,1996.359,64,1357.119,LESS,-329,1355,1026,2,2,-23,-2.15603946,23,2.444506035,-0.510782266,-0.744516457,243,133,110,0,1.655437281,2.067884313,1.170500555,-0.825154217,-0.493879759,0.493879759,1.170500555,2.067884313,0,0,0
749,4,30,49,131,110,1,15235.493,74,2031.344,LESS,-13,6354,6341,14,1,-21,-1.968557767,21,2.095290887,-0.049579317,1.587114182,241,131,110,0,1.615547226,1.989850943,1.170500555,3.388399232,-0.211036202,0.211036202,1.170500555,1.989850943,1,1,1
750,4,31,47,126,110,1,9458.254,94,1320.76,LESS,687,3570,4257,6,2,-16,-1.499853537,16,1.222253018,0.872826581,0.569646766,236,126,110,0,1.515822089,1.794767517,1.170500555,0.579363599,0.415515983,0.415515983,1.170500555,1.794767517,1,1,1
751,4,32,50,110,133,0,1876.74,84,2989.532,LESS,-887,1551,664,2,2,23,2.15603946,23,2.444506035,0.411623632,-0.765583343,243,110,133,1,1.655437281,1.170500555,2.067884313,-0.825154217,-0.993331358,0.993331358,2.067884313,1.170500555,1,0,0
752,4,33,47,110,126,0,6732.502,84,1920.56,LESS,-985,3398,2413,4,2,16,1.499853537,16,1.222253018,0.411623632,0.08959672,236,110,126,1,1.515822089,1.170500555,1.794767517,-0.122895309,-1.081048664,1.081048664,1.794767517,1.170500555,1,1,0
753,4,34,12,48,50,0,1564.586,100,1156.133,LESS,-63,862,799,2,2,2,0.187481692,2,-1.222253018,1.149548351,-0.82055883,98,48,50,1,-1.236591704,-1.248533925,-1.170500555,-0.825154217,-0.255789929,0.255789929,-1.170500555,-1.248533925,1,0,1
754,4,35,32,80,77,0,10629.362,24,1964.181,LESS,-389,4885,4496,10,1,-3,-0.281222538,3,-1.047645444,-2.355594063,0.77589827,157,80,77,0,-0.059835082,0,-0.117050055,1.983881416,-0.547584232,0.547584232,-0.117050055,0,0,1,0
755,4,36,43,117,110,1,9460.517,54,1720.961,LESS,1802,3080,4882,7,2,-7,-0.656185922,7,-0.349215148,-0.971985216,0.570045318,227,117,110,0,1.336316841,1.443617351,1.170500555,0.930493053,1.413524105,1.413524105,1.170500555,1.443617351,0,1,1
756,4,37,40,80,64,1,7210.473,74,846.129,LESS,-570,3105,2535,6,2,-16,-1.499853537,16,1.222253018,-0.049579317,0.173775325,144,80,64,0,-0.31912044,0,-0.624266962,0.579363599,-0.709592726,0.709592726,-0.624266962,0,0,1,0
757,4,38,31,80,78,0,6251.048,14,469.319,LESS,-1528,3165,1637,5,2,-2,-0.187481692,2,-1.222253018,-2.816797013,0.004804702,158,80,78,0,-0.039890055,0,-0.07803337,0.228234145,-1.567074144,1.567074144,-0.07803337,0,0,1,0
758,4,39,46,124,110,0,6443.423,74,859.105,LESS,-478,2547,2069,3,1,-14,-1.312371845,14,0.87303787,-0.049579317,0.038685124,234,124,110,0,1.475932034,1.716734147,1.170500555,-0.474024763,-0.627245867,0.627245867,1.170500555,1.716734147,0,0,0
759,4,40,58,92,110,0,2842.802,64,2023.994,LESS,-2295,3459,1164,2,1,18,1.687335229,18,1.571468165,-0.510782266,-0.595443834,202,92,110,1,0.837691154,0.468200222,1.170500555,-0.825154217,-2.253596323,2.253596323,1.170500555,0.468200222,0,0,0
760,4,41,49,110,131,1,3753.06,94,2603.975,MORE,578,1521,2099,3,2,21,1.968557767,21,2.095290887,0.872826581,-0.435132333,241,110,131,0,1.615547226,1.170500555,1.989850943,-0.474024763,0.317952857,0.317952857,1.989850943,1.170500555,1,0,1
761,4,42,13,47,50,1,2852.768,74,2179.56,MORE,-306,1519,1213,3,1,3,0.281222538,3,-1.047645444,-0.049579317,-0.593688657,97,47,50,0,-1.256536731,-1.28755061,-1.170500555,-0.474024763,-0.473293045,0.473293045,-1.170500555,-1.28755061,0,1,0
762,4,43,16,50,44,1,7578.454,64,1990.795,MORE,-417,3789,3372,9,2,-6,-0.562445076,6,-0.523822722,-0.510782266,0.23858287,94,50,44,1,-1.316371814,-1.170500555,-1.404600665,1.632751962,-0.57264632,0.57264632,-1.404600665,-1.170500555,0,1,0
763,4,44,7,57,50,0,19368.146,44,2046.833,MORE,638,8096,8734,18,1,-7,-0.656185922,7,-0.349215148,-1.433188165,2.314942782,107,57,50,1,-1.057086457,-0.897383758,-1.170500555,4.792917049,0.37165733,0.37165733,-1.170500555,-0.897383758,0,1,1
764,4,45,18,42,50,1,3215.312,94,1982.622,MORE,732,1194,1926,3,2,8,0.749926769,8,-0.174607574,0.872826581,-0.529838657,92,42,50,0,-1.356261869,-1.482634036,-1.170500555,-0.474024763,0.455794337,0.455794337,-1.170500555,-1.482634036,1,0,1
765,4,46,51,108,110,1,1942.017,94,1754.971,MORE,331,945,1276,3,2,2,0.187481692,2,-1.222253018,0.872826581,-0.754086983,218,108,110,0,1.156811594,1.092467184,1.170500555,-0.474024763,0.096869443,0.096869443,1.170500555,1.092467184,1,0,0
766,4,47,31,78,80,1,1587.571,94,2189.131,MORE,603,667,1270,2,2,2,0.187481692,2,-1.222253018,0.872826581,-0.816510791,158,78,80,0,-0.039890055,-0.07803337,0,-0.825154217,0.340329721,0.340329721,0,-0.07803337,1,0,1
767,4,48,58,110,92,0,2246.732,94,1705.271,MORE,94,1278,1372,2,2,-18,-1.687335229,18,1.571468165,0.872826581,-0.700421628,202,110,92,1,0.837691154,1.170500555,0.468200222,-0.825154217,-0.115263225,0.115263225,0.468200222,1.170500555,1,0,0
768,4,49,12,50,48,0,2550.21,84,1317.801,MORE,-55,1322,1267,4,2,-2,-0.187481692,2,-1.222253018,0.411623632,-0.646974129,98,50,48,1,-1.236591704,-1.170500555,-1.248533925,-0.122895309,-0.248629333,0.248629333,-1.248533925,-1.170500555,0,1,0
769,4,50,54,110,101,1,5602.05,34,1297.772,MORE,654,2152,2806,5,2,-9,-0.843667615,9,0,-1.894391114,-0.109494589,211,110,101,1,1.017196402,1.170500555,0.819350388,0.228234145,0.385978523,0.385978523,0.819350388,1.170500555,0,1,1
770,4,51,14,46,50,1,1793.482,74,1285.286,MORE,291,939,1230,3,2,4,0.374963384,4,-0.87303787,-0.049579317,-0.780246455,96,46,50,0,-1.276481759,-1.326567295,-1.170500555,-0.474024763,0.061066461,0.061066461,-1.170500555,-1.326567295,0,0,0
771,4,52,22,80,83,1,5781.335,84,981.986,MORE,-1898,3696,1798,5,2,3,0.281222538,3,-1.047645444,0.411623632,-0.077919533,163,80,83,0,0.059835082,0,0.117050055,0.228234145,-1.898251727,1.898251727,0.117050055,0,0,1,0
772,4,53,6,50,56,1,1880.978,94,2257.368,MORE,306,921,1227,3,2,6,0.562445076,6,-0.523822722,0.872826581,-0.764836961,106,50,56,0,-1.077031484,-1.170500555,-0.936400444,-0.474024763,0.074492579,0.074492579,-0.936400444,-1.170500555,1,1,0
773,4,54,13,50,47,1,3078.102,94,6016.719,MORE,1702,1244,2946,4,2,-3,-0.281222538,3,-1.047645444,0.872826581,-0.554003609,97,50,47,1,-1.256536731,-1.170500555,-1.28755061,-0.122895309,1.32401665,1.32401665,-1.28755061,-1.170500555,1,1,1
774,4,55,46,110,124,1,9843.826,84,7314.723,MORE,2191,4780,6971,7,2,14,1.312371845,14,0.87303787,0.411623632,0.637552377,234,110,124,0,1.475932034,1.170500555,1.716734147,0.930493053,1.761708105,1.761708105,1.716734147,1.170500555,1,1,1
775,4,56,27,91,80,0,11180.726,84,2796.48,MORE,1237,3926,5163,8,2,-11,-1.031149307,11,0.349215148,0.411623632,0.873002597,171,91,80,1,0.219395302,0.429183537,0,1.281622508,0.907806985,0.907806985,0,0.429183537,1,1,1
776,4,57,40,64,80,1,1902.12,100,3156.962,MORE,550,1410,1960,1,2,16,1.499853537,16,1.222253018,1.149548351,-0.761113505,144,64,80,0,-0.31912044,-0.624266962,0,-1.176283671,0.292890769,0.292890769,0,-0.624266962,1,0,0
777,4,58,22,83,80,1,1910.42,100,1640.964,MORE,602,967,1569,3,2,-3,-0.281222538,3,-1.047645444,1.149548351,-0.759651738,163,83,80,1,0.059835082,0.117050055,0,-0.474024763,0.339434646,0.339434646,0,0.117050055,1,0,1
778,4,59,54,101,110,1,2634.23,94,804.126,MORE,931,1037,1968,3,2,9,0.843667615,9,0,0.872826581,-0.632176816,211,101,110,0,1.017196402,0.819350388,1.170500555,-0.474024763,0.633914173,0.633914173,1.170500555,0.819350388,1,0,1
779,4,60,6,56,50,1,2586.458,100,1813.426,MORE,988,969,1957,3,2,-6,-0.562445076,6,-0.523822722,1.149548351,-0.640590256,106,56,50,1,-1.077031484,-0.936400444,-1.170500555,-0.474024763,0.684933422,0.684933422,-1.170500555,-0.936400444,1,0,1
780,4,61,18,50,42,1,4955.317,84,2101.278,MORE,172,2008,2180,5,2,-8,-0.749926769,8,-0.174607574,0.411623632,-0.223394975,92,50,42,1,-1.356261869,-1.170500555,-1.482634036,0.228234145,-0.04544741,0.04544741,-1.482634036,-1.170500555,1,1,0
781,4,62,43,110,117,1,2957.897,64,1684.541,MORE,210,1240,1450,3,2,7,0.656185922,7,-0.349215148,-0.510782266,-0.5751737,227,110,117,0,1.336316841,1.170500555,1.443617351,-0.474024763,-0.011434577,0.011434577,1.443617351,1.170500555,0,0,0
782,4,63,32,77,80,1,11515.408,84,920.84,MORE,1722,4138,5860,7,2,3,0.281222538,3,-1.047645444,0.411623632,0.931945637,157,77,80,0,-0.059835082,-0.117050055,0,0.930493053,1.341918141,1.341918141,0,-0.117050055,1,1,1
783,4,64,27,80,91,1,2351.575,94,2240.988,MORE,992,1071,2063,3,2,11,1.031149307,11,0.349215148,0.872826581,-0.68195704,171,80,91,0,0.219395302,0,0.429183537,-0.474024763,0.68851372,0.68851372,0.429183537,0,1,0,1
784,4,65,16,44,50,1,3137.373,94,706.637,MORE,436,1125,1561,2,2,6,0.562445076,6,-0.523822722,0.872826581,-0.543565005,94,44,50,0,-1.316371814,-1.404600665,-1.170500555,-0.825154217,0.190852271,0.190852271,-1.170500555,-1.404600665,1,0,0
785,4,66,7,50,57,1,1736.937,94,1224.269,MORE,815,678,1493,1,2,7,0.656185922,7,-0.349215148,0.872826581,-0.790204966,107,50,57,0,-1.057086457,-1.170500555,-0.897383758,-1.176283671,0.530085525,0.530085525,-0.897383758,-1.170500555,1,0,1
786,4,67,14,50,46,1,2057.448,94,1469.114,MORE,1188,647,1835,1,2,-4,-0.374963384,4,-0.87303787,0.872826581,-0.733757673,96,50,46,1,-1.276481759,-1.170500555,-1.326567295,-1.176283671,0.863948332,0.863948332,-1.326567295,-1.170500555,1,0,1
787,4,68,51,110,108,1,11483.744,94,991.242,MORE,-176,5353,5177,6,2,-2,-0.187481692,2,-1.222253018,0.872826581,0.926369082,218,110,108,1,1.156811594,1.170500555,1.092467184,0.579363599,-0.356933353,0.356933353,1.092467184,1.170500555,1,1,0
788,4,69,50,133,110,0,1873.12,94,1847.734,MORE,-440,1303,863,2,2,-23,-2.15603946,23,2.444506035,0.872826581,-0.766220885,243,133,110,1,1.655437281,2.067884313,1.170500555,-0.825154217,-0.593233034,0.593233034,1.170500555,2.067884313,1,0,0
789,4,70,49,131,110,0,3187.65,74,1602.521,MORE,484,1493,1977,4,2,-21,-1.968557767,21,2.095290887,-0.049579317,-0.534710393,241,131,110,1,1.615547226,1.989850943,1.170500555,-0.122895309,0.233815849,0.233815849,1.170500555,1.989850943,0,1,0
790,4,71,47,126,110,0,5174.183,44,1965.527,MORE,-865,2785,1920,6,1,-16,-1.499853537,16,1.222253018,-1.433188165,-0.18484905,236,126,110,1,1.515822089,1.794767517,1.170500555,0.579363599,-0.973639718,0.973639718,1.170500555,1.794767517,0,1,0
791,4,72,50,110,133,1,6284.96,24,519.911,MORE,284,1853,2137,4,2,23,2.15603946,23,2.444506035,-2.355594063,0.010777166,243,110,133,0,1.655437281,1.170500555,2.067884313,-0.122895309,0.054800939,0.054800939,2.067884313,1.170500555,0,1,0
792,4,73,47,110,126,1,2648.892,84,1566.551,MORE,735,1444,2179,3,2,16,1.499853537,16,1.222253018,0.411623632,-0.629594595,236,110,126,0,1.515822089,1.170500555,1.794767517,-0.474024763,0.458479561,0.458479561,1.794767517,1.170500555,1,0,1
793,4,74,12,48,50,1,3745.233,64,1301.346,MORE,527,1448,1975,3,2,2,0.187481692,2,-1.222253018,-0.510782266,-0.436510798,98,48,50,0,-1.236591704,-1.248533925,-1.170500555,-0.474024763,0.272304055,0.272304055,-1.170500555,-1.248533925,0,0,0
794,4,75,32,80,77,1,5846.379,74,1524.609,MORE,-833,3111,2278,5,2,-3,-0.281222538,3,-1.047645444,-0.049579317,-0.066464208,157,80,77,1,-0.059835082,0,-0.117050055,0.228234145,-0.944997332,0.944997332,-0.117050055,0,0,1,0
795,4,76,43,117,110,1,2244.629,74,1463.252,MORE,-576,1320,744,3,2,-7,-0.656185922,7,-0.349215148,-0.049579317,-0.700792001,227,117,110,1,1.336316841,1.443617351,1.170500555,-0.474024763,-0.714963173,0.714963173,1.170500555,1.443617351,0,0,0
796,4,77,40,80,64,0,4492.143,44,2184.407,MORE,-870,2463,1593,4,1,-16,-1.499853537,16,1.222253018,-1.433188165,-0.304967583,144,80,64,1,-0.31912044,0,-0.624266962,-0.122895309,-0.978115091,0.978115091,-0.624266962,0,0,1,0
797,4,78,31,80,78,1,2831.068,90,1461.321,MORE,1054,1180,2234,3,2,-2,-0.187481692,2,-1.222253018,0.688345402,-0.597510386,158,80,78,1,-0.039890055,0,-0.07803337,-0.474024763,0.744008342,0.744008342,-0.07803337,0,1,0,1
798,4,79,46,124,110,1,5841.602,44,1923.178,MORE,-602,2799,2197,4,1,-14,-1.312371845,14,0.87303787,-1.433188165,-0.067305516,234,124,110,1,1.475932034,1.716734147,1.170500555,-0.122895309,-0.738235111,0.738235111,1.170500555,1.716734147,0,1,0
799,4,80,58,92,110,1,2507.425,94,1276.304,MORE,300,1484,1784,3,1,18,1.687335229,18,1.571468165,0.872826581,-0.654509275,202,92,110,0,0.837691154,0.468200222,1.170500555,-0.474024763,0.069122132,0.069122132,1.170500555,0.468200222,1,0,0
800,4,81,48,128,110,1,5514.536,64,3310.606,LESS,-122,2589,2467,4,1,-18,-1.687335229,18,1.571468165,-0.510782266,-0.124907253,238,128,110,0,1.555712144,1.872800887,1.170500555,-0.122895309,-0.308599328,0.308599328,1.170500555,1.872800887,0,1,1
801,4,82,8,50,58,0,1932.558,74,2132.206,LESS,-600,1128,528,2,1,8,0.749926769,8,-0.174607574,-0.049579317,-0.75575287,108,50,58,1,-1.037141429,-1.170500555,-0.858367073,-0.825154217,-0.736444962,0.736444962,-0.858367073,-1.170500555,1,0,0
802,4,83,4,54,50,0,9801.449,74,1936.535,LESS,1458,3591,5049,8,1,-4,-0.374963384,4,-0.87303787,-0.049579317,0.630089086,104,54,50,0,-1.116921539,-1.014433814,-1.170500555,1.281622508,1.10561846,1.10561846,-1.170500555,-1.014433814,1,1,1
803,4,84,37,80,69,1,5940.869,44,2208.389,LESS,-649,3168,2519,5,1,-11,-1.031149307,11,0.349215148,-1.433188165,-0.049822954,149,80,69,0,-0.219395302,0,-0.429183537,0.228234145,-0.780303615,0.780303615,-0.429183537,0,0,1,0
804,4,85,52,105,110,0,3591.975,74,1821.57,LESS,24,2142,2166,5,2,5,0.46870423,5,-0.698430296,-0.049579317,-0.463502068,215,105,110,1,1.096976512,0.975417129,1.170500555,0.228234145,-0.177918444,0.177918444,1.170500555,0.975417129,0,1,1
805,4,86,5,55,50,0,2463.779,84,2162.893,LESS,-831,1747,916,2,2,-5,-0.46870423,5,-0.698430296,0.411623632,-0.662196058,105,55,50,0,-1.096976512,-0.975417129,-1.170500555,-0.825154217,-0.943207183,0.943207183,-1.170500555,-0.975417129,1,0,0
806,4,87,30,96,80,0,4914.518,74,1479.838,LESS,-179,2422,2243,5,2,-16,-1.499853537,16,1.222253018,-0.049579317,-0.230580354,176,96,80,0,0.31912044,0.624266962,0,0.228234145,-0.359618577,0.359618577,0,0.624266962,1,1,0
807,4,88,33,80,75,0,3861.154,84,879.331,LESS,-136,1844,1708,4,2,-5,-0.46870423,5,-0.698430296,0.411623632,-0.416095191,155,80,75,0,-0.099725137,0,-0.195083426,-0.122895309,-0.321130371,0.321130371,-0.195083426,0,1,0,1
808,4,89,48,110,128,0,1810.596,94,1170.014,LESS,397,967,1364,1,2,18,1.687335229,18,1.571468165,0.872826581,-0.777232397,238,110,128,1,1.555712144,1.170500555,1.872800887,-1.176283671,0.155944363,0.155944363,1.872800887,1.170500555,1,0,1
809,4,90,9,59,50,1,6114.863,84,744.31,LESS,919,2383,3302,5,2,-9,-0.843667615,9,0,0.411623632,-0.019179731,109,59,50,0,-1.017196402,-0.819350388,-1.170500555,0.228234145,0.623173278,0.623173278,-1.170500555,-0.819350388,1,1,1
810,4,91,44,110,119,0,2444.855,74,2185.069,LESS,704,1479,2183,2,2,9,0.843667615,9,0,-0.049579317,-0.665528888,229,110,119,1,1.376206896,1.170500555,1.521650721,-0.825154217,0.43073225,0.43073225,1.521650721,1.170500555,1,0,1
811,4,92,2,52,50,0,3256.276,44,3182.235,LESS,-494,1880,1386,4,1,-2,-0.187481692,2,-1.222253018,-1.433188165,-0.522624219,102,52,50,0,-1.156811594,-1.092467184,-1.170500555,-0.122895309,-0.64156706,0.64156706,-1.170500555,-1.092467184,0,0,0
812,4,93,8,58,50,0,15007.925,84,1693.974,LESS,-1553,7201,5648,11,2,-8,-0.749926769,8,-0.174607574,0.411623632,1.547035691,108,58,50,0,-1.037141429,-0.858367073,-1.170500555,2.33501087,-1.589451008,1.589451008,-1.170500555,-0.858367073,1,1,0
813,4,94,44,119,110,1,14697.957,74,1801.644,LESS,2866,5088,7954,10,2,-9,-0.843667615,9,0,-0.049579317,1.492445195,229,119,110,0,1.376206896,1.521650721,1.170500555,1.983881416,2.365883426,2.365883426,1.170500555,1.521650721,1,1,1
814,4,95,34,74,80,0,1860.584,84,2868.871,LESS,650,875,1525,2,2,6,0.562445076,6,-0.523822722,0.411623632,-0.768428682,154,74,80,1,-0.119670165,-0.234100111,0,-0.825154217,0.382398224,0.382398224,0,-0.234100111,1,0,1
815,4,96,24,86,80,0,5034.29,24,1765.131,LESS,48,1903,1951,1,1,-6,-0.562445076,6,-0.523822722,-2.355594063,-0.209486523,166,86,80,0,0.119670165,0.234100111,0,-1.176283671,-0.156436654,0.156436654,0,0.234100111,0,0,1
816,4,97,39,66,80,0,7942.371,84,2051.71,LESS,260,3337,3597,6,2,14,1.312371845,14,0.87303787,0.411623632,0.302674678,146,66,80,1,-0.279230385,-0.546233592,0,0.579363599,0.03331915,0.03331915,0,-0.546233592,1,1,1
817,4,98,9,50,59,0,1541.675,100,1136.526,LESS,-26,842,816,2,2,9,0.843667615,9,0,1.149548351,-0.824593836,109,50,59,1,-1.017196402,-1.170500555,-0.819350388,-0.825154217,-0.222672171,0.222672171,-0.819350388,-1.170500555,1,0,1
818,4,99,57,94,110,0,1639.813,100,1921.683,LESS,1145,749,1894,1,2,16,1.499853537,16,1.222253018,1.149548351,-0.80731011,204,94,110,1,0.877581209,0.546233592,1.170500555,-1.176283671,0.825460126,0.825460126,1.170500555,0.546233592,1,0,1
819,4,100,60,110,87,1,3309.907,74,1269.867,LESS,42,1390,1432,5,2,-23,-2.15603946,23,2.444506035,-0.049579317,-0.513178912,197,110,87,0,0.737966017,1.170500555,0.273116796,0.228234145,-0.161807102,0.161807102,0.273116796,1.170500555,0,1,1
820,4,101,33,75,80,0,1652.721,94,1256.019,LESS,662,565,1227,1,2,5,0.46870423,5,-0.698430296,0.872826581,-0.805036797,155,75,80,1,-0.099725137,-0.195083426,0,-1.176283671,0.393139119,0.393139119,0,-0.195083426,1,0,1
821,4,102,15,50,45,0,2686.654,94,747.731,LESS,188,1222,1410,3,2,-5,-0.46870423,5,-0.698430296,0.872826581,-0.622944082,95,50,45,0,-1.296426786,-1.170500555,-1.36558398,-0.474024763,-0.031126217,0.031126217,-1.36558398,-1.170500555,1,0,1
822,4,103,59,89,110,0,1650.025,94,1374.265,LESS,361,934,1295,2,2,21,1.968557767,21,2.095290887,0.872826581,-0.805511608,199,89,110,1,0.777856072,0.351150166,1.170500555,-0.825154217,0.12372168,0.12372168,1.170500555,0.351150166,1,0,1
823,4,104,29,80,94,0,2717.362,84,2032.601,LESS,-638,1774,1136,2,2,14,1.312371845,14,0.87303787,0.411623632,-0.617535895,174,80,94,1,0.279230385,0,0.546233592,-0.825154217,-0.770457795,0.770457795,0.546233592,0,1,0,0
824,4,105,55,110,98,0,1869.81,44,3062.782,LESS,-492,959,467,2,1,-12,-1.124890153,12,0.523822722,-1.433188165,-0.766803831,208,110,98,0,0.957361319,1.170500555,0.702300333,-0.825154217,-0.639776911,0.639776911,0.702300333,1.170500555,0,0,0
825,4,106,29,94,80,1,8438.741,34,2214.246,LESS,-38,3742,3704,7,2,-14,-1.312371845,14,0.87303787,-1.894391114,0.390093651,174,94,80,0,0.279230385,0.546233592,0,0.930493053,-0.233413066,0.233413066,0,0.546233592,0,1,1
826,4,107,57,110,94,0,1844.599,54,1104.464,LESS,-484,1070,586,2,1,-16,-1.499853537,16,1.222253018,-0.971985216,-0.771243905,204,110,94,0,0.877581209,1.170500555,0.546233592,-0.825154217,-0.632616315,0.632616315,0.546233592,1.170500555,0,0,0
827,4,108,39,80,66,0,3257.386,64,1974.123,LESS,731,1564,2295,5,2,-14,-1.312371845,14,0.87303787,-0.510782266,-0.522428729,146,80,66,0,-0.279230385,0,-0.546233592,0.228234145,0.454899263,0.454899263,-0.546233592,0,0,1,1
828,4,109,4,50,54,0,1544.762,100,2619.878,LESS,248,793,1041,2,2,4,0.374963384,4,-0.87303787,1.149548351,-0.824050164,104,50,54,1,-1.116921539,-1.170500555,-1.014433814,-0.825154217,0.022578256,0.022578256,-1.014433814,-1.170500555,1,0,1
829,4,110,55,98,110,0,1977.232,84,2593.056,LESS,68,1151,1219,2,2,12,1.124890153,12,0.523822722,0.411623632,-0.747885039,208,98,110,1,0.957361319,0.702300333,1.170500555,-0.825154217,-0.138535163,0.138535163,1.170500555,0.702300333,1,0,1
830,4,111,2,50,52,0,5245.961,84,2753.649,LESS,317,2422,2739,4,2,2,0.187481692,2,-1.222253018,0.411623632,-0.172207756,102,50,52,1,-1.156811594,-1.170500555,-1.092467184,-0.122895309,0.084338399,0.084338399,-1.092467184,-1.170500555,1,0,1
831,4,112,59,110,89,1,10697.016,64,964.72,LESS,1483,3647,5130,7,2,-21,-1.968557767,21,2.095290887,-0.510782266,0.787813259,199,110,89,0,0.777856072,1.170500555,0.351150166,0.930493053,1.127995324,1.127995324,0.351150166,1.170500555,0,1,1
832,4,113,60,87,110,0,5721.714,94,2594.537,LESS,-73,2690,2617,2,2,23,2.15603946,23,2.444506035,0.872826581,-0.088419778,197,87,110,1,0.737966017,0.273116796,1.170500555,-0.825154217,-0.264740675,0.264740675,1.170500555,0.273116796,1,0,1
833,4,114,52,110,105,0,7035.153,74,1582.319,LESS,1313,2796,4109,6,2,-5,-0.46870423,5,-0.698430296,-0.049579317,0.142898571,215,110,105,0,1.096976512,1.170500555,0.975417129,0.579363599,0.975832651,0.975832651,0.975417129,1.170500555,0,1,1
834,4,115,30,80,96,0,1696.698,94,1457.798,LESS,471,790,1261,2,2,16,1.499853537,16,1.222253018,0.872826581,-0.79729172,176,80,96,1,0.31912044,0,0.624266962,-0.825154217,0.22217988,0.22217988,0.624266962,0,1,0,1
835,4,116,24,80,86,0,5437.186,100,2168.817,LESS,-1051,2972,1921,3,2,6,0.562445076,6,-0.523822722,1.149548351,-0.138529868,166,80,86,1,0.119670165,0,0.234100111,-0.474024763,-1.140123584,1.140123584,0.234100111,0,1,0,0
836,4,117,5,50,55,0,1864.389,100,1405.434,LESS,-139,1122,983,2,2,5,0.46870423,5,-0.698430296,1.149548351,-0.767758559,105,50,55,1,-1.096976512,-1.170500555,-0.975417129,-0.825154217,-0.323815595,0.323815595,-0.975417129,-1.170500555,1,0,1
837,4,118,34,80,74,0,6701.093,54,1933.619,LESS,966,2670,3636,5,2,-6,-0.562445076,6,-0.523822722,-0.971985216,0.084065076,154,80,74,0,-0.119670165,0,-0.234100111,0.228234145,0.665241782,0.665241782,-0.234100111,0,0,1,1
838,4,119,15,45,50,0,1591.685,54,2323.066,LESS,-430,1112,682,2,2,5,0.46870423,5,-0.698430296,-0.971985216,-0.815786247,95,45,50,1,-1.296426786,-1.36558398,-1.170500555,-0.825154217,-0.584282289,0.584282289,-1.170500555,-1.36558398,0,0,0
839,4,120,37,69,80,0,3241.106,44,1387.661,LESS,-729,1814,1085,4,1,11,1.031149307,11,0.349215148,-1.433188165,-0.525295907,149,69,80,1,-0.219395302,-0.429183537,0,-0.122895309,-0.851909579,0.851909579,0,-0.429183537,0,0,0
840,4,121,48,128,110,0,17445.725,74,3053.301,MORE,1311,7595,8906,11,2,-18,-1.687335229,18,1.571468165,-0.049579317,1.976372623,238,128,110,1,1.555712144,1.872800887,1.170500555,2.33501087,0.974042501,0.974042501,1.170500555,1.872800887,0,1,1
841,4,122,8,50,58,1,1605.944,84,2052.862,MORE,951,563,1514,1,2,8,0.749926769,8,-0.174607574,0.411623632,-0.813275001,108,50,58,0,-1.037141429,-1.170500555,-0.858367073,-1.176283671,0.651815664,0.651815664,-0.858367073,-1.170500555,0,0,1
842,4,123,4,54,50,0,4883.308,74,2761.139,MORE,-897,2689,1792,4,1,-4,-0.374963384,4,-0.87303787,-0.049579317,-0.236076952,104,54,50,1,-1.116921539,-1.014433814,-1.170500555,-0.122895309,-1.002282103,1.002282103,-1.170500555,-1.014433814,0,1,0
843,4,124,37,80,69,1,1537.096,100,1027.048,MORE,1179,501,1680,1,2,-11,-1.031149307,11,0.349215148,1.149548351,-0.825400274,149,80,69,1,-0.219395302,0,-0.429183537,-1.176283671,0.855892661,0.855892661,-0.429183537,0,1,0,1
844,4,125,52,105,110,1,2097.817,94,1719.974,MORE,544,1224,1768,3,2,5,0.46870423,5,-0.698430296,0.872826581,-0.726648024,215,105,110,0,1.096976512,0.975417129,1.170500555,-0.474024763,0.287520322,0.287520322,1.170500555,0.975417129,1,1,0
845,4,126,5,55,50,1,6545.841,34,1734.288,MORE,341,2609,2950,5,2,-5,-0.46870423,5,-0.698430296,-1.894391114,0.056722629,105,55,50,1,-1.096976512,-0.975417129,-1.170500555,0.228234145,0.105820189,0.105820189,-1.170500555,-0.975417129,0,1,0
846,4,127,30,96,80,0,5068.047,64,1370.384,MORE,-715,2439,1724,4,1,-16,-1.499853537,16,1.222253018,-0.510782266,-0.203541356,176,96,80,1,0.31912044,0.624266962,0,-0.122895309,-0.839378535,0.839378535,0,0.624266962,0,1,0
847,4,128,33,80,75,1,10908.364,84,1238.404,MORE,1786,3764,5550,2,2,-5,-0.46870423,5,-0.698430296,0.411623632,0.82503514,155,80,75,1,-0.099725137,0,-0.195083426,-0.825154217,1.399202912,1.399202912,-0.195083426,0,1,0,1
848,4,129,48,110,128,1,4783.775,94,1156.103,MORE,37,2030,2067,2,2,18,1.687335229,18,1.571468165,0.872826581,-0.253606361,238,110,128,0,1.555712144,1.170500555,1.872800887,-0.825154217,-0.166282474,0.166282474,1.872800887,1.170500555,1,0,0
849,4,130,9,59,50,1,5229.633,74,1301.781,MORE,1256,1690,2946,5,2,-9,-0.843667615,9,0,-0.049579317,-0.175083387,109,59,50,1,-1.017196402,-0.819350388,-1.170500555,0.228234145,0.924813401,0.924813401,-1.170500555,-0.819350388,0,1,1
850,4,131,44,110,119,1,3058.329,84,1971.817,MORE,1081,1092,2173,3,2,9,0.843667615,9,0,0.411623632,-0.557485962,229,110,119,0,1.376206896,1.170500555,1.521650721,-0.474024763,0.768175355,0.768175355,1.521650721,1.170500555,0,0,1
851,4,132,2,52,50,1,6826.916,64,1442.612,MORE,-767,3318,2551,5,2,-2,-0.187481692,2,-1.222253018,-0.510782266,0.106224589,102,52,50,1,-1.156811594,-1.092467184,-1.170500555,0.228234145,-0.885922412,0.885922412,-1.170500555,-1.092467184,0,1,0
852,4,133,8,58,50,0,3045.346,84,865.667,MORE,428,1384,1812,2,2,-8,-0.749926769,8,-0.174607574,0.411623632,-0.559772483,108,58,50,1,-1.037141429,-0.858367073,-1.170500555,-0.825154217,0.183691674,0.183691674,-1.170500555,-0.858367073,1,0,0
853,4,134,44,119,110,1,3269.93,64,1932.937,MORE,1490,1262,2752,3,2,-9,-0.843667615,9,0,-0.510782266,-0.520219523,229,119,110,1,1.376206896,1.521650721,1.170500555,-0.474024763,1.134260846,1.134260846,1.170500555,1.521650721,0,0,1
854,4,135,34,74,80,1,1471.687,84,2007.49,MORE,812,549,1361,1,2,6,0.562445076,6,-0.523822722,0.411623632,-0.836919881,154,74,80,0,-0.119670165,-0.234100111,0,-1.176283671,0.527400301,0.527400301,0,-0.234100111,0,0,1
855,4,136,24,86,80,1,4238.808,74,1244.525,MORE,1149,1822,2971,5,2,-6,-0.562445076,6,-0.523822722,-0.049579317,-0.34958407,166,86,80,1,0.119670165,0.234100111,0,0.228234145,0.829040424,0.829040424,0,0.234100111,0,1,1
856,4,137,39,66,80,1,1535.682,94,2529.697,MORE,374,1111,1485,4,2,14,1.312371845,14,0.87303787,0.872826581,-0.825649303,146,66,80,0,-0.279230385,-0.546233592,0,-0.122895309,0.135357649,0.135357649,0,-0.546233592,1,1,0
857,4,138,9,50,59,1,1519.357,94,1011.304,MORE,1363,470,1833,1,2,9,0.843667615,9,0,0.872826581,-0.828524405,109,50,59,0,-1.017196402,-1.170500555,-0.819350388,-1.176283671,1.020586378,1.020586378,-0.819350388,-1.170500555,1,0,1
858,4,139,57,94,110,1,2981.751,84,1972.525,MORE,605,1305,1910,3,2,16,1.499853537,16,1.222253018,0.411623632,-0.570972615,204,94,110,0,0.877581209,0.546233592,1.170500555,-0.474024763,0.34211987,0.34211987,1.170500555,0.546233592,0,0,1
859,4,140,60,110,87,0,4321.783,64,1519.537,MORE,-584,2373,1789,4,1,-23,-2.15603946,23,2.444506035,-0.510782266,-0.334970799,197,110,87,1,0.737966017,1.170500555,0.273116796,-0.122895309,-0.72212377,0.72212377,0.273116796,1.170500555,0,1,0
860,4,141,33,75,80,1,1608.882,74,1690.144,MORE,419,601,1020,1,2,5,0.46870423,5,-0.698430296,-0.049579317,-0.812757571,155,75,80,0,-0.099725137,-0.195083426,0,-1.176283671,0.175636003,0.175636003,0,-0.195083426,0,0,0
861,4,142,15,50,45,0,9537.109,24,1331.337,MORE,-2515,5878,3363,5,1,-5,-0.46870423,5,-0.698430296,-2.355594063,0.583534437,95,50,45,1,-1.296426786,-1.170500555,-1.36558398,0.228234145,-2.450512724,2.450512724,-1.36558398,-1.170500555,0,1,0
862,4,143,59,89,110,1,1774.399,84,1497.556,MORE,552,743,1295,1,2,21,1.968557767,21,2.095290887,0.411623632,-0.783607287,199,89,110,0,0.777856072,0.351150166,1.170500555,-1.176283671,0.294680918,0.294680918,1.170500555,0.351150166,0,0,0
863,4,144,29,80,94,1,3304.423,100,1707.999,MORE,990,1525,2515,3,2,14,1.312371845,14,0.87303787,1.149548351,-0.514144735,174,80,94,0,0.279230385,0,0.546233592,-0.474024763,0.686723571,0.686723571,0.546233592,0,1,0,1
864,4,145,55,110,98,0,3033.366,74,1314.099,MORE,354,1223,1577,4,2,-12,-1.124890153,12,0.523822722,-0.049579317,-0.56188236,208,110,98,1,0.957361319,1.170500555,0.702300333,-0.122895309,0.117456158,0.117456158,0.702300333,1.170500555,0,1,0
865,4,146,29,94,80,0,6061.712,74,2336.464,MORE,-1162,3316,2154,3,1,-14,-1.312371845,14,0.87303787,-0.049579317,-0.028540502,174,94,80,1,0.279230385,0.546233592,0,-0.474024763,-1.239476859,1.239476859,0,0.546233592,0,0,0
866,4,147,57,110,94,1,2043.157,100,1473.285,MORE,774,995,1769,3,2,-16,-1.499853537,16,1.222253018,1.149548351,-0.736274555,204,110,94,1,0.877581209,1.170500555,0.546233592,-0.474024763,0.493387468,0.493387468,0.546233592,1.170500555,1,0,1
867,4,148,39,80,66,0,2237.002,74,1753.936,MORE,-822,1511,689,2,1,-14,-1.312371845,14,0.87303787,-0.049579317,-0.702135242,146,80,66,1,-0.279230385,0,-0.546233592,-0.825154217,-0.935151512,0.935151512,-0.546233592,0,0,0,0
868,4,149,4,50,54,1,1632.804,100,1948.105,MORE,1077,609,1686,1,2,4,0.374963384,4,-0.87303787,1.149548351,-0.808544511,104,50,54,0,-1.116921539,-1.170500555,-1.014433814,-1.176283671,0.764595057,0.764595057,-1.014433814,-1.170500555,1,0,1
869,4,150,55,98,110,1,1772.698,94,2106.611,MORE,618,996,1614,3,2,12,1.124890153,12,0.523822722,0.872826581,-0.783906862,208,98,110,0,0.957361319,0.702300333,1.170500555,-0.474024763,0.353755839,0.353755839,1.170500555,0.702300333,1,0,1
870,4,151,2,50,52,1,4730.624,74,1669.864,MORE,175,2008,2183,5,2,2,0.187481692,2,-1.222253018,-0.049579317,-0.262967132,102,50,52,0,-1.156811594,-1.170500555,-1.092467184,0.228234145,-0.042762187,0.042762187,-1.092467184,-1.170500555,0,1,0
871,4,152,59,110,89,1,12463.602,84,1198.06,MORE,1471,4002,5473,5,2,-21,-1.968557767,21,2.095290887,0.411623632,1.098938295,199,110,89,1,0.777856072,1.170500555,0.351150166,0.228234145,1.117254429,1.117254429,0.351150166,1.170500555,0,1,1
872,4,153,60,87,110,1,1735.195,4,430.34,MORE,556,689,1245,1,2,23,2.15603946,23,2.444506035,-3.277999962,-0.790511761,197,87,110,0,0.737966017,0.273116796,1.170500555,-1.176283671,0.298261217,0.298261217,1.170500555,0.273116796,0,0,1
873,4,154,52,110,105,1,3602.502,54,2005.134,MORE,-202,1677,1475,3,2,-5,-0.46870423,5,-0.698430296,-0.971985216,-0.461648089,215,110,105,1,1.096976512,1.170500555,0.975417129,-0.474024763,-0.380205292,0.380205292,0.975417129,1.170500555,0,0,0
874,4,155,30,80,96,1,1572.06,100,937.675,MORE,1047,634,1681,1,2,16,1.499853537,16,1.222253018,1.149548351,-0.819242535,176,80,96,0,0.31912044,0,0.624266962,-1.176283671,0.73774282,0.73774282,0.624266962,0,1,0,1
875,4,156,24,80,86,1,2244.141,94,2591.103,MORE,1180,1063,2243,0,2,6,0.562445076,6,-0.523822722,0.872826581,-0.700877946,166,80,86,0,0.119670165,0,0.234100111,-1.527413125,0.856787735,0.856787735,0.234100111,0,1,0,1
876,4,157,5,50,55,1,2891.789,94,1074.157,MORE,968,1166,2134,3,2,5,0.46870423,5,-0.698430296,0.872826581,-0.586816413,105,50,55,0,-1.096976512,-1.170500555,-0.975417129,-0.474024763,0.667031931,0.667031931,-0.975417129,-1.170500555,1,0,1
877,4,158,34,80,74,0,26075.23,44,2000.168,MORE,-332,10316,9984,12,2,-6,-0.562445076,6,-0.523822722,-1.433188165,3.496171294,154,80,74,1,-0.119670165,0,-0.234100111,2.686140324,-0.496564983,0.496564983,-0.234100111,0,0,1,0
878,4,159,15,45,50,1,1549.096,84,2659.596,MORE,1124,383,1507,1,2,5,0.46870423,5,-0.698430296,0.411623632,-0.823286875,95,45,50,0,-1.296426786,-1.36558398,-1.170500555,-1.176283671,0.806663561,0.806663561,-1.170500555,-1.36558398,0,0,1
879,4,160,37,69,80,1,1694.063,100,1265.452,MORE,1004,887,1891,1,1,11,1.031149307,11,0.349215148,1.149548351,-0.797755787,149,69,80,0,-0.219395302,-0.429183537,0,-1.176283671,0.699254615,0.699254615,0,-0.429183537,1,0,1
880,4,161,3,50,53,0,7326.801,100,1558.426,LESS,500,3657,4157,6,2,3,0.281222538,3,-1.047645444,1.149548351,0.194262612,103,50,53,1,-1.136866566,-1.170500555,-1.053450499,0.579363599,0.248137042,0.248137042,-1.053450499,-1.170500555,1,1,1
881,4,162,20,50,40,0,10370.944,54,3904.349,LESS,-782,5450,4668,5,2,-10,-0.937408461,10,0.174607574,-0.971985216,0.730386582,90,50,40,0,-1.396151924,-1.170500555,-1.560667406,0.228234145,-0.89934853,0.89934853,-1.560667406,-1.170500555,0,1,0
882,4,163,25,80,88,0,6994.066,64,1313.788,LESS,108,3317,3425,6,1,8,0.749926769,8,-0.174607574,-0.510782266,0.13566247,168,80,88,1,0.15956022,0,0.312133481,0.579363599,-0.102732181,0.102732181,0.312133481,0,0,1,1
883,4,164,42,115,110,0,20801.538,74,1803.007,LESS,3649,7642,11291,11,2,-5,-0.46870423,5,-0.698430296,-0.049579317,2.567386839,225,115,110,0,1.296426786,1.36558398,1.170500555,2.33501087,3.066726798,3.066726798,1.170500555,1.36558398,0,1,1
884,4,165,53,103,110,0,3869.451,64,2247.818,LESS,-539,2022,1483,4,1,7,0.656185922,7,-0.349215148,-0.510782266,-0.414633952,213,103,110,1,1.057086457,0.897383758,1.170500555,-0.122895309,-0.681845415,0.681845415,1.170500555,0.897383758,0,0,0
885,4,166,26,90,80,0,10888.107,74,1448.341,LESS,2699,3831,6530,8,2,-10,-0.937408461,10,0.174607574,-0.049579317,0.821467547,170,90,80,0,0.199450275,0.390166852,0,1.281622508,2.216405976,2.216405976,0,0.390166852,0,1,1
886,4,167,35,80,72,1,15326.428,84,1285.388,LESS,1231,6354,7585,6,2,-8,-0.749926769,8,-0.174607574,0.411623632,1.603129341,152,80,72,0,-0.15956022,0,-0.312133481,0.579363599,0.902436537,0.902436537,-0.312133481,0,1,1,1
887,4,168,28,93,80,1,3698.599,64,1498.22,LESS,-319,1849,1530,3,2,-13,-1.218630999,13,0.698430296,-0.510782266,-0.444723817,173,93,80,0,0.259285357,0.507216907,0,-0.474024763,-0.484929014,0.484929014,0,0.507216907,0,0,0
888,4,169,26,80,90,0,1644.716,94,1592.405,LESS,582,840,1422,2,2,10,0.937408461,10,0.174607574,0.872826581,-0.80644661,170,80,90,1,0.199450275,0,0.390166852,-0.825154217,0.321533155,0.321533155,0.390166852,0,1,0,1
889,4,170,25,88,80,1,5217.47,94,1230.066,LESS,1189,1827,3016,4,2,-8,-0.749926769,8,-0.174607574,0.872826581,-0.177225493,168,88,80,0,0.15956022,0.312133481,0,-0.122895309,0.864843406,0.864843406,0,0.312133481,1,1,1
890,4,171,36,80,70,1,7844.832,84,852.353,LESS,1317,2997,4314,7,2,-10,-0.937408461,10,0.174607574,0.411623632,0.285496445,150,80,70,0,-0.199450275,0,-0.390166852,0.930493053,0.979412949,0.979412949,-0.390166852,0,1,1,1
891,4,172,28,80,93,0,1715.847,94,1562.843,LESS,420,980,1400,2,2,13,1.218630999,13,0.698430296,0.872826581,-0.793919264,173,80,93,1,0.259285357,0,0.507216907,-0.825154217,0.176531078,0.176531078,0.507216907,0,1,0,1
892,4,173,21,82,80,0,2732.037,74,2427.542,LESS,-754,1525,771,3,2,-2,-0.187481692,2,-1.222253018,-0.049579317,-0.614951384,162,82,80,0,0.039890055,0.07803337,0,-0.474024763,-0.874286443,0.874286443,0,0.07803337,0,0,0
893,4,174,19,50,41,0,19264.999,74,1256.026,LESS,-1404,8579,7175,10,1,-9,-0.843667615,9,0,-0.049579317,2.296776888,91,50,41,0,-1.376206896,-1.170500555,-1.521650721,1.983881416,-1.4560849,1.4560849,-1.521650721,-1.170500555,0,1,0
894,4,175,56,96,110,0,2416.989,84,1398.906,LESS,-693,1754,1061,2,2,14,1.312371845,14,0.87303787,0.411623632,-0.670436552,206,96,110,1,0.917471264,0.624266962,1.170500555,-0.825154217,-0.819686895,0.819686895,1.170500555,0.624266962,1,0,0
895,4,176,23,80,85,0,17362.41,34,1329.615,LESS,-1627,8035,6408,11,1,5,0.46870423,5,-0.698430296,-1.894391114,1.961699472,165,80,85,1,0.099725137,0,0.195083426,2.33501087,-1.655686524,1.655686524,0.195083426,0,0,1,0
896,4,177,10,60,50,1,8393.032,84,932.879,LESS,-710,3892,3182,5,2,-10,-0.937408461,10,0.174607574,0.411623632,0.38204354,110,60,50,0,-0.997251374,-0.780333703,-1.170500555,0.228234145,-0.834903163,0.834903163,-1.170500555,-0.780333703,1,1,0
897,4,178,19,41,50,0,4098.332,100,2606.828,LESS,513,2070,2583,2,2,9,0.843667615,9,0,1.149548351,-0.374324219,91,41,50,1,-1.376206896,-1.521650721,-1.170500555,-0.825154217,0.259773011,0.259773011,-1.170500555,-1.521650721,1,0,1
898,4,179,56,110,96,0,10515.086,64,1833.034,LESS,1829,3846,5675,7,2,-14,-1.312371845,14,0.87303787,-0.510782266,0.755772375,206,110,96,0,0.917471264,1.170500555,0.624266962,0.930493053,1.437691118,1.437691118,0.624266962,1.170500555,0,1,1
899,4,180,35,72,80,0,31663.561,34,1804.845,LESS,-834,13069,12235,8,1,8,0.749926769,8,-0.174607574,-1.894391114,4.480368885,152,72,80,1,-0.15956022,-0.312133481,0,1.281622508,-0.945892407,0.945892407,0,-0.312133481,0,1,0
900,4,181,11,49,50,0,13825.959,44,1351.529,LESS,-3297,7786,4489,8,1,1,0.093740846,1,-1.396860592,-1.433188165,1.338871913,99,49,50,1,-1.216646676,-1.20951724,-1.170500555,1.281622508,-3.150461022,3.150461022,-1.170500555,-1.20951724,0,1,0
901,4,182,17,43,50,0,3532.394,54,1421.12,LESS,-876,1958,1082,4,1,7,0.656185922,7,-0.349215148,-0.971985216,-0.473995269,93,43,50,1,-1.336316841,-1.443617351,-1.170500555,-0.122895309,-0.983485538,0.983485538,-1.170500555,-1.443617351,0,1,0
902,4,183,1,51,50,0,6932.072,74,1164.222,LESS,409,2992,3401,6,1,-1,-0.093740846,1,-1.396860592,-0.049579317,0.124744301,101,51,50,0,-1.176756621,-1.131483869,-1.170500555,0.579363599,0.166685258,0.166685258,-1.170500555,-1.131483869,0,1,1
903,4,184,41,112,110,0,4322.377,64,1126.478,LESS,-713,2326,1613,4,1,-2,-0.187481692,2,-1.222253018,-0.510782266,-0.334866186,222,112,110,0,1.236591704,1.248533925,1.170500555,-0.122895309,-0.837588386,0.837588386,1.170500555,1.248533925,0,1,0
904,4,185,20,40,50,0,1712.77,94,2224.272,LESS,260,982,1242,2,2,10,0.937408461,10,0.174607574,0.872826581,-0.794461174,90,40,50,1,-1.396151924,-1.560667406,-1.170500555,-0.825154217,0.03331915,0.03331915,-1.170500555,-1.560667406,1,0,1
905,4,186,1,50,51,0,8741.852,84,2383.411,LESS,-1625,4556,2931,6,2,1,0.093740846,1,-1.396860592,0.411623632,0.443476515,101,50,51,1,-1.176756621,-1.170500555,-1.131483869,0.579363599,-1.653896375,1.653896375,-1.131483869,-1.170500555,1,1,0
906,4,187,23,85,80,0,18617.121,34,1863.061,LESS,708,7112,7820,10,1,-5,-0.46870423,5,-0.698430296,-1.894391114,2.182674848,165,85,80,0,0.099725137,0.195083426,0,1.983881416,0.434312548,0.434312548,0,0.195083426,0,1,1
907,4,188,11,50,49,0,7029.46,64,2016.111,LESS,2168,1863,4031,5,1,-1,-0.093740846,1,-1.396860592,-0.510782266,0.14189594,99,50,49,0,-1.216646676,-1.170500555,-1.20951724,0.228234145,1.74112139,1.74112139,-1.20951724,-1.170500555,0,1,1
908,4,189,17,50,43,0,17355.536,84,1470.056,LESS,-2358,8008,5650,7,2,-7,-0.656185922,7,-0.349215148,0.411623632,1.960488847,93,50,43,0,-1.336316841,-1.170500555,-1.443617351,0.930493053,-2.30998602,2.30998602,-1.443617351,-1.170500555,1,1,0
909,4,190,21,80,82,0,1770.037,84,1164.903,LESS,-155,1074,919,1,2,2,0.187481692,2,-1.222253018,0.411623632,-0.784375508,162,80,82,1,0.039890055,0,0.07803337,-1.176283671,-0.338136788,0.338136788,0.07803337,0,1,0,0
910,4,191,10,50,60,0,5798.199,94,2559.67,LESS,-549,3244,2695,6,2,10,0.937408461,10,0.174607574,0.872826581,-0.074949503,110,50,60,1,-0.997251374,-1.170500555,-0.780333703,0.579363599,-0.69079616,0.69079616,-0.780333703,-1.170500555,1,1,0
911,4,192,3,53,50,0,2808.845,84,750.026,LESS,165,1435,1600,4,2,-3,-0.281222538,3,-1.047645444,0.411623632,-0.601424224,103,53,50,0,-1.136866566,-1.053450499,-1.170500555,-0.122895309,-0.051712932,0.051712932,-1.170500555,-1.053450499,1,0,1
912,4,193,45,122,110,1,8212.237,54,1251.279,LESS,497,3407,3904,6,2,-12,-1.124890153,12,0.523822722,-0.971985216,0.350202547,232,122,110,0,1.436041979,1.638700776,1.170500555,0.579363599,0.245451818,0.245451818,1.170500555,1.638700776,0,1,1
913,4,194,38,67,80,0,2293.854,94,1013.764,LESS,-654,1678,1024,2,2,13,1.218630999,13,0.698430296,0.872826581,-0.692122664,147,67,80,1,-0.259285357,-0.507216907,0,-0.825154217,-0.784778988,0.784778988,0,-0.507216907,1,0,0
914,4,195,38,80,67,1,8415.61,84,1051.495,LESS,2751,2594,5345,5,2,-13,-1.218630999,13,0.698430296,0.411623632,0.386019899,147,80,67,0,-0.259285357,0,-0.507216907,0.228234145,2.262949852,2.262949852,-0.507216907,0,1,1,1
915,4,196,36,70,80,0,2697.017,74,812.103,LESS,-1339,1936,597,2,1,10,0.937408461,10,0.174607574,-0.049579317,-0.621118986,150,70,80,1,-0.199450275,-0.390166852,0,-0.825154217,-1.397905054,1.397905054,0,-0.390166852,0,0,0
916,4,197,45,110,122,0,2157.263,94,1847.89,LESS,-177,1185,1008,2,2,12,1.124890153,12,0.523822722,0.872826581,-0.7161786,232,110,122,1,1.436041979,1.170500555,1.638700776,-0.825154217,-0.357828428,0.357828428,1.638700776,1.170500555,1,0,0
917,4,198,42,110,115,0,2450.887,94,722.905,LESS,-382,1544,1162,3,2,5,0.46870423,5,-0.698430296,0.872826581,-0.664466553,225,110,115,1,1.296426786,1.170500555,1.36558398,-0.474024763,-0.541318711,0.541318711,1.36558398,1.170500555,1,0,0
918,4,199,41,110,112,0,3564.241,70,1603.798,LESS,-201,2263,2062,5,2,2,0.187481692,2,-1.222253018,-0.234060497,-0.468386485,222,110,112,1,1.236591704,1.170500555,1.248533925,0.228234145,-0.379310217,0.379310217,1.248533925,1.170500555,0,1,0
919,4,200,53,110,103,0,2070.507,74,1764.473,LESS,-1171,1873,702,2,1,-7,-0.656185922,7,-0.349215148,-0.049579317,-0.731457767,213,110,103,0,1.057086457,1.170500555,0.897383758,-0.825154217,-1.24753253,1.24753253,0.897383758,1.170500555,0,0,0
920,4,201,3,50,53,1,24275.208,44,1272.221,MORE,2717,8525,11242,10,1,3,0.281222538,3,-1.047645444,-1.433188165,3.179157625,103,50,53,0,-1.136866566,-1.170500555,-1.053450499,1.983881416,2.232517318,2.232517318,-1.053450499,-1.170500555,0,1,1
921,4,202,20,50,40,0,28694.544,84,4965.2,MORE,5631,7162,12793,6,2,-10,-0.937408461,10,0.174607574,0.411623632,3.957475846,90,50,40,1,-1.396151924,-1.170500555,-1.560667406,0.579363599,4.840764554,4.840764554,-1.560667406,-1.170500555,0,1,1
922,4,203,25,80,88,1,9090.346,94,1104.882,MORE,-1088,4415,3327,4,2,8,0.749926769,8,-0.174607574,0.872826581,0.504852077,168,80,88,0,0.15956022,0,0.312133481,-0.122895309,-1.173241342,1.173241342,0.312133481,0,1,1,0
923,4,204,42,115,110,0,2248.756,84,1327.852,MORE,150,1528,1678,4,2,-5,-0.46870423,5,-0.698430296,0.411623632,-0.700065168,225,115,110,1,1.296426786,1.36558398,1.170500555,-0.122895309,-0.06513905,0.06513905,1.170500555,1.36558398,1,1,0
924,4,205,53,103,110,1,6266.904,94,1491.438,MORE,1271,2352,3623,4,1,7,0.656185922,7,-0.349215148,0.872826581,0.007597206,213,103,110,0,1.057086457,0.897383758,1.170500555,-0.122895309,0.938239519,0.938239519,1.170500555,0.897383758,1,1,1
925,4,206,26,90,80,0,2477.286,80,1640.219,MORE,657,1504,2161,2,2,-10,-0.937408461,10,0.174607574,0.227142453,-0.659817252,170,90,80,1,0.199450275,0.390166852,0,-0.825154217,0.388663746,0.388663746,0,0.390166852,0,0,1
926,4,207,35,80,72,1,3713.833,94,1300.195,MORE,1015,1343,2358,3,2,-8,-0.749926769,8,-0.174607574,0.872826581,-0.442040857,152,80,72,1,-0.15956022,0,-0.312133481,-0.474024763,0.709100435,0.709100435,-0.312133481,0,1,0,1
927,4,208,28,93,80,0,3301.402,74,1015.732,MORE,145,1420,1565,4,1,-13,-1.218630999,13,0.698430296,-0.049579317,-0.514676783,173,93,80,1,0.259285357,0.507216907,0,-0.122895309,-0.069614423,0.069614423,0,0.507216907,0,1,0
928,4,209,26,80,90,1,4661.243,84,1549.132,MORE,1159,1430,2589,4,2,10,0.937408461,10,0.174607574,0.411623632,-0.275186274,170,80,90,0,0.199450275,0,0.390166852,-0.122895309,0.83799117,0.83799117,0.390166852,0,0,1,1
929,4,210,25,88,80,0,7973.228,84,874.623,MORE,1595,2771,4366,7,2,-8,-0.749926769,8,-0.174607574,0.411623632,0.308109106,168,88,80,1,0.15956022,0.312133481,0,0.930493053,1.228243673,1.228243673,0,0.312133481,0,1,1
930,4,211,36,80,70,0,23899.959,54,1707.359,MORE,-901,10086,9185,7,2,-10,-0.937408461,10,0.174607574,-0.971985216,3.113070064,150,80,70,1,-0.199450275,0,-0.390166852,0.930493053,-1.005862402,1.005862402,-0.390166852,0,0,1,0
931,4,212,28,80,93,1,9832.332,94,868.877,MORE,1322,3741,5063,4,2,13,1.218630999,13,0.698430296,0.872826581,0.635528094,173,80,93,0,0.259285357,0,0.507216907,-0.122895309,0.983888321,0.983888321,0.507216907,0,1,1,1
932,4,213,21,82,80,1,8348.35,84,895.719,MORE,1622,3073,4695,5,2,-2,-0.187481692,2,-1.222253018,0.411623632,0.3741743,162,82,80,1,0.039890055,0.07803337,0,0.228234145,1.252410686,1.252410686,0,0.07803337,0,1,1
933,4,214,19,50,41,1,6603.464,74,1542.974,MORE,1091,2584,3675,5,2,-9,-0.843667615,9,0,-0.049579317,0.066870993,91,50,41,1,-1.376206896,-1.170500555,-1.521650721,0.228234145,0.777126101,0.777126101,-1.521650721,-1.170500555,0,1,1
934,4,215,56,96,110,1,1956.746,74,2460.617,MORE,1026,511,1537,1,2,14,1.312371845,14,0.87303787,-0.049579317,-0.751492962,206,96,110,0,0.917471264,0.624266962,1.170500555,-1.176283671,0.718946255,0.718946255,1.170500555,0.624266962,0,0,1
935,4,216,23,80,85,1,7123.875,94,1315.515,MORE,352,3368,3720,5,2,5,0.46870423,5,-0.698430296,0.872826581,0.158523984,165,80,85,0,0.099725137,0,0.195083426,0.228234145,0.115666009,0.115666009,0.195083426,0,1,1,0
936,4,217,10,60,50,0,4671.155,64,1529.473,MORE,465,1244,1709,3,1,-10,-0.937408461,10,0.174607574,-0.510782266,-0.273440607,110,60,50,1,-0.997251374,-0.780333703,-1.170500555,-0.474024763,0.216809433,0.216809433,-1.170500555,-0.780333703,0,0,0
937,4,218,19,41,50,1,2589.862,94,1512.231,MORE,589,996,1585,3,2,9,0.843667615,9,0,0.872826581,-0.639990755,91,41,50,0,-1.376206896,-1.521650721,-1.170500555,-0.474024763,0.327798677,0.327798677,-1.170500555,-1.521650721,1,0,1
938,4,219,56,110,96,0,2795.518,84,2422.467,MORE,-750,1576,826,2,1,-14,-1.312371845,14,0.87303787,0.411623632,-0.603771329,206,110,96,1,0.917471264,1.170500555,0.624266962,-0.825154217,-0.870706145,0.870706145,0.624266962,1.170500555,1,0,0
939,4,220,35,72,80,1,10457.271,94,789.193,MORE,-220,4410,4190,5,2,8,0.749926769,8,-0.174607574,0.872826581,0.745590196,152,72,80,0,-0.15956022,-0.312133481,0,0.228234145,-0.396316634,0.396316634,0,-0.312133481,1,1,0
940,4,221,11,49,50,1,19451.716,74,1977.379,MORE,2458,6317,8775,11,2,1,0.093740846,1,-1.396860592,-0.049579317,2.329660842,99,49,50,0,-1.216646676,-1.20951724,-1.170500555,2.33501087,2.000693009,2.000693009,-1.170500555,-1.20951724,0,1,1
941,4,222,17,43,50,1,3254.627,94,2336.704,MORE,1181,1262,2443,3,2,7,0.656185922,7,-0.349215148,0.872826581,-0.522914635,93,43,50,0,-1.336316841,-1.443617351,-1.170500555,-0.474024763,0.85768281,0.85768281,-1.170500555,-1.443617351,1,0,1
942,4,223,1,51,50,1,3079.733,84,2434.106,MORE,-504,1769,1265,3,1,-1,-0.093740846,1,-1.396860592,0.411623632,-0.553716363,101,51,50,1,-1.176756621,-1.131483869,-1.170500555,-0.474024763,-0.650517806,0.650517806,-1.170500555,-1.131483869,1,0,0
943,4,224,41,112,110,1,3459.986,94,1680.285,MORE,1204,1038,2242,3,2,-2,-0.187481692,2,-1.222253018,0.872826581,-0.486747516,222,112,110,1,1.236591704,1.248533925,1.170500555,-0.474024763,0.878269525,0.878269525,1.170500555,1.248533925,1,0,1
944,4,225,20,40,50,1,15340.949,100,3601.285,MORE,-1931,7003,5072,9,2,10,0.937408461,10,0.174607574,1.149548351,1.605686729,90,40,50,0,-1.396151924,-1.560667406,-1.170500555,1.632751962,-1.927789187,1.927789187,-1.170500555,-1.560667406,1,1,0
945,4,226,1,50,51,1,19093.958,44,1942.265,MORE,2136,6912,9048,8,1,1,0.093740846,1,-1.396860592,-1.433188165,2.266653736,101,50,51,0,-1.176756621,-1.170500555,-1.131483869,1.281622508,1.712479005,1.712479005,-1.131483869,-1.170500555,0,1,1
946,4,227,23,85,80,1,13427.761,94,2238.684,MORE,-925,6123,5198,8,2,-5,-0.46870423,5,-0.698430296,0.872826581,1.268742654,165,85,80,1,0.099725137,0.195083426,0,1.281622508,-1.027344191,1.027344191,0,0.195083426,1,1,0
947,4,228,11,50,49,1,6109.62,94,2826.025,MORE,-177,2683,2506,5,2,-1,-0.093740846,1,-1.396860592,0.872826581,-0.02010311,99,50,49,1,-1.216646676,-1.170500555,-1.20951724,0.228234145,-0.357828428,0.357828428,-1.20951724,-1.170500555,1,1,0
948,4,229,17,50,43,0,8288.198,54,2579.258,MORE,-904,4219,3315,6,1,-7,-0.656185922,7,-0.349215148,-0.971985216,0.363580537,93,50,43,1,-1.336316841,-1.170500555,-1.443617351,0.579363599,-1.008547625,1.008547625,-1.443617351,-1.170500555,0,1,0
949,4,230,21,80,82,1,1916.633,100,1835.514,MORE,519,610,1129,2,1,2,0.187481692,2,-1.222253018,1.149548351,-0.758557526,162,80,82,0,0.039890055,0,0.07803337,-0.825154217,0.265143458,0.265143458,0.07803337,0,1,0,0
950,4,231,10,50,60,1,7507.572,94,2338.874,MORE,1030,2693,3723,5,2,10,0.937408461,10,0.174607574,0.872826581,0.226099377,110,50,60,0,-0.997251374,-1.170500555,-0.780333703,0.228234145,0.722526553,0.722526553,-0.780333703,-1.170500555,1,1,1
951,4,232,3,53,50,0,13232.992,54,2339.615,MORE,1189,5276,6465,6,1,-3,-0.281222538,3,-1.047645444,-0.971985216,1.23444061,103,53,50,1,-1.136866566,-1.053450499,-1.170500555,0.579363599,0.864843406,0.864843406,-1.170500555,-1.053450499,0,1,1
952,4,233,45,122,110,0,11606.772,54,2165.651,MORE,1968,4044,6012,8,1,-12,-1.124890153,12,0.523822722,-0.971985216,0.948036349,232,122,110,1,1.436041979,1.638700776,1.170500555,1.281622508,1.56210648,1.56210648,1.170500555,1.638700776,0,1,1
953,4,234,38,67,80,1,12451.409,94,968.814,MORE,-770,5552,4782,6,2,13,1.218630999,13,0.698430296,0.872826581,1.096790906,147,67,80,0,-0.259285357,-0.507216907,0,0.579363599,-0.888607636,0.888607636,0,-0.507216907,1,1,0
954,4,235,38,80,67,0,18886.015,84,1100.562,MORE,-2794,8438,5644,10,2,-13,-1.218630999,13,0.698430296,0.411623632,2.230031532,147,80,67,1,-0.259285357,0,-0.507216907,1.983881416,-2.700238523,2.700238523,-0.507216907,0,0,1,0
955,4,236,36,70,80,1,1614.061,14,502.289,MORE,395,516,911,1,2,10,0.937408461,10,0.174607574,-2.816797013,-0.811845463,150,70,80,0,-0.199450275,-0.390166852,0,-1.176283671,0.154154214,0.154154214,0,-0.390166852,0,0,0
956,4,237,45,110,122,0,7399.05,84,2198.369,MORE,-1433,3892,2459,6,1,12,1.124890153,12,0.523822722,0.411623632,0.206986856,232,110,122,0,1.436041979,1.170500555,1.638700776,0.579363599,-1.482042062,1.482042062,1.638700776,1.170500555,0,1,0
957,4,238,42,110,115,1,1900.737,94,3477.038,MORE,427,755,1182,1,2,5,0.46870423,5,-0.698430296,0.872826581,-0.761357074,225,110,115,0,1.296426786,1.170500555,1.36558398,-1.176283671,0.1827966,0.1827966,1.36558398,1.170500555,1,0,0
958,4,239,41,110,112,1,3355.031,100,1088.039,MORE,879,1088,1967,3,2,2,0.187481692,2,-1.222253018,1.149548351,-0.505231829,222,110,112,0,1.236591704,1.170500555,1.248533925,-0.474024763,0.587370296,0.587370296,1.248533925,1.170500555,1,0,1
959,4,240,53,110,103,1,3006.93,100,2546.3,MORE,1135,1047,2182,3,2,-7,-0.656185922,7,-0.349215148,1.149548351,-0.566538177,213,110,103,1,1.057086457,1.170500555,0.897383758,-0.474024763,0.816509381,0.816509381,0.897383758,1.170500555,1,0,1
960,5,1,49,110,131,0,7222.438,64,1544.631,LESS,-294,3310,3016,8,1,21,1.968557767,21,2.095290887,-0.917328644,1.051231771,241,110,131,1,1.615547226,1.170500555,1.989850943,1.50555795,-0.895369797,0.895369797,1.989850943,1.170500555,0,1,0
961,5,2,13,47,50,0,4765.239,54,936.432,LESS,-192,2140,1948,6,1,3,0.281222538,3,-1.047645444,-1.400133194,-0.042278417,97,47,50,1,-1.256536731,-1.28755061,-1.170500555,0.54964814,-0.751120685,0.751120685,-1.170500555,-1.28755061,0,1,0
962,5,3,16,50,44,1,3295.646,94,1258.302,LESS,564,1528,2092,3,2,-6,-0.562445076,6,-0.523822722,0.531085005,-0.696281173,94,50,44,0,-1.316371814,-1.170500555,-1.404600665,-0.884216574,0.318019796,0.318019796,-1.404600665,-1.170500555,1,0,1
963,5,4,7,57,50,1,2944.05,74,724.291,LESS,124,1310,1434,3,2,-7,-0.656185922,7,-0.349215148,-0.434524095,-0.852749497,107,57,50,0,-1.057086457,-0.897383758,-1.170500555,-0.884216574,-0.304231278,0.304231278,-1.170500555,-0.897383758,0,0,0
964,5,5,18,42,50,0,4044.965,84,1578.607,LESS,194,1670,1864,4,2,8,0.749926769,8,-0.174607574,0.048280455,-0.362816948,92,42,50,1,-1.356261869,-1.482634036,-1.170500555,-0.406261669,-0.205236789,0.205236789,-1.170500555,-1.482634036,1,0,0
965,5,6,51,108,110,1,5083.667,64,1344.185,LESS,802,2152,2954,4,2,2,0.187481692,2,-1.222253018,-0.917328644,0.099429382,218,108,110,1,1.156811594,1.092467184,1.170500555,-0.406261669,0.654601058,0.654601058,1.170500555,1.092467184,0,0,1
966,5,7,31,78,80,0,2478.845,94,1848.898,LESS,238,1438,1676,2,2,2,0.187481692,2,-1.222253018,0.531085005,-1.059776444,158,78,80,1,-0.039890055,-0.07803337,0,-1.362171478,-0.143011681,0.143011681,0,-0.07803337,1,0,0
967,5,8,58,110,92,0,6831.774,84,1540.628,LESS,188,3190,3378,5,2,-18,-1.687335229,18,1.571468165,0.048280455,0.877377287,202,110,92,0,0.837691154,1.170500555,0.468200222,0.071693236,-0.213722031,0.213722031,0.468200222,1.170500555,1,1,0
968,5,9,12,50,48,0,7215.97,84,1853.52,LESS,1224,3128,4352,7,2,-2,-0.187481692,2,-1.222253018,0.048280455,1.048353362,98,50,48,0,-1.236591704,-1.170500555,-1.248533925,1.027603045,1.251396406,1.251396406,-1.248533925,-1.170500555,1,1,1
969,5,10,54,110,101,0,7304.288,54,1411.268,LESS,-264,3270,3006,6,1,-9,-0.843667615,9,0,-1.400133194,1.087656908,211,110,101,0,1.017196402,1.170500555,0.819350388,0.54964814,-0.852943588,0.852943588,0.819350388,1.170500555,0,1,0
970,5,11,14,46,50,1,7185.6,74,1168.595,LESS,2036,2352,4388,7,2,4,0.374963384,4,-0.87303787,-0.434524095,1.034838012,96,46,50,1,-1.276481759,-1.326567295,-1.170500555,1.027603045,2.399732477,2.399732477,-1.170500555,-1.326567295,0,1,1
971,5,12,22,80,83,1,9791.269,64,2653.804,LESS,3056,3516,6572,9,2,3,0.281222538,3,-1.047645444,-0.917328644,2.194420772,163,80,83,1,0.059835082,0,0.117050055,1.983512854,3.842223602,3.842223602,0.117050055,0,0,1,1
972,5,13,6,50,56,0,5181.088,84,1051.945,LESS,348,2350,2698,6,2,6,0.562445076,6,-0.523822722,0.048280455,0.142783972,106,50,56,1,-1.077031484,-1.170500555,-0.936400444,0.54964814,0.012551087,0.012551087,-0.936400444,-1.170500555,0,1,1
973,5,14,13,50,47,1,6220.18,94,1815.246,LESS,1098,2502,3600,5,2,-3,-0.281222538,3,-1.047645444,0.531085005,0.605203861,97,50,47,0,-1.256536731,-1.170500555,-1.28755061,0.071693236,1.073206326,1.073206326,-1.28755061,-1.170500555,1,1,1
974,5,15,46,110,124,0,4647.592,74,1324.261,LESS,-72,2394,2322,4,2,14,1.312371845,14,0.87303787,-0.434524095,-0.094634044,234,110,124,1,1.475932034,1.170500555,1.716734147,-0.406261669,-0.581415847,0.581415847,1.716734147,1.170500555,0,0,0
975,5,16,27,91,80,0,8988.713,64,1316.476,LESS,-488,3920,3432,7,2,-11,-1.031149307,11,0.349215148,-0.917328644,1.837264855,171,91,80,0,0.219395302,0.429183537,0,1.027603045,-1.169725952,1.169725952,0,0.429183537,0,1,0
976,5,17,40,64,80,0,3464.902,100,1387.95,LESS,454,1732,2186,4,2,16,1.499853537,16,1.222253018,0.820767734,-0.620958352,144,64,80,1,-0.31912044,-0.624266962,0,-0.406261669,0.162457027,0.162457027,0,-0.624266962,1,0,1
977,5,18,22,83,80,0,10276.159,74,2298.076,LESS,-248,4700,4452,8,2,-3,-0.281222538,3,-1.047645444,-0.434524095,2.410207998,163,83,80,0,0.059835082,0.117050055,0,1.50555795,-0.830316276,0.830316276,0,0.117050055,0,1,0
978,5,19,54,101,110,0,5499.503,74,1250.655,LESS,466,2330,2796,6,2,9,0.843667615,9,0,-0.434524095,0.284485986,211,101,110,1,1.017196402,0.819350388,1.170500555,0.54964814,0.179427511,0.179427511,1.170500555,0.819350388,0,1,1
979,5,20,6,56,50,1,6396.53,84,1882.386,LESS,1716,2336,4052,6,2,-6,-0.562445076,6,-0.523822722,0.048280455,0.683683676,106,56,50,0,-1.077031484,-0.936400444,-1.170500555,0.54964814,1.947186242,1.947186242,-1.170500555,-0.936400444,1,1,1
980,5,21,18,50,42,0,3607.382,84,1577.839,LESS,430,1782,2212,4,2,-8,-0.749926769,8,-0.174607574,0.048280455,-0.557551468,92,50,42,0,-1.356261869,-1.170500555,-1.482634036,-0.406261669,0.12851606,0.12851606,-1.482634036,-1.170500555,1,0,1
981,5,22,43,110,117,0,4718.766,94,1782.365,LESS,28,2580,2608,4,2,7,0.656185922,7,-0.349215148,0.531085005,-0.062959973,227,110,117,1,1.336316841,1.170500555,1.443617351,-0.406261669,-0.439995148,0.439995148,1.443617351,1.170500555,1,0,0
982,5,23,32,77,80,0,6240.307,100,1423.497,LESS,302,3126,3428,6,2,3,0.281222538,3,-1.047645444,0.820767734,0.61416084,157,77,80,1,-0.059835082,-0.117050055,0,0.54964814,-0.052502434,0.052502434,0,-0.117050055,1,1,1
983,5,24,27,80,91,0,3710.405,100,2037.012,LESS,490,1854,2344,4,2,11,1.031149307,11,0.349215148,0.820767734,-0.511703859,171,80,91,1,0.219395302,0,0.429183537,-0.406261669,0.213368479,0.213368479,0.429183537,0,1,0,1
984,5,25,16,44,50,0,4812.778,90,1891.045,LESS,324,2618,2942,4,2,6,0.562445076,6,-0.523822722,0.337963185,-0.021122466,94,44,50,1,-1.316371814,-1.404600665,-1.170500555,-0.406261669,-0.021389881,0.021389881,-1.170500555,-1.404600665,1,0,1
985,5,26,7,50,57,0,3689.549,100,1099.108,LESS,-230,2138,1908,4,2,7,0.656185922,7,-0.349215148,0.820767734,-0.520985259,107,50,57,1,-1.057086457,-1.170500555,-0.897383758,-0.406261669,-0.80486055,0.80486055,-0.897383758,-1.170500555,1,0,0
986,5,27,14,50,46,0,7967.58,90,1302.56,LESS,826,3218,4044,8,2,-4,-0.374963384,4,-0.87303787,0.337963185,1.382837135,96,50,46,0,-1.276481759,-1.170500555,-1.326567295,1.50555795,0.688542026,0.688542026,-1.326567295,-1.170500555,1,1,1
987,5,28,51,110,108,1,6837.966,74,1694.565,LESS,252,3008,3260,7,2,-2,-0.187481692,2,-1.222253018,-0.434524095,0.88013287,218,110,108,0,1.156811594,1.170500555,1.092467184,1.027603045,-0.123212784,0.123212784,1.092467184,1.170500555,0,1,0
988,5,29,50,133,110,1,3779.256,74,1478.918,LESS,286,1268,1554,3,2,-23,-2.15603946,23,2.444506035,-0.434524095,-0.481063577,243,133,110,0,1.655437281,2.067884313,1.170500555,-0.884216574,-0.075129746,0.075129746,1.170500555,2.067884313,0,0,0
989,5,30,49,131,110,1,3215.512,84,764.005,LESS,750,1238,1988,3,2,-21,-1.968557767,21,2.095290887,0.048280455,-0.73194265,241,131,110,0,1.615547226,1.989850943,1.170500555,-0.884216574,0.581062295,0.581062295,1.170500555,1.989850943,0,0,1
990,5,31,47,126,110,1,3665.191,80,1426.142,LESS,1262,1486,2748,3,2,-16,-1.499853537,16,1.222253018,-0.144841365,-0.531825131,236,126,110,0,1.515822089,1.794767517,1.170500555,-0.884216574,1.305136271,1.305136271,1.170500555,1.794767517,0,0,1
991,5,32,50,110,133,0,6854.612,64,1179.632,LESS,204,3166,3370,6,2,23,2.15603946,23,2.444506035,-0.917328644,0.887540724,243,110,133,1,1.655437281,1.170500555,2.067884313,0.54964814,-0.191094719,0.191094719,2.067884313,1.170500555,0,1,0
992,5,33,47,110,126,0,4058.527,14,1981.72,LESS,-962,2374,1412,4,1,16,1.499853537,16,1.222253018,-3.331351392,-0.356781545,236,110,126,1,1.515822089,1.170500555,1.794767517,-0.406261669,-1.840060063,1.840060063,1.794767517,1.170500555,0,0,0
993,5,34,12,48,50,0,9497.24,44,1082.924,LESS,38,3864,3902,8,1,2,0.187481692,2,-1.222253018,-1.882937743,2.06357109,98,48,50,1,-1.236591704,-1.248533925,-1.170500555,1.50555795,-0.425853078,0.425853078,-1.170500555,-1.248533925,0,1,0
994,5,35,32,80,77,0,5471.917,74,1513.739,LESS,150,2362,2512,5,2,-3,-0.281222538,3,-1.047645444,-0.434524095,0.27220958,157,80,77,0,-0.059835082,0,-0.117050055,0.071693236,-0.267461896,0.267461896,-0.117050055,0,0,1,0
995,5,36,43,117,110,1,2581.39,94,1520.381,LESS,1032,1014,2046,3,2,-7,-0.656185922,7,-0.349215148,0.531085005,-1.014141555,227,117,110,0,1.336316841,1.443617351,1.170500555,-0.884216574,0.979868665,0.979868665,1.170500555,1.443617351,1,0,1
996,5,37,40,80,64,1,2750.297,100,824.22,LESS,400,1206,1606,3,2,-16,-1.499853537,16,1.222253018,0.820767734,-0.938974047,144,80,64,0,-0.31912044,0,-0.624266962,-0.884216574,0.08608985,0.08608985,-0.624266962,0,1,0,1
997,5,38,31,80,78,0,6351.305,84,879.607,LESS,784,2550,3334,7,2,-2,-0.187481692,2,-1.222253018,0.048280455,0.663557508,158,80,78,0,-0.039890055,0,-0.07803337,1.027603045,0.629145332,0.629145332,-0.07803337,0,1,1,1
998,5,39,46,124,110,1,1710.409,84,1649.001,LESS,768,736,1504,1,2,-14,-1.312371845,14,0.87303787,0.048280455,-1.401748174,234,124,110,0,1.475932034,1.716734147,1.170500555,-1.840126383,0.606518021,0.606518021,1.170500555,1.716734147,1,0,1
999,5,40,58,92,110,0,5981.896,74,2039.069,LESS,388,3204,3592,6,2,18,1.687335229,18,1.571468165,-0.434524095,0.499161989,202,92,110,1,0.837691154,0.468200222,1.170500555,0.54964814,0.069119366,0.069119366,1.170500555,0.468200222,0,1,1
1000,5,41,49,110,131,1,2956.698,100,1062.088,MORE,738,1080,1818,3,2,21,1.968557767,21,2.095290887,0.820767734,-0.847120845,241,110,131,0,1.615547226,1.170500555,1.989850943,-0.884216574,0.564091811,0.564091811,1.989850943,1.170500555,1,0,1
1001,5,42,13,47,50,0,3701.877,100,1361.938,MORE,454,1828,2282,4,2,3,0.281222538,3,-1.047645444,0.820767734,-0.515499015,97,47,50,0,-1.256536731,-1.28755061,-1.170500555,-0.406261669,0.162457027,0.162457027,-1.170500555,-1.28755061,1,1,1
1002,5,43,16,50,44,0,3152.05,0,3701.378,MORE,-160,2544,2384,4,1,-6,-0.562445076,6,-0.523822722,-4.007277762,-0.760184703,94,50,44,1,-1.316371814,-1.170500555,-1.404600665,-0.406261669,-0.705866061,0.705866061,-1.404600665,-1.170500555,0,1,0
1003,5,44,7,57,50,0,3153.11,84,816.402,MORE,-152,1542,1390,4,2,-7,-0.656185922,7,-0.349215148,0.048280455,-0.759712978,107,57,50,1,-1.057086457,-0.897383758,-1.170500555,-0.406261669,-0.694552405,0.694552405,-1.170500555,-0.897383758,0,1,0
1004,5,45,18,42,50,1,2396.847,84,929.394,MORE,658,1072,1730,3,2,8,0.749926769,8,-0.174607574,0.048280455,-1.096267443,92,42,50,0,-1.356261869,-1.482634036,-1.170500555,-0.884216574,0.450955252,0.450955252,-1.170500555,-1.482634036,0,0,1
1005,5,46,51,108,110,0,4489.472,64,1426.064,MORE,-640,2286,1646,4,2,2,0.187481692,2,-1.222253018,-0.917328644,-0.165001088,218,108,110,0,1.156811594,1.092467184,1.170500555,-0.406261669,-1.384685414,1.384685414,1.170500555,1.092467184,0,1,0
1006,5,47,31,78,80,1,3855.439,84,2873.104,MORE,1186,1744,2930,3,2,2,0.187481692,2,-1.222253018,0.048280455,-0.447160386,158,78,80,0,-0.039890055,-0.07803337,0,-0.884216574,1.19765654,1.19765654,0,-0.07803337,0,0,1
1007,5,48,58,110,92,0,4038.037,100,1776.229,MORE,238,2000,2238,4,2,-18,-1.687335229,18,1.571468165,0.820767734,-0.365900068,202,110,92,1,0.837691154,1.170500555,0.468200222,-0.406261669,-0.143011681,0.143011681,0.468200222,1.170500555,1,0,0
1008,5,49,12,50,48,1,4217.473,74,1237.2,MORE,970,1776,2746,5,2,-2,-0.187481692,2,-1.222253018,-0.434524095,-0.286046912,98,50,48,1,-1.236591704,-1.170500555,-1.248533925,0.071693236,0.892187832,0.892187832,-1.248533925,-1.170500555,0,1,1
1009,5,50,54,110,101,0,3315.376,80,1091.207,MORE,422,1532,1954,3,2,-9,-0.843667615,9,0,-0.144841365,-0.687500868,211,110,101,1,1.017196402,1.170500555,0.819350388,-0.884216574,0.117202404,0.117202404,0.819350388,1.170500555,0,0,1
1010,5,51,14,46,50,0,3757.45,64,1166.957,MORE,320,1836,2156,3,2,4,0.374963384,4,-0.87303787,-0.917328644,-0.490767749,96,46,50,0,-1.276481759,-1.326567295,-1.170500555,-0.884216574,-0.027046709,0.027046709,-1.170500555,-1.326567295,0,0,0
1011,5,52,22,80,83,0,6773.183,84,1800.97,MORE,-70,3732,3662,6,2,3,0.281222538,3,-1.047645444,0.048280455,0.851302942,163,80,83,0,0.059835082,0,0.117050055,0.54964814,-0.578587433,0.578587433,0.117050055,0,0,1,0
1012,5,53,6,50,56,1,3177.464,94,1122.828,MORE,856,1306,2162,3,2,6,0.562445076,6,-0.523822722,0.531085005,-0.748874887,106,50,56,0,-1.077031484,-1.170500555,-0.936400444,-0.884216574,0.730968235,0.730968235,-0.936400444,-1.170500555,0,0,1
1013,5,54,13,50,47,0,3303.463,84,2254.048,MORE,750,1672,2422,4,2,-3,-0.281222538,3,-1.047645444,0.048280455,-0.692802428,97,50,47,1,-1.256536731,-1.170500555,-1.28755061,-0.406261669,0.581062295,0.581062295,-1.28755061,-1.170500555,0,1,1
1014,5,55,46,110,124,1,2960.213,94,1147.15,MORE,954,1292,2246,3,2,14,1.312371845,14,0.87303787,0.531085005,-0.845556589,234,110,124,0,1.475932034,1.170500555,1.716734147,-0.884216574,0.86956052,0.86956052,1.716734147,1.170500555,0,0,1
1015,5,56,27,91,80,0,15960.826,84,1694.728,MORE,-2190,6976,4786,10,2,-11,-1.031149307,11,0.349215148,0.048280455,4.940015832,171,91,80,1,0.219395302,0.429183537,0,2.461467759,-3.576706241,3.576706241,0,0.429183537,0,1,0
1016,5,57,40,64,80,1,4419.742,100,1070.099,MORE,1154,1788,2942,4,2,16,1.499853537,16,1.222253018,0.820767734,-0.196032545,144,64,80,0,-0.31912044,-0.624266962,0,-0.406261669,1.152401917,1.152401917,0,-0.624266962,1,1,1
1017,5,58,22,83,80,1,4347.116,84,2187.104,MORE,1000,1686,2686,5,2,-3,-0.281222538,3,-1.047645444,0.048280455,-0.228352789,163,83,80,1,0.059835082,0.117050055,0,0.071693236,0.934614041,0.934614041,0,0.117050055,0,1,1
1018,5,59,54,101,110,0,5359.591,64,1381.453,MORE,346,2510,2856,5,2,9,0.843667615,9,0,-0.917328644,0.222221921,211,101,110,0,1.017196402,0.819350388,1.170500555,0.071693236,0.009722673,0.009722673,1.170500555,0.819350388,0,1,0
1019,5,60,6,56,50,0,2847.962,84,1045.647,MORE,290,1480,1770,5,2,-6,-0.562445076,6,-0.523822722,0.048280455,-0.895510871,106,56,50,1,-1.077031484,-0.936400444,-1.170500555,0.071693236,-0.069472918,0.069472918,-1.170500555,-0.936400444,0,1,0
1020,5,61,18,50,42,0,3925.857,100,893.5,MORE,1018,1472,2490,4,2,-8,-0.749926769,8,-0.174607574,0.820767734,-0.415822753,92,50,42,1,-1.356261869,-1.170500555,-1.482634036,-0.406261669,0.960069767,0.960069767,-1.482634036,-1.170500555,1,0,1
1021,5,62,43,110,117,1,5172.947,80,957.907,MORE,1220,2052,3272,5,2,7,0.656185922,7,-0.349215148,-0.144841365,0.13916104,227,110,117,0,1.336316841,1.170500555,1.443617351,0.071693236,1.245739578,1.245739578,1.443617351,1.170500555,0,1,1
1022,5,63,32,77,80,1,5052.259,94,752.162,MORE,1146,2016,3162,5,2,3,0.281222538,3,-1.047645444,0.531085005,0.085452098,157,77,80,0,-0.059835082,-0.117050055,0,0.071693236,1.141088261,1.141088261,0,-0.117050055,0,1,1
1023,5,64,27,80,91,1,5466.552,100,1011.834,MORE,370,2724,3094,5,2,11,1.031149307,11,0.349215148,0.820767734,0.269822032,171,80,91,0,0.219395302,0,0.429183537,0.071693236,0.043663641,0.043663641,0.429183537,0,1,1,0
1024,5,65,16,44,50,1,3752.296,100,1101.102,MORE,204,2038,2242,3,2,6,0.562445076,6,-0.523822722,0.820767734,-0.493061398,94,44,50,0,-1.316371814,-1.404600665,-1.170500555,-0.884216574,-0.191094719,0.191094719,-1.170500555,-1.404600665,1,0,0
1025,5,66,7,50,57,1,2538.419,100,1870.621,MORE,1120,1020,2140,3,2,7,0.656185922,7,-0.349215148,0.820767734,-1.033264641,107,50,57,0,-1.057086457,-1.170500555,-0.897383758,-0.884216574,1.104318879,1.104318879,-0.897383758,-1.170500555,1,0,1
1026,5,67,14,50,46,1,3357.547,84,2118.042,MORE,1178,1518,2696,3,2,-4,-0.374963384,4,-0.87303787,0.048280455,-0.668733801,96,50,46,1,-1.276481759,-1.170500555,-1.326567295,-0.884216574,1.186342884,1.186342884,-1.326567295,-1.170500555,0,0,1
1027,5,68,51,110,108,1,5031.74,100,755.037,MORE,448,2200,2648,5,2,-2,-0.187481692,2,-1.222253018,0.820767734,0.07632067,218,110,108,1,1.156811594,1.170500555,1.092467184,0.071693236,0.153971785,0.153971785,1.092467184,1.170500555,1,1,1
1028,5,69,50,133,110,0,3503.936,100,872.44,MORE,-98,1846,1748,4,2,-23,-2.15603946,23,2.444506035,0.820767734,-0.603587322,243,133,110,1,1.655437281,2.067884313,1.170500555,-0.406261669,-0.618185228,0.618185228,1.170500555,2.067884313,1,1,0
1029,5,70,49,131,110,0,1993.824,100,612.242,MORE,-312,1226,914,2,2,-21,-1.968557767,21,2.095290887,0.820767734,-1.275621967,241,131,110,1,1.615547226,1.989850943,1.170500555,-1.362171478,-0.920825523,0.920825523,1.170500555,1.989850943,1,0,0
1030,5,71,47,126,110,0,2816.126,84,806.522,MORE,36,1516,1552,2,2,-16,-1.499853537,16,1.222253018,0.048280455,-0.909678625,236,126,110,1,1.515822089,1.794767517,1.170500555,-1.362171478,-0.428681492,0.428681492,1.170500555,1.794767517,0,0,0
1031,5,72,50,110,133,1,2861.582,94,1935.895,MORE,756,1364,2120,3,2,23,2.15603946,23,2.444506035,0.531085005,-0.889449657,243,110,133,0,1.655437281,1.170500555,2.067884313,-0.884216574,0.589547537,0.589547537,2.067884313,1.170500555,0,0,1
1032,5,73,47,110,126,1,2965.652,94,1520.478,MORE,1190,1184,2374,3,2,16,1.499853537,16,1.222253018,0.531085005,-0.843136109,236,110,126,0,1.515822089,1.170500555,1.794767517,-0.884216574,1.203313368,1.203313368,1.794767517,1.170500555,0,0,1
1033,5,74,12,48,50,1,4486.102,84,767.75,MORE,178,2064,2242,5,2,2,0.187481692,2,-1.222253018,0.048280455,-0.166500816,98,48,50,0,-1.236591704,-1.248533925,-1.170500555,0.071693236,-0.2278641,0.2278641,-1.170500555,-1.248533925,0,1,0
1034,5,75,32,80,77,1,2822.192,84,993.453,MORE,948,1074,2022,3,2,-3,-0.281222538,3,-1.047645444,0.048280455,-0.906979115,157,80,77,1,-0.059835082,0,-0.117050055,-0.884216574,0.861075278,0.861075278,-0.117050055,0,0,0,1
1035,5,76,43,117,110,1,8519.964,84,2118.826,MORE,2128,3174,5302,8,2,-7,-0.656185922,7,-0.349215148,0.048280455,1.628660746,227,117,110,1,1.336316841,1.443617351,1.170500555,1.50555795,2.52983952,2.52983952,1.170500555,1.443617351,0,1,1
1036,5,77,40,80,64,0,4165.882,84,1609.565,MORE,708,1660,2368,3,2,-16,-1.499853537,16,1.222253018,0.048280455,-0.309006096,144,80,64,1,-0.31912044,0,-0.624266962,-0.884216574,0.521665602,0.521665602,-0.624266962,0,0,0,1
1037,5,78,31,80,78,0,5106.462,100,688.987,MORE,470,2136,2606,6,2,-2,-0.187481692,2,-1.222253018,0.820767734,0.109573682,158,80,78,1,-0.039890055,0,-0.07803337,0.54964814,0.185084339,0.185084339,-0.07803337,0,1,1,1
1038,5,79,46,124,110,0,5412.254,64,1815.64,MORE,-62,2240,2178,6,2,-14,-1.312371845,14,0.87303787,-0.917328644,0.24565817,234,124,110,1,1.475932034,1.716734147,1.170500555,0.54964814,-0.567273777,0.567273777,1.170500555,1.716734147,0,1,0
1039,5,80,58,92,110,1,2672.471,94,644.867,MORE,564,1250,1814,3,2,18,1.687335229,18,1.571468165,0.531085005,-0.973608411,202,92,110,0,0.837691154,0.468200222,1.170500555,-0.884216574,0.318019796,0.318019796,1.170500555,0.468200222,0,0,1
1040,5,81,48,128,110,1,4242.301,54,1752.835,LESS,228,1650,1878,5,2,-18,-1.687335229,18,1.571468165,-1.400133194,-0.27499788,238,128,110,0,1.555712144,1.872800887,1.170500555,0.071693236,-0.157153751,0.157153751,1.170500555,1.872800887,0,1,0
1041,5,82,8,50,58,0,6513.653,44,1117.119,LESS,-1154,3510,2356,7,1,8,0.749926769,8,-0.174607574,-1.882937743,0.73580611,108,50,58,1,-1.037141429,-1.170500555,-0.858367073,1.027603045,-2.111587804,2.111587804,-0.858367073,-1.170500555,0,1,0
1042,5,83,4,54,50,1,4276.049,4,793.846,LESS,-144,2156,2012,5,1,-4,-0.374963384,4,-0.87303787,-3.814155942,-0.259979242,104,54,50,0,-1.116921539,-1.014433814,-1.170500555,0.071693236,-0.68323875,0.68323875,-1.170500555,-1.014433814,0,1,0
1043,5,84,37,80,69,1,4416.106,74,1345.495,LESS,256,1890,2146,5,2,-11,-1.031149307,11,0.349215148,-0.434524095,-0.197650649,149,80,69,0,-0.219395302,0,-0.429183537,0.071693236,-0.117555956,0.117555956,-0.429183537,0,0,1,0
1044,5,85,52,105,110,0,3549.203,74,782.841,LESS,-772,1948,1176,4,1,5,0.46870423,5,-0.698430296,-0.434524095,-0.583442464,215,105,110,1,1.096976512,0.975417129,1.170500555,-0.406261669,-1.571360736,1.571360736,1.170500555,0.975417129,0,0,0
1045,5,86,5,55,50,0,5117.803,64,1933.325,LESS,-898,2590,1692,6,2,-5,-0.46870423,5,-0.698430296,-0.917328644,0.114620689,105,55,50,0,-1.096976512,-0.975417129,-1.170500555,0.54964814,-1.749550816,1.749550816,-1.170500555,-0.975417129,0,1,0
1046,5,87,30,96,80,0,10385.769,54,935.635,LESS,-842,4708,3866,11,1,-16,-1.499853537,16,1.222253018,-1.400133194,2.458986974,176,96,80,0,0.31912044,0.624266962,0,2.939422664,-1.670355225,1.670355225,0,0.624266962,0,1,0
1047,5,88,33,80,75,1,5970.382,84,811.043,LESS,962,2378,3340,7,2,-5,-0.46870423,5,-0.698430296,0.048280455,0.494037994,155,80,75,0,-0.099725137,0,-0.195083426,1.027603045,0.880874176,0.880874176,-0.195083426,0,1,1,1
1048,5,89,48,110,128,0,4631.856,74,1730.658,LESS,562,2172,2734,6,2,18,1.687335229,18,1.571468165,-0.434524095,-0.101636926,238,110,128,1,1.555712144,1.170500555,1.872800887,0.54964814,0.315191382,0.315191382,1.872800887,1.170500555,0,1,1
1049,5,90,9,59,50,1,3194.466,100,691.635,LESS,234,1580,1814,3,2,-9,-0.843667615,9,0,0.820767734,-0.741308605,109,59,50,0,-1.017196402,-0.819350388,-1.170500555,-0.884216574,-0.148668509,0.148668509,-1.170500555,-0.819350388,1,0,0
1050,5,91,44,110,119,0,3151.831,100,690.841,LESS,-12,1634,1622,4,2,9,0.843667615,9,0,0.820767734,-0.760282163,229,110,119,1,1.376206896,1.170500555,1.521650721,-0.406261669,-0.496563428,0.496563428,1.521650721,1.170500555,1,0,0
1051,5,92,2,52,50,0,5548.877,74,949.569,LESS,346,2666,3012,6,2,-2,-0.187481692,2,-1.222253018,-0.434524095,0.306458554,102,52,50,0,-1.156811594,-1.092467184,-1.170500555,0.54964814,0.009722673,0.009722673,-1.170500555,-1.092467184,0,1,1
1052,5,93,8,58,50,0,5032.219,100,1705.268,LESS,312,2778,3090,6,2,-8,-0.749926769,8,-0.174607574,0.820767734,0.076533836,108,58,50,0,-1.037141429,-0.858367073,-1.170500555,0.54964814,-0.038360364,0.038360364,-1.170500555,-0.858367073,1,1,1
1053,5,94,44,119,110,0,11801.06,24,2039.73,LESS,-122,5256,5134,14,2,-9,-0.843667615,9,0,-2.848546843,3.088824089,229,119,110,0,1.376206896,1.521650721,1.170500555,4.373287378,-0.652126196,0.652126196,1.170500555,1.521650721,0,1,0
1054,5,95,34,74,80,0,2841.384,100,1401.617,LESS,586,1390,1976,4,2,6,0.562445076,6,-0.523822722,0.820767734,-0.898438233,154,74,80,1,-0.119670165,-0.234100111,0,-0.406261669,0.349132349,0.349132349,0,-0.234100111,1,0,1
1055,5,96,24,86,80,1,6339.867,64,1051.996,LESS,858,2554,3412,7,2,-6,-0.562445076,6,-0.523822722,-0.917328644,0.658467335,166,86,80,0,0.119670165,0.234100111,0,1.027603045,0.733796649,0.733796649,0,0.234100111,0,1,1
1056,5,97,39,66,80,0,3893.338,100,733.29,LESS,-298,2142,1844,4,2,14,1.312371845,14,0.87303787,0.820767734,-0.430294458,146,66,80,1,-0.279230385,-0.546233592,0,-0.406261669,-0.901026625,0.901026625,0,-0.546233592,1,0,0
1057,5,98,9,50,59,0,1974.536,100,1093.626,LESS,200,1266,1466,3,2,9,0.843667615,9,0,0.820767734,-1.284205572,109,50,59,1,-1.017196402,-1.170500555,-0.819350388,-0.884216574,-0.196751547,0.196751547,-0.819350388,-1.170500555,1,0,0
1058,5,99,57,94,110,0,1955.173,100,670.568,LESS,-230,1336,1106,3,2,16,1.499853537,16,1.222253018,0.820767734,-1.292822553,204,94,110,1,0.877581209,0.546233592,1.170500555,-0.884216574,-0.80486055,0.80486055,1.170500555,0.546233592,1,0,0
1059,5,100,60,110,87,1,4986.021,84,1420.438,LESS,1776,2024,3800,5,2,-23,-2.15603946,23,2.444506035,0.048280455,0.055974661,197,110,87,0,0.737966017,1.170500555,0.273116796,0.071693236,2.032038661,2.032038661,0.273116796,1.170500555,1,1,1
1060,5,101,33,75,80,1,11520.602,64,1659.206,LESS,824,5268,6092,11,2,5,0.46870423,5,-0.698430296,-0.917328644,2.964013815,155,75,80,1,-0.099725137,-0.195083426,0,2.939422664,0.685713612,0.685713612,0,-0.195083426,0,1,1
1061,5,102,15,50,45,1,4560.314,94,1782.764,LESS,994,1932,2926,5,2,-5,-0.46870423,5,-0.698430296,0.531085005,-0.133474765,95,50,45,0,-1.296426786,-1.170500555,-1.36558398,0.071693236,0.926128799,0.926128799,-1.36558398,-1.170500555,1,1,1
1062,5,103,59,89,110,0,3483.968,100,699.956,LESS,76,1696,1772,4,2,21,1.968557767,21,2.095290887,0.820767734,-0.612473543,199,89,110,1,0.777856072,0.351150166,1.170500555,-0.406261669,-0.372113213,0.372113213,1.170500555,0.351150166,1,0,0
1063,5,104,29,80,94,0,1815.661,100,699.583,LESS,66,1028,1094,3,2,14,1.312371845,14,0.87303787,0.820767734,-1.354908609,174,80,94,1,0.279230385,0,0.546233592,-0.884216574,-0.386255283,0.386255283,0.546233592,0,1,0,0
1064,5,105,55,110,98,1,2644.911,84,745.889,LESS,814,1228,2042,3,2,-12,-1.124890153,12,0.523822722,0.048280455,-0.985873246,208,110,98,0,0.957361319,1.170500555,0.702300333,-0.884216574,0.671571542,0.671571542,0.702300333,1.170500555,1,0,1
1065,5,106,29,94,80,1,5958.765,0,1675.749,LESS,-1418,3686,2268,6,1,-14,-1.312371845,14,0.87303787,-4.007277762,0.488868161,174,94,80,0,0.279230385,0.546233592,0,0.54964814,-2.484938448,2.484938448,0,0.546233592,0,1,0
1066,5,107,57,110,94,0,3971.287,100,622.38,LESS,-252,2134,1882,5,2,-16,-1.499853537,16,1.222253018,0.820767734,-0.395605356,204,110,94,0,0.877581209,1.170500555,0.546233592,0.071693236,-0.835973104,0.835973104,0.546233592,1.170500555,1,0,0
1067,5,108,39,80,66,0,4262.166,84,995.469,LESS,436,2092,2528,7,2,-14,-1.312371845,14,0.87303787,0.048280455,-0.266157497,146,80,66,0,-0.279230385,0,-0.546233592,1.027603045,0.137001302,0.137001302,-0.546233592,0,1,1,1
1068,5,109,4,50,54,1,4680.479,100,1253.783,LESS,1758,1606,3364,5,2,4,0.374963384,4,-0.87303787,0.820767734,-0.079998571,104,50,54,1,-1.116921539,-1.170500555,-1.014433814,0.071693236,2.006582936,2.006582936,-1.014433814,-1.170500555,1,0,1
1069,5,110,55,98,110,1,2555.67,100,811.945,LESS,630,1244,1874,3,2,12,1.124890153,12,0.523822722,0.820767734,-1.025587548,208,98,110,1,0.957361319,0.702300333,1.170500555,-0.884216574,0.411357457,0.411357457,1.170500555,0.702300333,1,0,1
1070,5,111,2,50,52,1,4514.502,100,2371.508,LESS,1316,2086,3402,5,2,2,0.187481692,2,-1.222253018,0.820767734,-0.153862161,102,50,52,1,-1.156811594,-1.170500555,-1.092467184,0.071693236,1.381503448,1.381503448,-1.092467184,-1.170500555,1,1,1
1071,5,112,59,110,89,0,4200.33,84,1166.305,LESS,410,1934,2344,4,2,-21,-1.968557767,21,2.095290887,0.048280455,-0.293675942,199,110,89,0,0.777856072,1.170500555,0.351150166,-0.406261669,0.10023192,0.10023192,0.351150166,1.170500555,0,0,1
1072,5,113,60,87,110,1,3215.42,100,2420.137,LESS,1612,1306,2918,3,2,23,2.15603946,23,2.444506035,0.820767734,-0.731983592,197,87,110,1,0.737966017,0.273116796,1.170500555,-0.884216574,1.800108716,1.800108716,1.170500555,0.273116796,1,0,1
1073,5,114,52,110,105,0,5822.605,94,964.014,LESS,-368,2906,2538,6,2,-5,-0.46870423,5,-0.698430296,0.531085005,0.428273823,215,110,105,0,1.096976512,1.170500555,0.975417129,0.54964814,-1.000021114,1.000021114,0.975417129,1.170500555,1,1,0
1074,5,115,30,80,96,1,7330.548,100,699.569,LESS,578,3098,3676,6,2,16,1.499853537,16,1.222253018,0.820767734,1.099343213,176,80,96,1,0.31912044,0,0.624266962,0.54964814,0.337818694,0.337818694,0.624266962,0,1,1,1
1075,5,116,24,80,86,1,4100.559,100,684.273,LESS,690,1792,2482,3,2,6,0.562445076,6,-0.523822722,0.820767734,-0.338076337,166,80,86,1,0.119670165,0,0.234100111,-0.884216574,0.496209876,0.496209876,0.234100111,0,1,0,1
1076,5,117,5,50,55,1,4450.724,100,1028.633,LESS,784,1912,2696,5,2,5,0.46870423,5,-0.698430296,0.820767734,-0.182244841,105,50,55,1,-1.096976512,-1.170500555,-0.975417129,0.071693236,0.629145332,0.629145332,-0.975417129,-1.170500555,1,0,1
1077,5,118,34,80,74,1,7381.719,74,1592.385,LESS,1368,3116,4484,7,2,-6,-0.562445076,6,-0.523822722,-0.434524095,1.122115487,154,80,74,0,-0.119670165,0,-0.234100111,1.027603045,1.455042212,1.455042212,-0.234100111,0,0,1,1
1078,5,119,15,45,50,1,4154.848,100,591.653,LESS,366,1916,2282,5,2,5,0.46870423,5,-0.698430296,0.820767734,-0.31391648,95,45,50,1,-1.296426786,-1.36558398,-1.170500555,0.071693236,0.038006813,0.038006813,-1.170500555,-1.36558398,1,0,1
1079,5,120,37,69,80,1,7643.315,100,1766.94,LESS,-552,4306,3754,5,2,11,1.031149307,11,0.349215148,0.820767734,1.238531736,149,69,80,1,-0.219395302,-0.429183537,0,0.071693236,-1.260235199,1.260235199,0,-0.429183537,1,0,0
1080,5,121,48,128,110,0,2240.432,100,1203.945,MORE,332,1300,1632,3,2,-18,-1.687335229,18,1.571468165,0.820767734,-1.165875723,238,128,110,1,1.555712144,1.872800887,1.170500555,-0.884216574,-0.010076225,0.010076225,1.170500555,1.872800887,1,0,0
1081,5,122,8,50,58,1,2874.839,100,1296.077,MORE,890,1286,2176,3,2,8,0.749926769,8,-0.174607574,0.820767734,-0.883549987,108,50,58,0,-1.037141429,-1.170500555,-0.858367073,-0.884216574,0.779051273,0.779051273,-0.858367073,-1.170500555,1,0,1
1082,5,123,4,54,50,0,3298.259,100,1887.346,MORE,206,1886,2092,4,2,-4,-0.374963384,4,-0.87303787,0.820767734,-0.695118328,104,54,50,1,-1.116921539,-1.014433814,-1.170500555,-0.406261669,-0.188266305,0.188266305,-1.170500555,-1.014433814,1,0,0
1083,5,124,37,80,69,0,3386.571,64,1871.556,MORE,-646,1902,1256,4,2,-11,-1.031149307,11,0.349215148,-0.917328644,-0.655817452,149,80,69,1,-0.219395302,0,-0.429183537,-0.406261669,-1.393170656,1.393170656,-0.429183537,0,0,1,0
1084,5,125,52,105,110,1,5788.203,100,1439.221,MORE,976,2398,3374,7,2,5,0.46870423,5,-0.698430296,0.820767734,0.41296414,215,105,110,0,1.096976512,0.975417129,1.170500555,1.027603045,0.900673073,0.900673073,1.170500555,0.975417129,1,1,1
1085,5,126,5,55,50,0,3221.33,100,2063.893,MORE,402,1774,2176,4,2,-5,-0.46870423,5,-0.698430296,0.820767734,-0.729353506,105,55,50,1,-1.096976512,-0.975417129,-1.170500555,-0.406261669,0.088918264,0.088918264,-1.170500555,-0.975417129,1,1,1
1086,5,127,30,96,80,0,4298.562,84,1400.015,MORE,70,2178,2248,4,2,-16,-1.499853537,16,1.222253018,0.048280455,-0.249960438,176,96,80,1,0.31912044,0.624266962,0,-0.406261669,-0.380598455,0.380598455,0,0.624266962,0,1,0
1087,5,128,33,80,75,0,5391.25,100,582.917,MORE,-184,2606,2422,6,2,-5,-0.46870423,5,-0.698430296,0.820767734,0.236310906,155,80,75,1,-0.099725137,0,-0.195083426,0.54964814,-0.739807029,0.739807029,-0.195083426,0,1,1,0
1088,5,129,48,110,128,1,4248.572,100,1514.937,MORE,1148,1888,3036,3,2,18,1.687335229,18,1.571468165,0.820767734,-0.27220714,238,110,128,0,1.555712144,1.170500555,1.872800887,-0.884216574,1.143916675,1.143916675,1.872800887,1.170500555,1,0,1
1089,5,130,9,59,50,1,3983.248,100,673.297,MORE,284,1760,2044,4,2,-9,-0.843667615,9,0,0.820767734,-0.390282435,109,59,50,1,-1.017196402,-0.819350388,-1.170500555,-0.406261669,-0.07795816,0.07795816,-1.170500555,-0.819350388,1,0,0
1090,5,131,44,110,119,1,4782.524,74,1025.449,MORE,342,2296,2638,5,2,9,0.843667615,9,0,-0.434524095,-0.034586194,229,110,119,0,1.376206896,1.170500555,1.521650721,0.071693236,0.004065845,0.004065845,1.521650721,1.170500555,0,1,0
1091,5,132,2,52,50,1,2972.602,100,1355.791,MORE,940,1272,2212,3,2,-2,-0.187481692,2,-1.222253018,0.820767734,-0.840043199,102,52,50,1,-1.156811594,-1.092467184,-1.170500555,-0.884216574,0.849761622,0.849761622,-1.170500555,-1.092467184,1,0,1
1092,5,133,8,58,50,0,2512.02,100,1939.118,MORE,-62,1520,1458,2,2,-8,-0.749926769,8,-0.174607574,0.820767734,-1.045012804,108,58,50,1,-1.037141429,-0.858367073,-1.170500555,-1.362171478,-0.567273777,0.567273777,-1.170500555,-0.858367073,1,0,0
1093,5,134,44,119,110,0,5967.203,84,1419.199,MORE,1236,2652,3888,6,2,-9,-0.843667615,9,0,0.048280455,0.492623266,229,119,110,1,1.376206896,1.521650721,1.170500555,0.54964814,1.26836689,1.26836689,1.170500555,1.521650721,0,1,1
1094,5,135,34,74,80,1,2562.18,100,1692.536,MORE,1006,1090,2096,3,2,6,0.562445076,6,-0.523822722,0.820767734,-1.022690448,154,74,80,0,-0.119670165,-0.234100111,0,-0.884216574,0.943099283,0.943099283,0,-0.234100111,1,0,1
1095,5,136,24,86,80,0,4803.215,74,2414.092,MORE,632,2120,2752,5,2,-6,-0.562445076,6,-0.523822722,-0.434524095,-0.025378222,166,86,80,1,0.119670165,0.234100111,0,0.071693236,0.414185871,0.414185871,0,0.234100111,0,1,1
1096,5,137,39,66,80,1,2434.068,100,2024.193,MORE,1224,974,2198,3,2,14,1.312371845,14,0.87303787,0.820767734,-1.079703241,146,66,80,0,-0.279230385,-0.546233592,0,-0.884216574,1.251396406,1.251396406,0,-0.546233592,1,0,1
1097,5,138,9,50,59,1,2408.256,100,1739.869,MORE,592,1156,1748,3,2,9,0.843667615,9,0,0.820767734,-1.091190175,109,50,59,0,-1.017196402,-1.170500555,-0.819350388,-0.884216574,0.357617591,0.357617591,-0.819350388,-1.170500555,1,0,1
1098,5,139,57,94,110,1,2687.139,100,954.733,MORE,538,1256,1794,3,2,16,1.499853537,16,1.222253018,0.820767734,-0.967080813,204,94,110,0,0.877581209,0.546233592,1.170500555,-0.884216574,0.281250414,0.281250414,1.170500555,0.546233592,1,0,1
1099,5,140,60,110,87,0,2855.139,100,825.354,MORE,-644,1994,1350,3,2,-23,-2.15603946,23,2.444506035,0.820767734,-0.892316941,197,110,87,1,0.737966017,1.170500555,0.273116796,-0.884216574,-1.390342242,1.390342242,0.273116796,1.170500555,1,0,0
1100,5,141,33,75,80,1,4525.586,100,1437.257,MORE,1044,2036,3080,5,2,5,0.46870423,5,-0.698430296,0.820767734,-0.148929526,155,75,80,0,-0.099725137,-0.195083426,0,0.071693236,0.996839148,0.996839148,0,-0.195083426,1,1,1
1101,5,142,15,50,45,0,2420.489,100,929.26,MORE,-366,1604,1238,2,2,-5,-0.46870423,5,-0.698430296,0.820767734,-1.085746209,95,50,45,1,-1.296426786,-1.170500555,-1.36558398,-1.362171478,-0.9971927,0.9971927,-1.36558398,-1.170500555,1,0,0
1102,5,143,59,89,110,1,4451.694,100,785.973,MORE,8,2324,2332,5,2,21,1.968557767,21,2.095290887,0.820767734,-0.181813169,199,89,110,0,0.777856072,0.351150166,1.170500555,0.071693236,-0.468279288,0.468279288,1.170500555,0.351150166,1,1,0
1103,5,144,29,80,94,1,4451.385,100,1472.457,MORE,756,2042,2798,5,2,14,1.312371845,14,0.87303787,0.820767734,-0.181950681,174,80,94,0,0.279230385,0,0.546233592,0.071693236,0.589547537,0.589547537,0.546233592,0,1,1,1
1104,5,145,55,110,98,1,10142.36,74,1286.581,MORE,1654,4094,5748,9,2,-12,-1.124890153,12,0.523822722,-0.434524095,2.350664359,208,110,98,1,0.957361319,1.170500555,0.702300333,1.983512854,1.859505409,1.859505409,0.702300333,1.170500555,0,1,1
1105,5,146,29,94,80,0,1995.119,100,713.649,MORE,-234,1348,1114,3,2,-14,-1.312371845,14,0.87303787,0.820767734,-1.275045662,174,94,80,1,0.279230385,0.546233592,0,-0.884216574,-0.810517378,0.810517378,0,0.546233592,1,0,0
1106,5,147,57,110,94,0,7315.841,84,1396.739,MORE,-536,4004,3468,6,2,-16,-1.499853537,16,1.222253018,0.048280455,1.092798259,204,110,94,1,0.877581209,1.170500555,0.546233592,0.54964814,-1.237607888,1.237607888,0.546233592,1.170500555,0,1,0
1107,5,148,39,80,66,1,7825.448,74,1310.081,MORE,1312,3202,4514,7,2,-14,-1.312371845,14,0.87303787,-0.434524095,1.319585119,146,80,66,1,-0.279230385,0,-0.546233592,1.027603045,1.37584662,1.37584662,-0.546233592,0,0,1,1
1108,5,149,4,50,54,0,5077.025,94,2046.099,MORE,1380,2172,3552,5,2,4,0.374963384,4,-0.87303787,0.531085005,0.096473539,104,50,54,0,-1.116921539,-1.170500555,-1.014433814,0.071693236,1.472012695,1.472012695,-1.014433814,-1.170500555,0,1,1
1109,5,150,55,98,110,0,7236.551,64,1679.38,MORE,-1080,3686,2606,8,1,12,1.124890153,12,0.523822722,-0.917328644,1.057512381,208,98,110,0,0.957361319,0.702300333,1.170500555,1.50555795,-2.006936487,2.006936487,1.170500555,0.702300333,0,1,0
1110,5,151,2,50,52,1,4429.96,100,693.557,MORE,796,1650,2446,4,2,2,0.187481692,2,-1.222253018,0.820767734,-0.1914853,102,50,52,0,-1.156811594,-1.170500555,-1.092467184,-0.406261669,0.646115816,0.646115816,-1.092467184,-1.170500555,1,0,1
1111,5,152,59,110,89,0,3060.255,100,1065.114,MORE,10,1760,1770,4,2,-21,-1.968557767,21,2.095290887,0.820767734,-0.801035593,199,110,89,1,0.777856072,1.170500555,0.351150166,-0.406261669,-0.465450874,0.465450874,0.351150166,1.170500555,1,0,0
1112,5,153,60,87,110,1,4307.453,100,1658.557,MORE,1740,1632,3372,3,2,23,2.15603946,23,2.444506035,0.820767734,-0.246003738,197,87,110,0,0.737966017,0.273116796,1.170500555,-0.884216574,1.98112721,1.98112721,1.170500555,0.273116796,1,0,1
1113,5,154,52,110,105,0,6352.37,74,965.853,MORE,-1482,3780,2298,5,2,-5,-0.46870423,5,-0.698430296,-0.434524095,0.664031458,215,110,105,1,1.096976512,1.170500555,0.975417129,0.071693236,-2.575447695,2.575447695,0.975417129,1.170500555,0,1,0
1114,5,155,30,80,96,1,3454.677,100,758.714,MORE,1194,1364,2558,3,2,16,1.499853537,16,1.222253018,0.820767734,-0.625508713,176,80,96,0,0.31912044,0,0.624266962,-0.884216574,1.208970196,1.208970196,0.624266962,0,1,0,1
1115,5,156,24,80,86,1,7417.97,64,1686.31,MORE,102,3398,3500,7,2,6,0.562445076,6,-0.523822722,-0.917328644,1.138248018,166,80,86,0,0.119670165,0,0.234100111,1.027603045,-0.335343831,0.335343831,0.234100111,0,0,1,0
1116,5,157,5,50,55,1,2525.835,100,745.189,MORE,764,1024,1788,3,2,5,0.46870423,5,-0.698430296,0.820767734,-1.038864811,105,50,55,0,-1.096976512,-1.170500555,-0.975417129,-0.884216574,0.600861193,0.600861193,-0.975417129,-1.170500555,1,0,1
1117,5,158,34,80,74,0,3980.034,84,1797.92,MORE,-440,2276,1836,4,2,-6,-0.562445076,6,-0.523822722,0.048280455,-0.391712739,154,80,74,1,-0.119670165,0,-0.234100111,-0.406261669,-1.101844017,1.101844017,-0.234100111,0,0,0,0
1118,5,159,15,45,50,1,7475.688,44,1661.606,MORE,160,3078,3238,7,2,5,0.46870423,5,-0.698430296,-1.882937743,1.163933858,95,45,50,0,-1.296426786,-1.36558398,-1.170500555,1.027603045,-0.253319826,0.253319826,-1.170500555,-1.36558398,0,1,0
1119,5,160,37,69,80,1,3418.941,84,1574.044,MORE,962,1566,2528,3,2,11,1.031149307,11,0.349215148,0.048280455,-0.641412056,149,69,80,0,-0.219395302,-0.429183537,0,-0.884216574,0.880874176,0.880874176,0,-0.429183537,0,0,1
1120,5,161,3,50,53,0,4333.5,84,1142.034,LESS,-144,2110,1966,4,2,3,0.281222538,3,-1.047645444,0.048280455,-0.234412223,103,50,53,1,-1.136866566,-1.170500555,-1.053450499,-0.406261669,-0.68323875,0.68323875,-1.053450499,-1.170500555,0,0,0
1121,5,162,20,50,40,0,7113.265,44,1002.993,LESS,-634,3192,2558,8,1,-10,-0.937408461,10,0.174607574,-1.882937743,1.00264727,90,50,40,0,-1.396151924,-1.170500555,-1.560667406,1.50555795,-1.376200172,1.376200172,-1.560667406,-1.170500555,0,1,0
1122,5,163,25,80,88,0,2821.799,100,2071.688,LESS,38,1522,1560,4,2,8,0.749926769,8,-0.174607574,0.820767734,-0.907154009,168,80,88,1,0.15956022,0,0.312133481,-0.406261669,-0.425853078,0.425853078,0.312133481,0,1,0,0
1123,5,164,42,115,110,0,6692.084,54,1552.03,LESS,-328,3206,2878,8,2,-5,-0.46870423,5,-0.698430296,-1.400133194,0.815212018,225,115,110,0,1.296426786,1.36558398,1.170500555,1.50555795,-0.943452835,0.943452835,1.170500555,1.36558398,0,1,0
1124,5,165,53,103,110,1,5363.299,64,1453.355,LESS,460,2410,2870,5,2,7,0.656185922,7,-0.349215148,-0.917328644,0.223872067,213,103,110,1,1.057086457,0.897383758,1.170500555,0.071693236,0.170942269,0.170942269,1.170500555,0.897383758,0,0,1
1125,5,166,26,90,80,1,7395.46,34,1025.451,LESS,-8,3120,3112,6,2,-10,-0.937408461,10,0.174607574,-2.365742293,1.128230549,170,90,80,0,0.199450275,0.390166852,0,0.54964814,-0.4909066,0.4909066,0,0.390166852,0,1,0
1126,5,167,35,80,72,0,7097.294,84,700.959,LESS,-424,3458,3034,8,2,-8,-0.749926769,8,-0.174607574,0.048280455,0.995539807,152,80,72,0,-0.15956022,0,-0.312133481,1.50555795,-1.079216705,1.079216705,-0.312133481,0,0,1,0
1127,5,168,28,93,80,1,4372.559,84,1090.035,LESS,356,1802,2158,5,2,-13,-1.218630999,13,0.698430296,0.048280455,-0.217030068,173,93,80,0,0.259285357,0.507216907,0,0.071693236,0.023864743,0.023864743,0,0.507216907,0,0,1
1128,5,169,26,80,90,0,5583.157,100,709.492,LESS,-422,2976,2554,7,2,10,0.937408461,10,0.174607574,0.820767734,0.321713944,170,80,90,1,0.199450275,0,0.390166852,1.027603045,-1.076388291,1.076388291,0.390166852,0,1,1,0
1129,5,170,25,88,80,1,4584.432,84,922.806,LESS,1152,1746,2898,5,2,-8,-0.749926769,8,-0.174607574,0.048280455,-0.122741699,168,88,80,0,0.15956022,0.312133481,0,0.071693236,1.149573503,1.149573503,0,0.312133481,1,0,1
1130,5,171,36,80,70,0,5412.878,64,1726.767,LESS,-832,2848,2016,6,1,-10,-0.937408461,10,0.174607574,-0.917328644,0.245935865,150,80,70,0,-0.199450275,0,-0.390166852,0.54964814,-1.656213155,1.656213155,-0.390166852,0,0,1,0
1131,5,172,28,80,93,0,2244.948,100,908.756,LESS,-138,1434,1296,3,2,13,1.218630999,13,0.698430296,0.820767734,-1.163865999,173,80,93,1,0.259285357,0,0.507216907,-0.884216574,-0.674753508,0.674753508,0.507216907,0,1,0,0
1132,5,173,21,82,80,1,5185.66,64,1226.923,LESS,440,2376,2816,5,2,-2,-0.187481692,2,-1.222253018,-0.917328644,0.144818618,162,82,80,0,0.039890055,0.07803337,0,0.071693236,0.14265813,0.14265813,0,0.07803337,0,0,1
1133,5,174,19,50,41,1,2717.711,84,1141.777,LESS,474,1060,1534,3,2,-9,-0.843667615,9,0,0.048280455,-0.953475568,91,50,41,0,-1.376206896,-1.170500555,-1.521650721,-0.884216574,0.190741167,0.190741167,-1.521650721,-1.170500555,0,0,1
1134,5,175,56,96,110,0,7714.071,64,1190.64,LESS,-646,3710,3064,7,1,14,1.312371845,14,0.87303787,-0.917328644,1.270019787,206,96,110,1,0.917471264,0.624266962,1.170500555,1.027603045,-1.393170656,1.393170656,1.170500555,0.624266962,0,1,0
1135,5,176,23,80,85,0,8222.693,84,991.797,LESS,310,3700,4010,8,2,5,0.46870423,5,-0.698430296,0.048280455,1.4963683,165,80,85,1,0.099725137,0,0.195083426,1.50555795,-0.041188778,0.041188778,0.195083426,0,0,1,1
1136,5,177,10,60,50,0,7420.131,94,1541.199,LESS,100,3388,3488,7,2,-10,-0.937408461,10,0.174607574,0.531085005,1.139209713,110,60,50,0,-0.997251374,-0.780333703,-1.170500555,1.027603045,-0.338172245,0.338172245,-1.170500555,-0.780333703,1,1,0
1137,5,178,19,41,50,0,10990.016,64,1108.161,LESS,-70,4986,4916,12,2,9,0.843667615,9,0,-0.917328644,2.727890816,91,41,50,1,-1.376206896,-1.521650721,-1.170500555,3.417377569,-0.578587433,0.578587433,-1.170500555,-1.521650721,0,1,0
1138,5,179,56,110,96,1,4468.544,84,1174.832,LESS,604,1958,2562,5,2,-14,-1.312371845,14,0.87303787,0.048280455,-0.17431453,206,110,96,0,0.917471264,1.170500555,0.624266962,0.071693236,0.374588075,0.374588075,0.624266962,1.170500555,0,0,1
1139,5,180,35,72,80,1,2355.682,94,540.728,LESS,310,1246,1556,3,2,8,0.749926769,8,-0.174607574,0.531085005,-1.114586817,152,72,80,1,-0.15956022,-0.312133481,0,-0.884216574,-0.041188778,0.041188778,0,-0.312133481,1,0,1
1140,5,181,11,49,50,1,4612.005,84,1393.404,LESS,1346,1926,3272,5,2,1,0.093740846,1,-1.396860592,0.048280455,-0.110471079,99,49,50,1,-1.216646676,-1.20951724,-1.170500555,0.071693236,1.423929658,1.423929658,-1.170500555,-1.20951724,1,0,1
1141,5,182,17,43,50,0,9865.907,94,759.983,LESS,284,4196,4480,9,2,7,0.656185922,7,-0.349215148,0.531085005,2.227636402,93,43,50,1,-1.336316841,-1.443617351,-1.170500555,1.983512854,-0.07795816,0.07795816,-1.170500555,-1.443617351,1,1,0
1142,5,183,1,51,50,1,3959.668,94,1024.46,LESS,718,1804,2522,5,2,-1,-0.093740846,1,-1.396860592,0.531085005,-0.400776079,101,51,50,0,-1.176756621,-1.131483869,-1.170500555,0.071693236,0.535807671,0.535807671,-1.170500555,-1.131483869,1,0,1
1143,5,184,41,112,110,1,11031.357,94,622.631,LESS,834,4482,5316,9,2,-2,-0.187481692,2,-1.222253018,0.531085005,2.746288514,222,112,110,0,1.236591704,1.248533925,1.170500555,1.983512854,0.699855682,0.699855682,1.170500555,1.248533925,1,1,1
1144,5,185,20,40,50,0,2095.772,100,726.614,LESS,-196,1394,1198,3,2,10,0.937408461,10,0.174607574,0.820767734,-1.230252758,90,40,50,1,-1.396151924,-1.560667406,-1.170500555,-0.884216574,-0.756777513,0.756777513,-1.170500555,-1.560667406,1,0,0
1145,5,186,1,50,51,0,3203.825,100,1398.917,LESS,396,1580,1976,4,2,1,0.093740846,1,-1.396860592,0.820767734,-0.737143634,101,50,51,1,-1.176756621,-1.170500555,-1.131483869,-0.406261669,0.080433022,0.080433022,-1.131483869,-1.170500555,1,0,1
1146,5,187,23,85,80,1,4205.344,34,1315.713,LESS,-60,1852,1792,5,2,-5,-0.46870423,5,-0.698430296,-2.365742293,-0.291444596,165,85,80,0,0.099725137,0.195083426,0,0.071693236,-0.564445363,0.564445363,0,0.195083426,0,0,0
1147,5,188,11,50,49,0,5260.121,84,1270.134,LESS,374,2568,2942,7,2,-1,-0.093740846,1,-1.396860592,0.048280455,0.177955479,99,50,49,0,-1.216646676,-1.170500555,-1.20951724,1.027603045,0.049320469,0.049320469,-1.20951724,-1.170500555,1,1,1
1148,5,189,17,50,43,0,3668.326,94,597.773,LESS,-178,1774,1596,4,2,-7,-0.656185922,7,-0.349215148,0.531085005,-0.530429984,93,50,43,0,-1.336316841,-1.170500555,-1.443617351,-0.406261669,-0.731321787,0.731321787,-1.443617351,-1.170500555,1,0,0
1149,5,190,21,80,82,1,5770.312,44,1396.63,LESS,-662,2816,2154,5,2,2,0.187481692,2,-1.222253018,-1.882937743,0.405002233,162,80,82,1,0.039890055,0,0.07803337,0.071693236,-1.415797968,1.415797968,0.07803337,0,0,0,0
1150,5,191,10,50,60,0,3339.557,100,2259.945,LESS,172,1898,2070,4,2,10,0.937408461,10,0.174607574,0.820767734,-0.676739766,110,50,60,1,-0.997251374,-1.170500555,-0.780333703,-0.406261669,-0.236349342,0.236349342,-0.780333703,-1.170500555,1,0,0
1151,5,192,3,53,50,1,13106.934,14,1814.85,LESS,-990,6282,5292,14,1,-3,-0.281222538,3,-1.047645444,-3.331351392,3.669968116,103,53,50,0,-1.136866566,-1.053450499,-1.170500555,4.373287378,-1.879657859,1.879657859,-1.170500555,-1.053450499,0,1,0
1152,5,193,45,122,110,1,2748.249,100,1735.95,LESS,1460,1150,2610,3,2,-12,-1.124890153,12,0.523822722,0.820767734,-0.939885454,232,122,110,0,1.436041979,1.638700776,1.170500555,-0.884216574,1.585149254,1.585149254,1.170500555,1.638700776,1,0,1
1153,5,194,38,67,80,1,2600.832,64,710.256,LESS,540,1166,1706,3,2,13,1.218630999,13,0.698430296,-0.917328644,-1.005489417,147,67,80,1,-0.259285357,-0.507216907,0,-0.884216574,0.284078828,0.284078828,0,-0.507216907,0,0,1
1154,5,195,38,80,67,0,7194.944,44,1442.306,LESS,-646,3504,2858,8,2,-13,-1.218630999,13,0.698430296,-1.882937743,1.038996307,147,80,67,0,-0.259285357,0,-0.507216907,1.50555795,-1.393170656,1.393170656,-0.507216907,0,0,1,0
1155,5,196,36,70,80,0,6219.534,34,742.958,LESS,14,2640,2654,7,1,10,0.937408461,10,0.174607574,-2.365742293,0.604916376,150,70,80,1,-0.199450275,-0.390166852,0,1.027603045,-0.459794046,0.459794046,0,-0.390166852,0,1,0
1156,5,197,45,110,122,0,6192.639,74,1745.134,LESS,18,3112,3130,6,2,12,1.124890153,12,0.523822722,-0.434524095,0.592947481,232,110,122,1,1.436041979,1.170500555,1.638700776,0.54964814,-0.454137218,0.454137218,1.638700776,1.170500555,0,1,0
1157,5,198,42,110,115,1,4581.567,64,1151.857,LESS,508,1790,2298,4,2,5,0.46870423,5,-0.698430296,-0.917328644,-0.12401669,225,110,115,1,1.296426786,1.170500555,1.36558398,-0.406261669,0.238824205,0.238824205,1.36558398,1.170500555,0,0,1
1158,5,199,41,110,112,0,3802.61,74,1959.12,LESS,296,1840,2136,4,2,2,0.187481692,2,-1.222253018,-0.434524095,-0.470670509,222,110,112,1,1.236591704,1.170500555,1.248533925,-0.406261669,-0.060987676,0.060987676,1.248533925,1.170500555,0,0,0
1159,5,200,53,110,103,1,5948.082,0,1805.659,LESS,714,3080,3794,5,2,-7,-0.656185922,7,-0.349215148,-4.007277762,0.48411398,213,110,103,0,1.057086457,1.170500555,0.897383758,0.071693236,0.530150843,0.530150843,0.897383758,1.170500555,0,1,1
1160,5,201,3,50,53,1,10750.35,74,1101.378,MORE,1812,4002,5814,12,2,3,0.281222538,3,-1.047645444,-0.434524095,2.621233922,103,50,53,0,-1.136866566,-1.170500555,-1.053450499,3.417377569,2.082950113,2.082950113,-1.053450499,-1.170500555,0,1,1
1161,5,202,20,50,40,0,1967.113,100,1793.263,MORE,532,1062,1594,3,2,-10,-0.937408461,10,0.174607574,0.820767734,-1.287508978,90,50,40,1,-1.396151924,-1.170500555,-1.560667406,-0.884216574,0.272765172,0.272765172,-1.560667406,-1.170500555,1,0,1
1162,5,203,25,80,88,1,4202.552,74,2475.376,MORE,1570,1828,3398,5,2,8,0.749926769,8,-0.174607574,-0.434524095,-0.292687101,168,80,88,0,0.15956022,0,0.312133481,0.071693236,1.740712022,1.740712022,0.312133481,0,0,1,1
1163,5,204,42,115,110,1,5729.013,74,743.13,MORE,628,2392,3020,7,2,-5,-0.46870423,5,-0.698430296,-0.434524095,0.386623226,225,115,110,1,1.296426786,1.36558398,1.170500555,1.027603045,0.408529043,0.408529043,1.170500555,1.36558398,0,1,1
1164,5,205,53,103,110,1,6468.345,74,1613.658,MORE,426,3018,3444,7,2,7,0.656185922,7,-0.349215148,-0.434524095,0.715643006,213,103,110,0,1.057086457,0.897383758,1.170500555,1.027603045,0.122859232,0.122859232,1.170500555,0.897383758,0,1,1
1165,5,206,26,90,80,0,3401.716,94,1279.867,MORE,160,1808,1968,4,2,-10,-0.937408461,10,0.174607574,0.531085005,-0.649077578,170,90,80,1,0.199450275,0.390166852,0,-0.406261669,-0.253319826,0.253319826,0,0.390166852,0,1,0
1166,5,207,35,80,72,0,5120.399,100,1639.793,MORE,402,2494,2896,6,2,-8,-0.749926769,8,-0.174607574,0.820767734,0.115775969,152,80,72,1,-0.15956022,0,-0.312133481,0.54964814,0.088918264,0.088918264,-0.312133481,0,1,1,0
1167,5,208,28,93,80,0,3429.894,100,1167.644,MORE,332,1862,2194,4,2,-13,-1.218630999,13,0.698430296,0.820767734,-0.636537719,173,93,80,1,0.259285357,0.507216907,0,-0.406261669,-0.010076225,0.010076225,0,0.507216907,1,1,0
1168,5,209,26,80,90,1,2685.014,100,1827.085,MORE,1132,1148,2280,3,2,10,0.937408461,10,0.174607574,0.820767734,-0.968026487,170,80,90,0,0.199450275,0,0.390166852,-0.884216574,1.121289363,1.121289363,0.390166852,0,1,0,1
1169,5,210,25,88,80,0,3295.057,100,1815.741,MORE,-202,2176,1974,4,2,-8,-0.749926769,8,-0.174607574,0.820767734,-0.696543292,168,88,80,1,0.15956022,0.312133481,0,-0.406261669,-0.765262755,0.765262755,0,0.312133481,1,1,0
1170,5,211,36,80,70,0,2767.752,100,795.399,MORE,-920,2116,1196,3,2,-10,-0.937408461,10,0.174607574,0.820767734,-0.93120617,150,80,70,1,-0.199450275,0,-0.390166852,-0.884216574,-1.78066337,1.78066337,-0.390166852,0,1,0,0
1171,5,212,28,80,93,1,6210.28,100,1524.843,MORE,206,3284,3490,5,2,13,1.218630999,13,0.698430296,0.820767734,0.600798133,173,80,93,0,0.259285357,0,0.507216907,0.071693236,-0.188266305,0.188266305,0.507216907,0,1,1,0
1172,5,213,21,82,80,1,6286.696,74,2159.858,MORE,20,3118,3138,5,2,-2,-0.187481692,2,-1.222253018,-0.434524095,0.634805014,162,82,80,1,0.039890055,0.07803337,0,0.071693236,-0.451308804,0.451308804,0,0.07803337,0,1,0
1173,5,214,19,50,41,0,2773.192,100,1302.099,MORE,-620,1948,1328,2,2,-9,-0.843667615,9,0,0.820767734,-0.928785245,91,50,41,1,-1.376206896,-1.170500555,-1.521650721,-1.362171478,-1.356401274,1.356401274,-1.521650721,-1.170500555,1,0,0
1174,5,215,56,96,110,1,5131.492,100,1204.252,MORE,564,2406,2970,5,2,14,1.312371845,14,0.87303787,0.820767734,0.120712609,206,96,110,0,0.917471264,0.624266962,1.170500555,0.071693236,0.318019796,0.318019796,1.170500555,0.624266962,1,1,1
1175,5,216,23,80,85,1,5182.951,100,1726.051,MORE,582,2568,3150,3,2,5,0.46870423,5,-0.698430296,0.820767734,0.14361305,165,80,85,0,0.099725137,0,0.195083426,-0.884216574,0.343475521,0.343475521,0.195083426,0,1,0,1
1176,5,217,10,60,50,0,3509.371,100,1561.938,MORE,-404,2182,1778,4,2,-10,-0.937408461,10,0.174607574,0.820767734,-0.601168622,110,60,50,1,-0.997251374,-0.780333703,-1.170500555,-0.406261669,-1.050932566,1.050932566,-1.170500555,-0.780333703,1,1,0
1177,5,218,19,41,50,1,5524.318,74,980.147,MORE,298,2474,2772,5,2,9,0.843667615,9,0,-0.434524095,0.295529233,91,41,50,0,-1.376206896,-1.521650721,-1.170500555,0.071693236,-0.058159262,0.058159262,-1.170500555,-1.521650721,0,1,0
1178,5,219,56,110,96,0,3216.242,100,1853.984,MORE,-570,2494,1924,3,2,-14,-1.312371845,14,0.87303787,0.820767734,-0.731617783,206,110,96,1,0.917471264,1.170500555,0.624266962,-0.884216574,-1.285690925,1.285690925,0.624266962,1.170500555,1,0,0
1179,5,220,35,72,80,0,4535.487,74,1445.72,MORE,86,2432,2518,3,2,8,0.749926769,8,-0.174607574,-0.434524095,-0.144523352,152,72,80,0,-0.15956022,-0.312133481,0,-0.884216574,-0.357971143,0.357971143,0,-0.312133481,0,0,0
1180,5,221,11,49,50,0,3339.644,100,708.188,MORE,-780,2220,1440,5,2,1,0.093740846,1,-1.396860592,0.820767734,-0.676701049,99,49,50,0,-1.216646676,-1.20951724,-1.170500555,0.071693236,-1.582674392,1.582674392,-1.170500555,-1.20951724,1,1,0
1181,5,222,17,43,50,1,3696.722,84,1602.881,MORE,600,1914,2514,3,2,7,0.656185922,7,-0.349215148,0.048280455,-0.517793109,93,43,50,0,-1.336316841,-1.443617351,-1.170500555,-0.884216574,0.368931247,0.368931247,-1.170500555,-1.443617351,0,0,1
1182,5,223,1,51,50,1,9921.861,44,1453.737,MORE,-984,4618,3634,9,2,-1,-0.093740846,1,-1.396860592,-1.882937743,2.252537222,101,51,50,1,-1.176756621,-1.131483869,-1.170500555,1.983512854,-1.871172617,1.871172617,-1.170500555,-1.131483869,0,1,0
1183,5,224,41,112,110,0,4966.261,80,1377.971,MORE,-406,2880,2474,3,2,-2,-0.187481692,2,-1.222253018,-0.144841365,0.047181006,222,112,110,1,1.236591704,1.248533925,1.170500555,-0.884216574,-1.05376098,1.05376098,1.170500555,1.248533925,0,0,0
1184,5,225,20,40,50,1,3274.713,84,679.312,MORE,164,1734,1898,3,2,10,0.937408461,10,0.174607574,0.048280455,-0.705596841,90,40,50,0,-1.396151924,-1.560667406,-1.170500555,-0.884216574,-0.247662998,0.247662998,-1.170500555,-1.560667406,0,0,0
1185,5,226,1,50,51,0,3353.705,100,1021.074,MORE,-644,2128,1484,2,2,1,0.093740846,1,-1.396860592,0.820767734,-0.67044358,101,50,51,0,-1.176756621,-1.170500555,-1.131483869,-1.362171478,-1.390342242,1.390342242,-1.131483869,-1.170500555,1,0,0
1186,5,227,23,85,80,1,2880.162,100,793.045,MORE,662,1370,2032,3,2,-5,-0.46870423,5,-0.698430296,0.820767734,-0.881181129,165,85,80,1,0.099725137,0.195083426,0,-0.884216574,0.45661208,0.45661208,0,0.195083426,1,0,1
1187,5,228,11,50,49,1,5744.953,100,1658.069,MORE,982,2558,3540,4,2,-1,-0.093740846,1,-1.396860592,0.820767734,0.393716893,99,50,49,1,-1.216646676,-1.170500555,-1.20951724,-0.406261669,0.909158315,0.909158315,-1.20951724,-1.170500555,1,0,1
1188,5,229,17,50,43,0,7705.144,44,1761.267,MORE,-1526,4280,2754,4,1,-7,-0.656185922,7,-0.349215148,-1.882937743,1.266047066,93,50,43,1,-1.336316841,-1.170500555,-1.443617351,-0.406261669,-2.637672803,2.637672803,-1.443617351,-1.170500555,0,0,0
1189,5,230,21,80,82,0,5349.143,84,1673.566,MORE,-208,3284,3076,4,2,2,0.187481692,2,-1.222253018,0.048280455,0.217572321,162,80,82,0,0.039890055,0,0.07803337,-0.406261669,-0.773747997,0.773747997,0.07803337,0,0,1,0
1190,5,231,10,50,60,1,1684.127,100,1996.049,MORE,1458,698,2156,1,2,10,0.937408461,10,0.174607574,0.820767734,-1.41344427,110,50,60,0,-0.997251374,-1.170500555,-0.780333703,-1.840126383,1.58232084,1.58232084,-0.780333703,-1.170500555,1,0,1
1191,5,232,3,53,50,1,8920.318,74,1111.603,MORE,692,3814,4506,7,2,-3,-0.281222538,3,-1.047645444,-0.434524095,1.806827504,103,53,50,1,-1.136866566,-1.053450499,-1.170500555,1.027603045,0.49903829,0.49903829,-1.170500555,-1.053450499,0,1,1
1192,5,233,45,122,110,0,3929.479,100,1413.256,MORE,-144,2320,2176,5,2,-12,-1.124890153,12,0.523822722,0.820767734,-0.41421088,232,122,110,1,1.436041979,1.638700776,1.170500555,0.071693236,-0.68323875,0.68323875,1.170500555,1.638700776,1,1,0
1193,5,234,38,67,80,1,4745.499,100,2040.082,MORE,240,2702,2942,5,2,13,1.218630999,13,0.698430296,0.820767734,-0.051063172,147,67,80,0,-0.259285357,-0.507216907,0,0.071693236,-0.140183267,0.140183267,0,-0.507216907,1,1,0
1194,5,235,38,80,67,1,7090.407,84,1431.508,MORE,-8,3482,3474,5,2,-13,-1.218630999,13,0.698430296,0.048280455,0.992474933,147,80,67,1,-0.259285357,0,-0.507216907,0.071693236,-0.4909066,0.4909066,-0.507216907,0,0,1,0
1195,5,236,36,70,80,1,2844.463,100,1301.156,MORE,1102,1276,2378,3,2,10,0.937408461,10,0.174607574,0.820767734,-0.897068007,150,70,80,0,-0.199450275,-0.390166852,0,-0.884216574,1.078863154,1.078863154,0,-0.390166852,1,0,1
1196,5,237,45,110,122,1,3887.278,100,755.967,MORE,82,2012,2094,3,2,12,1.124890153,12,0.523822722,0.820767734,-0.432991297,232,110,122,0,1.436041979,1.170500555,1.638700776,-0.884216574,-0.363627971,0.363627971,1.638700776,1.170500555,1,0,0
1197,5,238,42,110,115,1,3029.146,100,627.125,MORE,652,1336,1988,3,2,5,0.46870423,5,-0.698430296,0.820767734,-0.814879815,225,110,115,0,1.296426786,1.170500555,1.36558398,-0.884216574,0.44247001,0.44247001,1.36558398,1.170500555,1,0,1
1198,5,239,41,110,112,1,4561.733,100,763.917,MORE,26,2312,2338,3,2,2,0.187481692,2,-1.222253018,0.820767734,-0.132843277,222,110,112,0,1.236591704,1.170500555,1.248533925,-0.884216574,-0.442823562,0.442823562,1.248533925,1.170500555,1,0,0
1199,5,240,53,110,103,0,3030.526,74,1640.106,MORE,44,2018,2062,2,2,-7,-0.656185922,7,-0.349215148,-0.434524095,-0.814265684,213,110,103,1,1.057086457,1.170500555,0.897383758,-1.362171478,-0.417367836,0.417367836,0.897383758,1.170500555,0,0,0
1200,6,1,49,110,131,1,4851.797,44,1770.088,MORE,1012,1602,2614,2,1,21,1.968557767,21,2.095290887,-0.658436931,2.058508817,241,110,131,0,1.615547226,1.170500555,1.989850943,-0.699964628,0.970895549,0.970895549,1.989850943,1.170500555,0,0,1
1201,6,2,13,47,50,1,3312.908,54,1638.924,MORE,-68,1286,1218,3,2,3,0.281222538,3,-1.047645444,-0.208223645,0.64503125,97,47,50,0,-1.256536731,-1.28755061,-1.170500555,0.024136711,-0.497548844,0.497548844,-1.170500555,-1.28755061,0,1,0
1202,6,3,16,50,44,0,4002.002,44,933.921,MORE,-620,1698,1078,3,1,-6,-0.562445076,6,-0.523822722,-0.658436931,1.277967681,94,50,44,1,-1.316371814,-1.170500555,-1.404600665,0.024136711,-1.248087089,1.248087089,-1.404600665,-1.170500555,0,1,0
1203,6,4,7,57,50,1,3162.02,4,507.562,MORE,-24,1468,1444,3,1,-7,-0.656185922,7,-0.349215148,-2.459290076,0.506439835,107,57,50,1,-1.057086457,-0.897383758,-1.170500555,0.024136711,-0.437723332,0.437723332,-1.170500555,-0.897383758,0,1,0
1204,6,5,18,42,50,1,2004.751,74,1477.236,MORE,492,790,1282,1,2,8,0.749926769,8,-0.174607574,0.692202928,-0.556517773,92,42,50,0,-1.356261869,-1.482634036,-1.170500555,-1.424065968,0.263866767,0.263866767,-1.170500555,-1.482634036,1,0,1
1205,6,6,51,108,110,1,4362.118,34,974.686,MORE,-156,1906,1750,3,2,2,0.187481692,2,-1.222253018,-1.108650218,1.608736104,218,108,110,0,1.156811594,1.092467184,1.170500555,0.024136711,-0.617199868,0.617199868,1.170500555,1.092467184,0,1,0
1206,6,7,31,78,80,1,3420.4,54,1641.365,MORE,-356,1352,996,1,2,2,0.187481692,2,-1.222253018,-0.208223645,0.743763212,158,78,80,0,-0.039890055,-0.07803337,0,-1.424065968,-0.889134015,0.889134015,0,-0.07803337,0,0,0
1207,6,8,58,110,92,0,2673.063,44,2328.276,MORE,-496,1498,1002,2,2,-18,-1.687335229,18,1.571468165,-0.658436931,0.057330282,202,110,92,1,0.837691154,1.170500555,0.468200222,-0.699964628,-1.079487918,1.079487918,0.468200222,1.170500555,0,0,0
1208,6,9,12,50,48,1,7952.5,34,1684.152,MORE,728,3128,3856,7,1,-2,-0.187481692,2,-1.222253018,-1.108650218,4.906520684,98,50,48,1,-1.236591704,-1.170500555,-1.248533925,2.920542069,0.58474906,0.58474906,-1.248533925,-1.170500555,0,1,1
1209,6,10,54,110,101,1,3058.378,44,1336.316,MORE,4,1264,1268,3,2,-9,-0.843667615,9,0,-0.658436931,0.411244118,211,110,101,1,1.017196402,1.170500555,0.819350388,0.024136711,-0.399652551,0.399652551,0.819350388,1.170500555,0,0,0
1210,6,11,14,46,50,1,1738.02,54,1861.731,MORE,46,742,788,2,1,4,0.374963384,4,-0.87303787,-0.208223645,-0.801511587,96,46,50,0,-1.276481759,-1.326567295,-1.170500555,-0.699964628,-0.34254638,0.34254638,-1.170500555,-1.326567295,0,0,0
1211,6,12,22,80,83,1,5138.158,44,1426.773,MORE,230,2178,2408,5,2,3,0.281222538,3,-1.047645444,-0.658436931,2.321532888,163,80,83,0,0.059835082,0,0.117050055,1.47233939,-0.092366965,0.092366965,0.117050055,0,0,1,0
1212,6,13,6,50,56,1,1388.854,74,2020.012,MORE,448,682,1130,3,2,6,0.562445076,6,-0.523822722,0.692202928,-1.122222378,106,50,56,0,-1.077031484,-1.170500555,-0.936400444,0.024136711,0.204041255,0.204041255,-0.936400444,-1.170500555,1,0,1
1213,6,14,13,50,47,1,6180.061,54,2205.455,MORE,-482,2874,2392,5,2,-3,-0.281222538,3,-1.047645444,-0.208223645,3.278526224,97,50,47,1,-1.256536731,-1.170500555,-1.28755061,1.47233939,-1.060452528,1.060452528,-1.28755061,-1.170500555,0,1,0
1214,6,15,46,110,124,1,2672.362,74,2979.225,MORE,478,1288,1766,4,2,14,1.312371845,14,0.87303787,0.692202928,0.05668641,234,110,124,0,1.475932034,1.170500555,1.716734147,0.748238051,0.244831377,0.244831377,1.716734147,1.170500555,1,1,1
1215,6,16,27,91,80,0,3024.093,54,1974.745,MORE,-790,1834,1044,4,1,-11,-1.031149307,11,0.349215148,-0.208223645,0.379753167,171,91,80,1,0.219395302,0.429183537,0,0.748238051,-1.479231114,1.479231114,0,0.429183537,1,1,0
1216,6,17,40,64,80,1,3066.804,54,1270.355,MORE,572,1234,1806,3,2,16,1.499853537,16,1.222253018,-0.208223645,0.418983443,144,64,80,0,-0.31912044,-0.624266962,0,0.024136711,0.372640426,0.372640426,0,-0.624266962,0,0,1
1217,6,18,22,83,80,0,3916.881,54,2322.837,MORE,-176,1822,1646,4,2,-3,-0.281222538,3,-1.047645444,-0.208223645,1.199783598,163,83,80,1,0.059835082,0.117050055,0,0.748238051,-0.644393283,0.644393283,0,0.117050055,0,1,0
1218,6,19,54,101,110,0,3402.134,34,1644.199,MORE,-372,1648,1276,4,1,9,0.843667615,9,0,-1.108650218,0.726985796,211,101,110,0,1.017196402,0.819350388,1.170500555,0.748238051,-0.910888747,0.910888747,1.170500555,0.819350388,0,1,0
1219,6,20,6,56,50,0,3214.156,34,2032.674,MORE,-952,2008,1056,4,1,-6,-0.562445076,6,-0.523822722,-1.108650218,0.554327023,106,56,50,1,-1.077031484,-0.936400444,-1.170500555,0.748238051,-1.699497773,1.699497773,-1.170500555,-0.936400444,0,1,0
1220,6,21,18,50,42,0,2321.735,74,1341.637,MORE,330,1110,1440,2,2,-8,-0.749926769,8,-0.174607574,0.692202928,-0.265366317,92,50,42,1,-1.356261869,-1.170500555,-1.482634036,-0.699964628,0.043600108,0.043600108,-1.482634036,-1.170500555,1,0,0
1221,6,22,43,110,117,0,5081.537,54,2934.694,MORE,-528,2092,1564,3,2,7,0.656185922,7,-0.349215148,-0.208223645,2.269526205,227,110,117,0,1.336316841,1.170500555,1.443617351,0.024136711,-1.122997382,1.122997382,1.443617351,1.170500555,0,0,0
1222,6,23,32,77,80,0,2524.934,54,2612.962,MORE,-250,1154,904,1,2,3,0.281222538,3,-1.047645444,-0.208223645,-0.078726976,157,77,80,0,-0.059835082,-0.117050055,0,-1.424065968,-0.745008917,0.745008917,0,-0.117050055,0,0,0
1223,6,24,27,80,91,1,3137.088,74,1545.239,MORE,1170,1350,2520,3,2,11,1.031149307,11,0.349215148,0.692202928,0.483539663,171,80,91,0,0.219395302,0,0.429183537,0.024136711,1.185723525,1.185723525,0.429183537,0,1,1,1
1224,6,25,16,44,50,1,2415.087,74,1024.678,MORE,916,930,1846,3,2,6,0.562445076,6,-0.523822722,0.692202928,-0.179622018,94,44,50,0,-1.316371814,-1.404600665,-1.170500555,0.024136711,0.840367158,0.840367158,-1.170500555,-1.404600665,1,1,1
1225,6,26,7,50,57,1,3210.695,94,1348.275,MORE,528,1558,2086,3,2,7,0.656185922,7,-0.349215148,1.5926295,0.551148077,107,50,57,0,-1.057086457,-1.170500555,-0.897383758,0.024136711,0.312814914,0.312814914,-0.897383758,-1.170500555,1,1,1
1226,6,27,14,50,46,0,2546.444,84,1508.721,MORE,472,1398,1870,2,2,-4,-0.374963384,4,-0.87303787,1.142416214,-0.058969929,96,50,46,1,-1.276481759,-1.170500555,-1.326567295,-0.699964628,0.236673352,0.236673352,-1.326567295,-1.170500555,1,0,1
1227,6,28,51,110,108,1,2899.148,100,2561.548,MORE,1734,1334,3068,3,2,-2,-0.187481692,2,-1.222253018,1.862757472,0.264990533,218,110,108,1,1.156811594,1.170500555,1.092467184,0.024136711,1.952577819,1.952577819,1.092467184,1.170500555,1,1,1
1228,6,29,50,133,110,0,5130.035,44,3109.239,MORE,-520,2590,2070,6,2,-23,-2.15603946,23,2.444506035,-0.658436931,2.314071871,243,133,110,1,1.655437281,2.067884313,1.170500555,2.19644073,-1.112120016,1.112120016,1.170500555,2.067884313,0,1,0
1229,6,30,49,131,110,0,2914.8,84,3205.875,MORE,1204,1380,2584,0,2,-21,-1.968557767,21,2.095290887,1.142416214,0.279366977,241,131,110,1,1.615547226,1.989850943,1.170500555,-2.148167307,1.23195233,1.23195233,1.170500555,1.989850943,1,0,1
1230,6,31,47,126,110,0,4271.251,54,1918.465,MORE,-924,1964,1040,3,2,-16,-1.499853537,16,1.222253018,-0.208223645,1.52527429,236,126,110,1,1.515822089,1.794767517,1.170500555,0.024136711,-1.661426992,1.661426992,1.170500555,1.794767517,0,1,0
1231,6,32,50,110,133,1,3288.96,84,2009.277,MORE,1148,1572,2720,2,2,23,2.15603946,23,2.444506035,1.142416214,0.623034887,243,110,133,0,1.655437281,1.170500555,2.067884313,-0.699964628,1.155810769,1.155810769,2.067884313,1.170500555,1,0,1
1232,6,33,47,110,126,0,2520.065,44,1418.918,MORE,-210,1294,1084,3,2,16,1.499853537,16,1.222253018,-0.658436931,-0.083199178,236,110,126,0,1.515822089,1.170500555,1.794767517,0.024136711,-0.690622088,0.690622088,1.794767517,1.170500555,0,1,0
1233,6,34,12,48,50,1,2498.831,64,1870.417,MORE,512,956,1468,3,2,2,0.187481692,2,-1.222253018,0.241989641,-0.102702718,98,48,50,0,-1.236591704,-1.248533925,-1.170500555,0.024136711,0.291060182,0.291060182,-1.170500555,-1.248533925,1,0,1
1234,6,35,32,80,77,0,4839.608,44,1288.559,MORE,-1150,2736,1586,4,1,-3,-0.281222538,3,-1.047645444,-0.658436931,2.047313157,157,80,77,1,-0.059835082,0,-0.117050055,0.748238051,-1.968712578,1.968712578,-0.117050055,0,0,1,0
1235,6,36,43,117,110,0,2739.551,54,1828.172,MORE,462,1164,1626,2,2,-7,-0.656185922,7,-0.349215148,-0.208223645,0.118399857,227,117,110,1,1.336316841,1.443617351,1.170500555,-0.699964628,0.223076645,0.223076645,1.170500555,1.443617351,0,0,1
1236,6,37,40,80,64,0,2809.392,64,1959.702,MORE,-820,1344,524,1,2,-16,-1.499853537,16,1.222253018,0.241989641,0.182549179,144,80,64,1,-0.31912044,0,-0.624266962,-1.424065968,-1.520021236,1.520021236,-0.624266962,0,1,0,0
1237,6,38,31,80,78,1,3378.269,44,2012.59,MORE,-94,1420,1326,3,2,-2,-0.187481692,2,-1.222253018,-0.658436931,0.705065669,158,80,78,1,-0.039890055,0,-0.07803337,0.024136711,-0.532900283,0.532900283,-0.07803337,0,0,1,0
1238,6,39,46,124,110,1,2938.868,64,1693.006,MORE,766,1296,2062,3,2,-14,-1.312371845,14,0.87303787,0.241989641,0.30147356,234,124,110,1,1.475932034,1.716734147,1.170500555,0.024136711,0.636416548,0.636416548,1.170500555,1.716734147,1,1,1
1239,6,40,58,92,110,1,2794.449,84,2922.662,MORE,1920,1390,3310,2,2,18,1.687335229,18,1.571468165,1.142416214,0.168823956,202,92,110,0,0.837691154,0.468200222,1.170500555,-0.699964628,2.205476575,2.205476575,1.170500555,0.468200222,1,0,1
1240,6,41,49,110,131,0,2260.55,64,969.613,LESS,-382,1512,1130,2,2,21,1.968557767,21,2.095290887,0.241989641,-0.321565058,241,110,131,1,1.615547226,1.170500555,1.989850943,-0.699964628,-0.924485454,0.924485454,1.989850943,1.170500555,1,0,0
1241,6,42,13,47,50,0,1843.156,64,892.812,LESS,-320,1028,708,1,2,3,0.281222538,3,-1.047645444,0.241989641,-0.704943623,97,47,50,1,-1.256536731,-1.28755061,-1.170500555,-1.424065968,-0.840185869,0.840185869,-1.170500555,-1.28755061,1,0,0
1242,6,43,16,50,44,0,2730.824,54,2105.529,LESS,112,922,1034,3,2,-6,-0.562445076,6,-0.523822722,-0.208223645,0.110384062,94,50,44,0,-1.316371814,-1.170500555,-1.404600665,0.024136711,-0.252808112,0.252808112,-1.404600665,-1.170500555,0,1,0
1243,6,44,7,57,50,1,2591.599,44,1935.642,LESS,108,1082,1190,3,2,-7,-0.656185922,7,-0.349215148,-0.658436931,-0.017494826,107,57,50,0,-1.057086457,-0.897383758,-1.170500555,0.024136711,-0.258246795,0.258246795,-1.170500555,-0.897383758,0,1,0
1244,6,45,18,42,50,0,2012.687,94,1188.056,LESS,2,1124,1126,2,2,8,0.749926769,8,-0.174607574,1.5926295,-0.549228516,92,42,50,1,-1.356261869,-1.482634036,-1.170500555,-0.699964628,-0.402371893,0.402371893,-1.170500555,-1.482634036,1,0,0
1245,6,46,51,108,110,1,4287.015,14,1523.29,LESS,102,1644,1746,5,2,2,0.187481692,2,-1.222253018,-2.00907679,1.539753607,218,108,110,1,1.156811594,1.092467184,1.170500555,1.47233939,-0.266404819,0.266404819,1.170500555,1.092467184,0,1,0
1246,6,47,31,78,80,1,5723.241,0,2844.485,LESS,-620,3146,2526,6,1,2,0.187481692,2,-1.222253018,-2.639375391,2.858934673,158,78,80,1,-0.039890055,-0.07803337,0,2.19644073,-1.248087089,1.248087089,0,-0.07803337,0,1,0
1247,6,48,58,110,92,1,2819.185,24,1347.127,LESS,388,1030,1418,3,2,-18,-1.687335229,18,1.571468165,-1.558863504,0.191544101,202,110,92,0,0.837691154,1.170500555,0.468200222,0.024136711,0.122461011,0.122461011,0.468200222,1.170500555,0,1,1
1248,6,49,12,50,48,0,2436.317,74,1256.585,LESS,206,1174,1380,2,2,-2,-0.187481692,2,-1.222253018,0.692202928,-0.160122153,98,50,48,0,-1.236591704,-1.170500555,-1.248533925,-0.699964628,-0.124999063,0.124999063,-1.248533925,-1.170500555,1,0,1
1249,6,50,54,110,101,0,2697.941,44,1054.908,LESS,-1044,1524,480,1,1,-9,-0.843667615,9,0,-0.658436931,0.080180855,211,110,101,0,1.017196402,1.170500555,0.819350388,-1.424065968,-1.82458748,1.82458748,0.819350388,1.170500555,0,0,0
1250,6,51,14,46,50,0,1706.21,84,2012.951,LESS,1194,526,1720,1,2,4,0.374963384,4,-0.87303787,1.142416214,-0.830729237,96,46,50,1,-1.276481759,-1.326567295,-1.170500555,-1.424065968,1.218355622,1.218355622,-1.170500555,-1.326567295,1,0,1
1251,6,52,22,80,83,0,2821.937,34,1708.231,LESS,-600,1492,892,3,1,3,0.281222538,3,-1.047645444,-1.108650218,0.194071827,163,80,83,1,0.059835082,0,0.117050055,0.024136711,-1.220893674,1.220893674,0.117050055,0,0,1,0
1252,6,53,6,50,56,0,2177.331,94,1201.755,LESS,162,890,1052,1,2,6,0.562445076,6,-0.523822722,1.5926295,-0.398002143,106,50,56,1,-1.077031484,-1.170500555,-0.936400444,-1.424065968,-0.184824575,0.184824575,-0.936400444,-1.170500555,1,0,0
1253,6,54,13,50,47,0,3235.244,64,1601.172,LESS,38,1544,1582,4,2,-3,-0.281222538,3,-1.047645444,0.241989641,0.573696461,97,50,47,0,-1.256536731,-1.170500555,-1.28755061,0.748238051,-0.353423746,0.353423746,-1.28755061,-1.170500555,1,1,0
1254,6,55,46,110,124,0,2865.366,44,2068.093,LESS,-42,1240,1198,4,2,14,1.312371845,14,0.87303787,-0.658436931,0.23396159,234,110,124,1,1.475932034,1.170500555,1.716734147,0.748238051,-0.462197405,0.462197405,1.716734147,1.170500555,0,1,0
1255,6,56,27,91,80,0,2002.322,44,1190.803,LESS,-450,1036,586,2,1,-11,-1.031149307,11,0.349215148,-0.658436931,-0.558748822,171,91,80,0,0.219395302,0.429183537,0,-0.699964628,-1.016943064,1.016943064,0,0.429183537,0,0,0
1256,6,57,40,64,80,0,1829.599,94,1947.976,LESS,744,902,1646,1,2,16,1.499853537,16,1.222253018,1.5926295,-0.717395798,144,64,80,1,-0.31912044,-0.624266962,0,-1.424065968,0.606503792,0.606503792,0,-0.624266962,1,0,1
1257,6,58,22,83,80,1,1772.886,64,1842.229,LESS,1284,560,1844,0,2,-3,-0.281222538,3,-1.047645444,0.241989641,-0.769486984,163,83,80,0,0.059835082,0.117050055,0,-2.148167307,1.340725988,1.340725988,0,0.117050055,1,0,1
1258,6,59,54,101,110,0,2618.333,54,3603.064,LESS,-910,1482,572,2,2,9,0.843667615,9,0,-0.208223645,0.007060492,211,101,110,1,1.017196402,0.819350388,1.170500555,-0.699964628,-1.642391602,1.642391602,1.170500555,0.819350388,0,0,0
1259,6,60,6,56,50,1,5072.362,0,1863.422,LESS,-470,2778,2308,7,1,-6,-0.562445076,6,-0.523822722,-2.639375391,2.261098919,106,56,50,0,-1.077031484,-0.936400444,-1.170500555,2.920542069,-1.044136479,1.044136479,-1.170500555,-0.936400444,0,1,0
1260,6,61,18,50,42,1,2568.139,64,1664.948,LESS,922,954,1876,3,2,-8,-0.749926769,8,-0.174607574,0.241989641,-0.039042958,92,50,42,0,-1.356261869,-1.170500555,-1.482634036,0.024136711,0.848525183,0.848525183,-1.482634036,-1.170500555,1,1,1
1261,6,62,43,110,117,0,2989.604,74,1320.926,LESS,74,1754,1828,5,2,7,0.656185922,7,-0.349215148,0.692202928,0.348074841,227,110,117,1,1.336316841,1.170500555,1.443617351,1.47233939,-0.3044756,0.3044756,1.443617351,1.170500555,1,1,0
1262,6,63,32,77,80,0,1675.984,64,1914.827,LESS,706,1088,1794,2,2,3,0.281222538,3,-1.047645444,0.241989641,-0.858491976,157,77,80,1,-0.059835082,-0.117050055,0,-0.699964628,0.554836304,0.554836304,0,-0.117050055,0,0,1
1263,6,64,27,80,91,0,3503.513,44,1203.748,LESS,-316,1500,1184,4,1,11,1.031149307,11,0.349215148,-0.658436931,0.820102936,171,80,91,1,0.219395302,0,0.429183537,0.748238051,-0.834747186,0.834747186,0.429183537,0,0,1,0
1264,6,65,16,44,50,0,2771.247,54,2031.247,LESS,220,1116,1336,3,2,6,0.562445076,6,-0.523822722,-0.208223645,0.147512798,94,44,50,1,-1.316371814,-1.404600665,-1.170500555,0.024136711,-0.105963673,0.105963673,-1.170500555,-1.404600665,0,1,1
1265,6,66,7,50,57,0,2388.186,44,2314.702,LESS,-602,1250,648,2,2,7,0.656185922,7,-0.349215148,-0.658436931,-0.204330727,107,50,57,1,-1.057086457,-1.170500555,-0.897383758,-0.699964628,-1.223613016,1.223613016,-0.897383758,-1.170500555,0,0,0
1266,6,67,14,50,46,1,3945.564,34,3035.246,LESS,542,1372,1914,4,2,-4,-0.374963384,4,-0.87303787,-1.108650218,1.226129083,96,50,46,0,-1.276481759,-1.170500555,-1.326567295,0.748238051,0.331850304,0.331850304,-1.326567295,-1.170500555,0,1,1
1267,6,68,51,110,108,1,3299.362,24,1648.98,LESS,990,780,1770,2,2,-2,-0.187481692,2,-1.222253018,-1.558863504,0.632589178,218,110,108,0,1.156811594,1.170500555,1.092467184,-0.699964628,0.940982793,0.940982793,1.092467184,1.170500555,0,0,1
1268,6,69,50,133,110,1,1688.906,74,1249.903,LESS,1040,584,1624,1,2,-23,-2.15603946,23,2.444506035,0.692202928,-0.846623052,243,133,110,0,1.655437281,2.067884313,1.170500555,-1.424065968,1.008966329,1.008966329,1.170500555,2.067884313,1,0,1
1269,6,70,49,131,110,1,2604.156,74,1943.291,LESS,1044,1036,2080,3,2,-21,-1.968557767,21,2.095290887,0.692202928,-0.005961156,241,131,110,0,1.615547226,1.989850943,1.170500555,0.024136711,1.014405012,1.014405012,1.170500555,1.989850943,1,1,1
1270,6,71,47,126,110,1,1623.296,64,1945.524,LESS,682,696,1378,1,2,-16,-1.499853537,16,1.222253018,0.241989641,-0.906886179,236,126,110,0,1.515822089,1.794767517,1.170500555,-1.424065968,0.522204207,0.522204207,1.170500555,1.794767517,0,0,1
1271,6,72,50,110,133,0,3169.172,74,2268.02,LESS,34,1716,1750,4,2,23,2.15603946,23,2.444506035,0.692202928,0.513008985,243,110,133,1,1.655437281,1.170500555,2.067884313,0.748238051,-0.358862429,0.358862429,2.067884313,1.170500555,1,1,0
1272,6,73,47,110,126,0,2024.944,54,2444.96,LESS,-1054,1584,530,2,1,16,1.499853537,16,1.222253018,-0.208223645,-0.537970397,236,110,126,1,1.515822089,1.170500555,1.794767517,-0.699964628,-1.838184188,1.838184188,1.794767517,1.170500555,0,0,0
1273,6,74,12,48,50,0,2595.24,100,1136.082,LESS,102,1502,1604,4,2,2,0.187481692,2,-1.222253018,1.862757472,-0.014150549,98,48,50,1,-1.236591704,-1.248533925,-1.170500555,0.748238051,-0.266404819,0.266404819,-1.170500555,-1.248533925,1,1,0
1274,6,75,32,80,77,1,3293.758,54,1511.054,LESS,332,1384,1716,5,2,-3,-0.281222538,3,-1.047645444,-0.208223645,0.627441875,157,80,77,0,-0.059835082,0,-0.117050055,1.47233939,0.04631945,0.04631945,-0.117050055,0,0,1,1
1275,6,76,43,117,110,1,3866.424,24,1357.382,LESS,156,1596,1752,4,1,-7,-0.656185922,7,-0.349215148,-1.558863504,1.153438581,227,117,110,0,1.336316841,1.443617351,1.170500555,0.748238051,-0.1929826,0.1929826,1.170500555,1.443617351,0,1,0
1276,6,77,40,80,64,1,2417.686,94,2697.597,LESS,2158,866,3024,3,2,-16,-1.499853537,16,1.222253018,1.5926295,-0.177234823,144,80,64,0,-0.31912044,0,-0.624266962,0.024136711,2.52907821,2.52907821,-0.624266962,0,1,1,1
1277,6,78,31,80,78,0,1925.797,84,1710.003,LESS,936,898,1834,3,2,-2,-0.187481692,2,-1.222253018,1.142416214,-0.629037433,158,80,78,0,-0.039890055,0,-0.07803337,0.024136711,0.867560573,0.867560573,-0.07803337,0,1,1,1
1278,6,79,46,124,110,1,2135.408,100,2156.491,LESS,2080,720,2800,3,2,-14,-1.312371845,14,0.87303787,1.862757472,-0.436508637,234,124,110,0,1.475932034,1.716734147,1.170500555,0.024136711,2.423023893,2.423023893,1.170500555,1.716734147,1,1,1
1279,6,80,58,92,110,0,2478.857,54,1882.872,LESS,-440,1356,916,4,2,18,1.687335229,18,1.571468165,-0.208223645,-0.121048941,202,92,110,1,0.837691154,0.468200222,1.170500555,0.748238051,-1.003346357,1.003346357,1.170500555,0.468200222,0,1,0
1280,6,81,48,128,110,0,1976.739,64,1582.624,MORE,360,968,1328,2,2,-18,-1.687335229,18,1.571468165,0.241989641,-0.582246941,238,128,110,1,1.555712144,1.872800887,1.170500555,-0.699964628,0.08439023,0.08439023,1.170500555,1.872800887,1,0,0
1281,6,82,8,50,58,1,2004.993,100,2061.641,MORE,1970,476,2446,2,2,8,0.749926769,8,-0.174607574,1.862757472,-0.556295495,108,50,58,0,-1.037141429,-1.170500555,-0.858367073,-0.699964628,2.273460112,2.273460112,-0.858367073,-1.170500555,1,0,1
1282,6,83,4,54,50,0,4613.913,44,1239.115,MORE,-232,1836,1604,6,1,-4,-0.374963384,4,-0.87303787,-0.658436931,1.840011123,104,54,50,1,-1.116921539,-1.014433814,-1.170500555,2.19644073,-0.720534844,0.720534844,-1.170500555,-1.014433814,0,1,0
1283,6,84,37,80,69,1,1711.742,0,2362.191,MORE,-684,1786,1102,1,1,-11,-1.031149307,11,0.349215148,-2.639375391,-0.825648067,149,80,69,1,-0.219395302,0,-0.429183537,-1.424065968,-1.335106016,1.335106016,-0.429183537,0,0,0,0
1284,6,85,52,105,110,1,4627.032,34,1642.76,MORE,206,1744,1950,5,2,5,0.46870423,5,-0.698430296,-1.108650218,1.852060993,215,105,110,0,1.096976512,0.975417129,1.170500555,1.47233939,-0.124999063,0.124999063,1.170500555,0.975417129,0,1,0
1285,6,86,5,55,50,0,5225.785,24,1078.644,MORE,-274,2478,2204,8,2,-5,-0.46870423,5,-0.698430296,-1.558863504,2.402018745,105,55,50,1,-1.096976512,-0.975417129,-1.170500555,3.644643409,-0.777641015,0.777641015,-1.170500555,-0.975417129,0,1,0
1286,6,87,30,96,80,0,2770.914,34,1582.312,MORE,-280,1204,924,3,1,-16,-1.499853537,16,1.222253018,-1.108650218,0.147206936,176,96,80,1,0.31912044,0.624266962,0,0.024136711,-0.785799039,0.785799039,0,0.624266962,0,1,0
1287,6,88,33,80,75,1,3621.255,54,2196.786,MORE,760,1594,2354,5,2,-5,-0.46870423,5,-0.698430296,-0.208223645,0.928249577,155,80,75,1,-0.099725137,0,-0.195083426,1.47233939,0.628258524,0.628258524,-0.195083426,0,1,1,1
1288,6,89,48,110,128,1,4006.095,24,1646.671,MORE,240,1706,1946,5,1,18,1.687335229,18,1.571468165,-1.558863504,1.281727122,238,110,128,0,1.555712144,1.170500555,1.872800887,1.47233939,-0.078770258,0.078770258,1.872800887,1.170500555,0,1,0
1289,6,90,9,59,50,0,3613.889,54,1221.421,MORE,-720,1976,1256,3,2,-9,-0.843667615,9,0,-0.208223645,0.921483867,109,59,50,1,-1.017196402,-0.819350388,-1.170500555,0.024136711,-1.384054162,1.384054162,-1.170500555,-0.819350388,1,1,0
1290,6,91,44,110,119,0,2647.951,54,2643.33,MORE,-344,1474,1130,4,2,9,0.843667615,9,0,-0.208223645,0.03426478,229,110,119,0,1.376206896,1.170500555,1.521650721,0.748238051,-0.872817966,0.872817966,1.521650721,1.170500555,1,1,0
1291,6,92,2,52,50,1,2386.248,64,1332.287,MORE,860,764,1624,3,2,-2,-0.187481692,2,-1.222253018,0.241989641,-0.20611079,102,52,50,1,-1.156811594,-1.092467184,-1.170500555,0.024136711,0.764225597,0.764225597,-1.170500555,-1.092467184,1,1,1
1292,6,93,8,58,50,1,5160.542,44,1972.438,MORE,668,2068,2736,6,2,-8,-0.749926769,8,-0.174607574,-0.658436931,2.342092709,108,58,50,1,-1.037141429,-0.858367073,-1.170500555,2.19644073,0.503168816,0.503168816,-1.170500555,-0.858367073,0,1,1
1293,6,94,44,119,110,0,2065.98,74,1873.753,MORE,820,964,1784,2,2,-9,-0.843667615,9,0,0.692202928,-0.500278617,229,119,110,1,1.376206896,1.521650721,1.170500555,-0.699964628,0.709838768,0.709838768,1.170500555,1.521650721,1,0,1
1294,6,95,34,74,80,0,2924.279,54,1291.474,MORE,-700,1630,930,4,1,6,0.562445076,6,-0.523822722,-0.208223645,0.288073488,154,74,80,0,-0.119670165,-0.234100111,0,0.748238051,-1.356860748,1.356860748,0,-0.234100111,0,1,0
1295,6,96,24,86,80,0,2003.695,74,1088.548,MORE,676,786,1462,3,2,-6,-0.562445076,6,-0.523822722,0.692202928,-0.557487714,166,86,80,1,0.119670165,0.234100111,0,0.024136711,0.514046182,0.514046182,0,0.234100111,1,1,1
1296,6,97,39,66,80,1,1363.791,100,968.02,MORE,1246,426,1672,1,2,14,1.312371845,14,0.87303787,1.862757472,-1.145242874,146,66,80,0,-0.279230385,-0.546233592,0,-1.424065968,1.2890585,1.2890585,0,-0.546233592,1,0,1
1297,6,98,9,50,59,1,2217.916,74,1329.341,MORE,1084,766,1850,3,2,9,0.843667615,9,0,0.692202928,-0.360724609,109,50,59,0,-1.017196402,-1.170500555,-0.819350388,0.024136711,1.068791842,1.068791842,-0.819350388,-1.170500555,1,1,1
1298,6,99,57,94,110,1,1400.724,100,2213.264,MORE,1738,508,2246,1,2,16,1.499853537,16,1.222253018,1.862757472,-1.111319721,204,94,110,0,0.877581209,0.546233592,1.170500555,-1.424065968,1.958016502,1.958016502,1.170500555,0.546233592,1,0,1
1299,6,100,60,110,87,0,1797.961,84,1183.893,MORE,140,1066,1206,2,2,-23,-2.15603946,23,2.444506035,1.142416214,-0.746455466,197,110,87,1,0.737966017,1.170500555,0.273116796,-0.699964628,-0.214737331,0.214737331,0.273116796,1.170500555,1,0,0
1300,6,101,33,75,80,1,2228.883,74,1386.473,MORE,1290,894,2184,3,2,5,0.46870423,5,-0.698430296,0.692202928,-0.350651363,155,75,80,0,-0.099725137,-0.195083426,0,0.024136711,1.348884013,1.348884013,0,-0.195083426,1,1,1
1301,6,102,15,50,45,0,3844.088,44,1737.29,MORE,-350,1866,1516,6,2,-5,-0.46870423,5,-0.698430296,-0.658436931,1.132922848,95,50,45,1,-1.296426786,-1.170500555,-1.36558398,2.19644073,-0.880975991,0.880975991,-1.36558398,-1.170500555,0,1,0
1302,6,103,59,89,110,1,3052.768,54,3971.851,MORE,326,1514,1840,4,2,21,1.968557767,21,2.095290887,-0.208223645,0.406091304,199,89,110,0,0.777856072,0.351150166,1.170500555,0.748238051,0.038161425,0.038161425,1.170500555,0.351150166,0,1,0
1303,6,104,29,80,94,1,2088.88,74,1581.176,MORE,1602,744,2346,3,2,14,1.312371845,14,0.87303787,0.692202928,-0.479244848,174,80,94,0,0.279230385,0,0.546233592,0.024136711,1.773101282,1.773101282,0.546233592,0,1,0,1
1304,6,105,55,110,98,0,3037.557,44,2003.705,MORE,-942,1946,1004,4,2,-12,-1.124890153,12,0.523822722,-0.658436931,0.392119921,208,110,98,1,0.957361319,1.170500555,0.702300333,0.748238051,-1.685901065,1.685901065,0.702300333,1.170500555,0,1,0
1305,6,106,29,94,80,0,2712.239,54,2191.662,MORE,-230,1596,1366,5,2,-14,-1.312371845,14,0.87303787,-0.208223645,0.093313643,174,94,80,1,0.279230385,0.546233592,0,1.47233939,-0.717815503,0.717815503,0,0.546233592,0,1,0
1306,6,107,57,110,94,0,1593.224,94,1072.27,MORE,454,970,1424,2,2,-16,-1.499853537,16,1.222253018,1.5926295,-0.934507467,204,110,94,1,0.877581209,1.170500555,0.546233592,-0.699964628,0.212199279,0.212199279,0.546233592,1.170500555,1,0,1
1307,6,108,39,80,66,0,1890.398,44,1518.134,MORE,184,888,1072,3,2,-14,-1.312371845,14,0.87303787,-0.658436931,-0.661551599,146,80,66,1,-0.279230385,0,-0.546233592,0.024136711,-0.154911819,0.154911819,-0.546233592,0,0,0,0
1308,6,109,4,50,54,1,2797.303,64,2315.72,MORE,2266,776,3042,2,2,4,0.374963384,4,-0.87303787,0.241989641,0.17144537,104,50,54,0,-1.116921539,-1.170500555,-1.014433814,-0.699964628,2.675922649,2.675922649,-1.014433814,-1.170500555,1,0,1
1309,6,110,55,98,110,0,3297.712,54,1941.148,MORE,-484,1580,1096,4,2,12,1.124890153,12,0.523822722,-0.208223645,0.631073645,208,98,110,0,0.957361319,0.702300333,1.170500555,0.748238051,-1.063171869,1.063171869,1.170500555,0.702300333,0,1,0
1310,6,111,2,50,52,1,2174.46,64,1085.746,MORE,1178,756,1934,3,2,2,0.187481692,2,-1.222253018,0.241989641,-0.400639172,102,50,52,0,-1.156811594,-1.170500555,-1.092467184,0.024136711,1.196600891,1.196600891,-1.092467184,-1.170500555,1,0,1
1311,6,112,59,110,89,0,1800.041,94,861.574,MORE,-252,1136,884,2,2,-21,-1.968557767,21,2.095290887,1.5926295,-0.744544975,199,110,89,1,0.777856072,1.170500555,0.351150166,-0.699964628,-0.747728259,0.747728259,0.351150166,1.170500555,1,0,0
1312,6,113,60,87,110,1,1699.086,94,1683.837,MORE,1356,712,2068,1,2,23,2.15603946,23,2.444506035,1.5926295,-0.837272669,197,87,110,0,0.737966017,0.273116796,1.170500555,-1.424065968,1.438622281,1.438622281,1.170500555,0.273116796,1,0,1
1313,6,114,52,110,105,0,3231.459,54,1321.163,MORE,-90,1544,1454,4,2,-5,-0.46870423,5,-0.698430296,-0.208223645,0.570219919,215,110,105,1,1.096976512,1.170500555,0.975417129,0.748238051,-0.5274616,0.5274616,0.975417129,1.170500555,0,1,0
1314,6,115,30,80,96,1,2290.637,84,2184.835,MORE,1778,962,2740,3,2,16,1.499853537,16,1.222253018,1.142416214,-0.293929992,176,80,96,0,0.31912044,0,0.624266962,0.024136711,2.012403331,2.012403331,0.624266962,0,1,0,1
1315,6,116,24,80,86,1,3646.764,74,730.938,MORE,332,1548,1880,5,2,6,0.562445076,6,-0.523822722,0.692202928,0.951679726,166,80,86,0,0.119670165,0,0.234100111,1.47233939,0.04631945,0.04631945,0.234100111,0,1,1,0
1316,6,117,5,50,55,1,3965.336,44,1412.566,MORE,220,1364,1584,5,2,5,0.46870423,5,-0.698430296,-0.658436931,1.244289768,105,50,55,0,-1.096976512,-1.170500555,-0.975417129,1.47233939,-0.105963673,0.105963673,-0.975417129,-1.170500555,0,1,0
1317,6,118,34,80,74,1,3670.988,34,1664.825,MORE,-306,1834,1528,3,2,-6,-0.562445076,6,-0.523822722,-1.108650218,0.973929596,154,80,74,1,-0.119670165,0,-0.234100111,0.024136711,-0.821150479,0.821150479,-0.234100111,0,0,0,0
1318,6,119,15,45,50,1,1861.353,84,2091.131,MORE,1542,892,2434,1,2,5,0.46870423,5,-0.698430296,1.142416214,-0.688229583,95,45,50,0,-1.296426786,-1.36558398,-1.170500555,-1.424065968,1.691521038,1.691521038,-1.170500555,-1.36558398,1,0,1
1319,6,120,37,69,80,1,3099.971,64,1051.592,MORE,742,1524,2266,3,2,11,1.031149307,11,0.349215148,0.241989641,0.449447506,149,69,80,0,-0.219395302,-0.429183537,0,0.024136711,0.603784451,0.603784451,0,-0.429183537,1,0,1
1320,6,121,48,128,110,1,2425.369,54,3145.692,LESS,366,1040,1406,3,1,-18,-1.687335229,18,1.571468165,-0.208223645,-0.170177948,238,128,110,0,1.555712144,1.872800887,1.170500555,0.024136711,0.092548255,0.092548255,1.170500555,1.872800887,0,1,1
1321,6,122,8,50,58,0,1891.933,74,2665.538,LESS,600,1294,1894,2,2,8,0.749926769,8,-0.174607574,0.692202928,-0.660141694,108,50,58,1,-1.037141429,-1.170500555,-0.858367073,-0.699964628,0.410711206,0.410711206,-0.858367073,-1.170500555,1,0,1
1322,6,123,4,54,50,0,2044.302,94,1654.557,LESS,478,1094,1572,2,2,-4,-0.374963384,4,-0.87303787,1.5926295,-0.520189973,104,54,50,0,-1.116921539,-1.014433814,-1.170500555,-0.699964628,0.244831377,0.244831377,-1.170500555,-1.014433814,1,0,1
1323,6,124,37,80,69,1,2331.542,64,2475.028,LESS,932,1010,1942,4,2,-11,-1.031149307,11,0.349215148,0.241989641,-0.256358536,149,80,69,0,-0.219395302,0,-0.429183537,0.748238051,0.86212189,0.86212189,-0.429183537,0,1,1,1
1324,6,125,52,105,110,1,4785.945,34,1143.323,LESS,44,1996,2040,6,2,5,0.46870423,5,-0.698430296,-1.108650218,1.998023412,215,105,110,1,1.096976512,0.975417129,1.170500555,2.19644073,-0.345265722,0.345265722,1.170500555,0.975417129,0,1,0
1325,6,126,5,55,50,0,1920.198,64,1260.263,LESS,-110,922,812,2,2,-5,-0.46870423,5,-0.698430296,0.241989641,-0.634180144,105,55,50,0,-1.096976512,-0.975417129,-1.170500555,-0.699964628,-0.554655015,0.554655015,-1.170500555,-0.975417129,1,0,0
1326,6,127,30,96,80,1,1467.219,84,2442.702,LESS,1514,804,2318,3,2,-16,-1.499853537,16,1.222253018,1.142416214,-1.050243717,176,96,80,0,0.31912044,0.624266962,0,0.024136711,1.653450257,1.653450257,0,0.624266962,1,1,1
1327,6,128,33,80,75,1,3917.63,24,1933.264,LESS,416,1584,2000,5,1,-5,-0.46870423,5,-0.698430296,-1.558863504,1.200471559,155,80,75,0,-0.099725137,0,-0.195083426,1.47233939,0.160531791,0.160531791,-0.195083426,0,0,1,1
1328,6,129,48,110,128,0,1610.102,94,2471.341,LESS,700,1204,1904,3,2,18,1.687335229,18,1.571468165,1.5926295,-0.919004936,238,110,128,1,1.555712144,1.170500555,1.872800887,0.024136711,0.54667828,0.54667828,1.872800887,1.170500555,1,1,1
1329,6,130,9,59,50,1,3836.994,24,1470.493,LESS,368,1510,1878,5,2,-9,-0.843667615,9,0,-1.558863504,1.126406973,109,59,50,0,-1.017196402,-0.819350388,-1.170500555,1.47233939,0.095267596,0.095267596,-1.170500555,-0.819350388,0,1,1
1330,6,131,44,110,119,1,2354.648,44,1549.937,LESS,420,844,1264,3,2,9,0.843667615,9,0,-0.658436931,-0.235135555,229,110,119,1,1.376206896,1.170500555,1.521650721,0.024136711,0.165970474,0.165970474,1.521650721,1.170500555,0,1,1
1331,6,132,2,52,50,0,3061.299,54,3245.721,LESS,112,1634,1746,4,2,-2,-0.187481692,2,-1.222253018,-0.208223645,0.413927072,102,52,50,0,-1.156811594,-1.092467184,-1.170500555,0.748238051,-0.252808112,0.252808112,-1.170500555,-1.092467184,0,1,0
1332,6,133,8,58,50,1,3584.885,14,1495.512,LESS,216,1674,1890,5,1,-8,-0.749926769,8,-0.174607574,-2.00907679,0.894843542,108,58,50,0,-1.037141429,-0.858367073,-1.170500555,1.47233939,-0.111402355,0.111402355,-1.170500555,-0.858367073,0,1,1
1333,6,134,44,119,110,0,1484.713,94,2070.076,LESS,1432,898,2330,2,2,-9,-0.843667615,9,0,1.5926295,-1.034175386,229,119,110,0,1.376206896,1.521650721,1.170500555,-0.699964628,1.541957257,1.541957257,1.170500555,1.521650721,1,0,1
1334,6,135,34,74,80,0,1891.344,64,1122.114,LESS,-428,1116,688,2,2,6,0.562445076,6,-0.523822722,0.241989641,-0.660682694,154,74,80,1,-0.119670165,-0.234100111,0,-0.699964628,-0.987030308,0.987030308,0,-0.234100111,1,0,0
1335,6,136,24,86,80,0,1606.882,74,2006.73,LESS,448,850,1298,2,2,-6,-0.562445076,6,-0.523822722,0.692202928,-0.921962523,166,86,80,0,0.119670165,0.234100111,0,-0.699964628,0.204041255,0.204041255,0,0.234100111,1,0,1
1336,6,137,39,66,80,0,1277.719,84,1255.262,LESS,500,876,1376,3,2,14,1.312371845,14,0.87303787,1.142416214,-1.224300454,146,66,80,1,-0.279230385,-0.546233592,0,0.024136711,0.274744133,0.274744133,0,-0.546233592,1,1,1
1337,6,138,9,50,59,0,1658.101,54,1424.689,LESS,104,742,846,3,2,9,0.843667615,9,0,-0.208223645,-0.874917605,109,50,59,1,-1.017196402,-1.170500555,-0.819350388,0.024136711,-0.263685478,0.263685478,-0.819350388,-1.170500555,0,1,0
1338,6,139,57,94,110,0,2822.017,64,1137.329,LESS,-336,1590,1254,5,2,16,1.499853537,16,1.222253018,0.241989641,0.194145308,204,94,110,1,0.877581209,0.546233592,1.170500555,1.47233939,-0.861940601,0.861940601,1.170500555,0.546233592,1,1,0
1339,6,140,60,110,87,1,2684.756,54,2808.405,LESS,416,1026,1442,3,2,-23,-2.15603946,23,2.444506035,-0.208223645,0.068070364,197,110,87,0,0.737966017,1.170500555,0.273116796,0.024136711,0.160531791,0.160531791,0.273116796,1.170500555,0,1,1
1340,6,141,33,75,80,0,1676.987,100,2223.357,LESS,1122,1032,2154,2,2,5,0.46870423,5,-0.698430296,1.862757472,-0.857570715,155,75,80,1,-0.099725137,-0.195083426,0,-0.699964628,1.120459329,1.120459329,0,-0.195083426,1,0,1
1341,6,142,15,50,45,0,1805.868,74,1907.093,LESS,250,1130,1380,2,2,-5,-0.46870423,5,-0.698430296,0.692202928,-0.739192845,95,50,45,0,-1.296426786,-1.170500555,-1.36558398,-0.699964628,-0.065173551,0.065173551,-1.36558398,-1.170500555,1,0,1
1342,6,143,59,89,110,0,1671.542,84,1390.153,LESS,196,1048,1244,2,2,21,1.968557767,21,2.095290887,1.142416214,-0.862571976,199,89,110,1,0.777856072,0.351150166,1.170500555,-0.699964628,-0.13859577,0.13859577,1.170500555,0.351150166,1,0,1
1343,6,144,29,80,94,0,1571.427,64,1155.466,LESS,-32,1074,1042,2,2,14,1.312371845,14,0.87303787,0.241989641,-0.954528125,174,80,94,1,0.279230385,0,0.546233592,-0.699964628,-0.448600697,0.448600697,0.546233592,0,1,0,0
1344,6,145,55,110,98,1,2280.73,74,2688.244,LESS,1570,976,2546,3,2,-12,-1.124890153,12,0.523822722,0.692202928,-0.303029623,208,110,98,0,0.957361319,1.170500555,0.702300333,0.024136711,1.729591818,1.729591818,0.702300333,1.170500555,1,1,1
1345,6,146,29,94,80,1,3221.795,14,1423.514,LESS,472,1218,1690,5,1,-14,-1.312371845,14,0.87303787,-2.00907679,0.561343484,174,94,80,0,0.279230385,0.546233592,0,1.47233939,0.236673352,0.236673352,0,0.546233592,0,1,1
1346,6,147,57,110,94,1,2407.991,64,1810.79,LESS,562,980,1542,3,2,-16,-1.499853537,16,1.222253018,0.241989641,-0.186139731,204,110,94,0,0.877581209,1.170500555,0.546233592,0.024136711,0.359043718,0.359043718,0.546233592,1.170500555,1,1,1
1347,6,148,39,80,66,1,2997.993,24,885.174,LESS,186,1218,1404,2,2,-14,-1.312371845,14,0.87303787,-1.558863504,0.355780181,146,80,66,0,-0.279230385,0,-0.546233592,-0.699964628,-0.152192477,0.152192477,-0.546233592,0,0,0,1
1348,6,149,4,50,54,0,1780.76,84,1552.097,LESS,114,1208,1322,2,2,4,0.374963384,4,-0.87303787,1.142416214,-0.762254674,104,50,54,1,-1.116921539,-1.170500555,-1.014433814,-0.699964628,-0.25008877,0.25008877,-1.014433814,-1.170500555,1,0,0
1349,6,150,55,98,110,1,2413.601,44,2360,LESS,148,860,1008,3,2,12,1.124890153,12,0.523822722,-0.658436931,-0.180986917,208,98,110,1,0.957361319,0.702300333,1.170500555,0.024136711,-0.203859965,0.203859965,1.170500555,0.702300333,0,0,0
1350,6,151,2,50,52,0,5177.366,34,2467.89,LESS,-1524,3104,1580,6,1,2,0.187481692,2,-1.222253018,-1.108650218,2.357545641,102,50,52,1,-1.156811594,-1.170500555,-1.092467184,2.19644073,-2.477229433,2.477229433,-1.092467184,-1.170500555,0,1,0
1351,6,152,59,110,89,1,2263.326,24,2166.877,LESS,394,834,1228,3,2,-21,-1.968557767,21,2.095290887,-1.558863504,-0.319015288,199,110,89,0,0.777856072,1.170500555,0.351150166,0.024136711,0.130619035,0.130619035,0.351150166,1.170500555,0,0,1
1352,6,153,60,87,110,0,2444.753,84,2447.921,LESS,1072,1326,2398,4,2,23,2.15603946,23,2.444506035,1.142416214,-0.152373643,197,87,110,1,0.737966017,0.273116796,1.170500555,0.748238051,1.052475793,1.052475793,1.170500555,0.273116796,1,1,1
1353,6,154,52,110,105,0,3962.399,0,3412.408,LESS,-1314,2814,1500,6,1,-5,-0.46870423,5,-0.698430296,-2.639375391,1.241592119,215,110,105,0,1.096976512,1.170500555,0.975417129,2.19644073,-2.191698578,2.191698578,0.975417129,1.170500555,0,1,0
1354,6,155,30,80,96,0,1620.34,84,1797.235,LESS,798,880,1678,2,2,16,1.499853537,16,1.222253018,1.142416214,-0.90960128,176,80,96,1,0.31912044,0,0.624266962,-0.699964628,0.679926012,0.679926012,0.624266962,0,1,0,1
1355,6,156,24,80,86,0,1457.779,100,1962.246,LESS,928,1072,2000,3,2,6,0.562445076,6,-0.523822722,1.862757472,-1.058914406,166,80,86,1,0.119670165,0,0.234100111,0.024136711,0.856683207,0.856683207,0.234100111,0,1,1,1
1356,6,157,5,50,55,0,2387.043,64,1176.573,LESS,494,1132,1626,3,2,5,0.46870423,5,-0.698430296,0.241989641,-0.205380578,105,50,55,1,-1.096976512,-1.170500555,-0.975417129,0.024136711,0.266586109,0.266586109,-0.975417129,-1.170500555,1,0,1
1357,6,158,34,80,74,0,2361.97,54,1604.112,LESS,-338,1264,926,4,2,-6,-0.562445076,6,-0.523822722,-0.208223645,-0.22841026,154,80,74,0,-0.119670165,0,-0.234100111,0.748238051,-0.864659942,0.864659942,-0.234100111,0,0,1,0
1358,6,159,15,45,50,1,2214.81,44,1867.887,LESS,510,678,1188,3,2,5,0.46870423,5,-0.698430296,-0.658436931,-0.363577487,95,45,50,1,-1.296426786,-1.36558398,-1.170500555,0.024136711,0.28834084,0.28834084,-1.170500555,-1.36558398,0,1,1
1359,6,160,37,69,80,0,1816.238,74,2107.565,LESS,426,956,1382,2,2,11,1.031149307,11,0.349215148,0.692202928,-0.729667946,149,69,80,1,-0.219395302,-0.429183537,0,-0.699964628,0.174128499,0.174128499,0,-0.429183537,1,0,1
1360,6,161,3,50,53,1,2219.093,54,1724.915,MORE,356,918,1274,3,2,3,0.281222538,3,-1.047645444,-0.208223645,-0.359643529,103,50,53,0,-1.136866566,-1.170500555,-1.053450499,0.024136711,0.078951547,0.078951547,-1.053450499,-1.170500555,0,0,0
1361,6,162,20,50,40,0,1555.681,74,1230.404,MORE,368,874,1242,2,2,-10,-0.937408461,10,0.174607574,0.692202928,-0.968990909,90,50,40,1,-1.396151924,-1.170500555,-1.560667406,-0.699964628,0.095267596,0.095267596,-1.560667406,-1.170500555,1,0,0
1362,6,163,25,80,88,1,2286.628,64,1336.87,MORE,1240,874,2114,3,2,8,0.749926769,8,-0.174607574,0.241989641,-0.297612279,168,80,88,0,0.15956022,0,0.312133481,0.024136711,1.280900476,1.280900476,0.312133481,0,1,0,1
1363,6,164,42,115,110,0,1884.333,64,2248.926,MORE,940,1152,2092,3,2,-5,-0.46870423,5,-0.698430296,0.241989641,-0.667122334,225,115,110,1,1.296426786,1.36558398,1.170500555,0.024136711,0.872999256,0.872999256,1.170500555,1.36558398,1,0,1
1364,6,165,53,103,110,1,3377.466,54,2313.3,MORE,390,1314,1704,4,2,7,0.656185922,7,-0.349215148,-0.208223645,0.704328109,213,103,110,0,1.057086457,0.897383758,1.170500555,0.748238051,0.125180352,0.125180352,1.170500555,0.897383758,0,1,0
1365,6,166,26,90,80,0,2420.207,54,1469.621,MORE,-452,1266,814,4,1,-10,-0.937408461,10,0.174607574,-0.208223645,-0.174919272,170,90,80,1,0.199450275,0.390166852,0,0.748238051,-1.019662406,1.019662406,0,0.390166852,0,1,0
1366,6,167,35,80,72,0,2573.202,44,869.329,MORE,-516,1388,872,4,1,-8,-0.749926769,8,-0.174607574,-0.658436931,-0.034392567,152,80,72,1,-0.15956022,0,-0.312133481,0.748238051,-1.106681333,1.106681333,-0.312133481,0,0,1,0
1367,6,168,28,93,80,0,1927.552,64,1541.193,MORE,-142,1416,1274,2,2,-13,-1.218630999,13,0.698430296,0.241989641,-0.627425457,173,93,80,1,0.259285357,0.507216907,0,-0.699964628,-0.598164478,0.598164478,0,0.507216907,1,0,0
1368,6,169,26,80,90,1,1923.274,64,1562.845,MORE,1014,694,1708,3,2,10,0.937408461,10,0.174607574,0.241989641,-0.631354822,170,80,90,0,0.199450275,0,0.390166852,0.024136711,0.97361489,0.97361489,0.390166852,0,1,1,1
1369,6,170,25,88,80,1,2021.136,64,1210.57,MORE,668,802,1470,3,2,-8,-0.749926769,8,-0.174607574,0.241989641,-0.541468065,168,88,80,1,0.15956022,0.312133481,0,0.024136711,0.503168816,0.503168816,0,0.312133481,1,1,1
1370,6,171,36,80,70,0,1993.843,54,1722.678,MORE,-176,976,800,3,2,-10,-0.937408461,10,0.174607574,-0.208223645,-0.566536828,150,80,70,1,-0.199450275,0,-0.390166852,0.024136711,-0.644393283,0.644393283,-0.390166852,0,0,0,0
1371,6,172,28,80,93,1,3532.94,44,2756.23,MORE,670,1396,2066,5,2,13,1.218630999,13,0.698430296,-0.658436931,0.847131789,173,80,93,0,0.259285357,0,0.507216907,1.47233939,0.505888158,0.505888158,0.507216907,0,0,1,1
1372,6,173,21,82,80,0,2024.598,54,2234.426,MORE,-626,1148,522,2,2,-2,-0.187481692,2,-1.222253018,-0.208223645,-0.5382882,162,82,80,1,0.039890055,0.07803337,0,-0.699964628,-1.256245113,1.256245113,0,0.07803337,0,0,0
1373,6,174,19,50,41,0,2658.451,54,1872.915,MORE,58,1356,1414,4,2,-9,-0.843667615,9,0,-0.208223645,0.043909084,91,50,41,1,-1.376206896,-1.170500555,-1.521650721,0.748238051,-0.326230331,0.326230331,-1.521650721,-1.170500555,0,1,0
1374,6,175,56,96,110,1,2239.484,54,1719.968,MORE,972,738,1710,3,2,14,1.312371845,14,0.87303787,-0.208223645,-0.340914289,206,96,110,0,0.917471264,0.624266962,1.170500555,0.024136711,0.916508719,0.916508719,1.170500555,0.624266962,0,0,1
1375,6,176,23,80,85,1,1283.366,84,941.489,MORE,526,380,906,1,2,5,0.46870423,5,-0.698430296,1.142416214,-1.219113655,165,80,85,0,0.099725137,0,0.195083426,-1.424065968,0.310095572,0.310095572,0.195083426,0,1,0,1
1376,6,177,10,60,50,1,4467.623,34,1748.128,MORE,416,1726,2142,5,2,-10,-0.937408461,10,0.174607574,-1.108650218,1.705642996,110,60,50,1,-0.997251374,-0.780333703,-1.170500555,1.47233939,0.160531791,0.160531791,-1.170500555,-0.780333703,0,1,1
1377,6,178,19,41,50,1,1179.067,100,2480.979,MORE,2482,382,2864,1,2,9,0.843667615,9,0,1.862757472,-1.314912831,91,41,50,0,-1.376206896,-1.521650721,-1.170500555,-1.424065968,2.969611528,2.969611528,-1.170500555,-1.521650721,1,0,1
1378,6,179,56,110,96,1,4555.062,44,1323.892,MORE,630,1442,2072,5,2,-14,-1.312371845,14,0.87303787,-0.658436931,1.785956173,206,110,96,1,0.917471264,1.170500555,0.624266962,1.47233939,0.451501328,0.451501328,0.624266962,1.170500555,0,1,1
1379,6,180,35,72,80,1,1342.918,64,1239.736,MORE,996,404,1400,1,2,8,0.749926769,8,-0.174607574,0.241989641,-1.164414833,152,72,80,0,-0.15956022,-0.312133481,0,-1.424065968,0.949140817,0.949140817,0,-0.312133481,1,0,1
1380,6,181,11,49,50,1,1767.813,64,1619.947,MORE,608,756,1364,3,2,1,0.093740846,1,-1.396860592,0.241989641,-0.774146561,99,49,50,0,-1.216646676,-1.20951724,-1.170500555,0.024136711,0.421588572,0.421588572,-1.170500555,-1.20951724,1,0,1
1381,6,182,17,43,50,1,2081.146,74,1742.326,MORE,1364,738,2102,3,2,7,0.656185922,7,-0.349215148,0.692202928,-0.486348567,93,43,50,0,-1.336316841,-1.443617351,-1.170500555,0.024136711,1.449499647,1.449499647,-1.170500555,-1.443617351,1,0,1
1382,6,183,1,51,50,1,1579.585,64,1387.87,MORE,1010,474,1484,1,2,-1,-0.093740846,1,-1.396860592,0.241989641,-0.94703496,101,51,50,1,-1.176756621,-1.131483869,-1.170500555,-1.424065968,0.968176207,0.968176207,-1.170500555,-1.131483869,1,0,1
1383,6,184,41,112,110,1,2602.75,54,1810.117,MORE,728,896,1624,3,2,-2,-0.187481692,2,-1.222253018,-0.208223645,-0.007252575,222,112,110,1,1.236591704,1.248533925,1.170500555,0.024136711,0.58474906,0.58474906,1.170500555,1.248533925,0,0,1
1384,6,185,20,40,50,1,1439.343,100,994.828,MORE,910,452,1362,1,2,10,0.937408461,10,0.174607574,1.862757472,-1.075847968,90,40,50,0,-1.396151924,-1.560667406,-1.170500555,-1.424065968,0.832209134,0.832209134,-1.170500555,-1.560667406,1,0,1
1385,6,186,1,50,51,1,1198.59,100,1511.21,MORE,1708,386,2094,1,2,1,0.093740846,1,-1.396860592,1.862757472,-1.296980853,101,50,51,0,-1.176756621,-1.170500555,-1.131483869,-1.424065968,1.91722638,1.91722638,-1.131483869,-1.170500555,1,0,1
1386,6,187,23,85,80,0,1701.021,74,2017.806,MORE,1642,768,2410,3,2,-5,-0.46870423,5,-0.698430296,0.692202928,-0.835495361,165,85,80,1,0.099725137,0.195083426,0,0.024136711,1.827488111,1.827488111,0,0.195083426,1,0,1
1387,6,188,11,50,49,1,2031.543,74,1723.602,MORE,1682,682,2364,3,2,-1,-0.093740846,1,-1.396860592,0.692202928,-0.531909181,99,50,49,1,-1.216646676,-1.170500555,-1.20951724,0.024136711,1.88187494,1.88187494,-1.20951724,-1.170500555,1,1,1
1388,6,189,17,50,43,0,2616.971,34,1048.119,MORE,-444,1394,950,4,2,-7,-0.656185922,7,-0.349215148,-1.108650218,0.005809488,93,50,43,1,-1.336316841,-1.170500555,-1.443617351,0.748238051,-1.00878504,1.00878504,-1.443617351,-1.170500555,0,1,0
1389,6,190,21,80,82,0,2551.144,44,1977.075,MORE,-672,1448,776,4,2,2,0.187481692,2,-1.222253018,-0.658436931,-0.054652955,162,80,82,0,0.039890055,0,0.07803337,0.748238051,-1.318789967,1.318789967,0.07803337,0,0,1,0
1390,6,191,10,50,60,1,1199.081,94,1889.409,MORE,1956,400,2356,1,2,10,0.937408461,10,0.174607574,1.5926295,-1.296529867,110,50,60,0,-0.997251374,-1.170500555,-0.780333703,-1.424065968,2.254424722,2.254424722,-0.780333703,-1.170500555,1,0,1
1391,6,192,3,53,50,0,3041.209,24,1742.173,MORE,-502,1594,1092,4,2,-3,-0.281222538,3,-1.047645444,-1.558863504,0.395474302,103,53,50,1,-1.136866566,-1.053450499,-1.170500555,0.748238051,-1.087645942,1.087645942,-1.170500555,-1.053450499,0,1,0
1392,6,193,45,122,110,1,3468.601,64,1209.878,MORE,856,1370,2226,3,2,-12,-1.124890153,12,0.523822722,0.241989641,0.788036082,232,122,110,1,1.436041979,1.638700776,1.170500555,0.024136711,0.758786914,0.758786914,1.170500555,1.638700776,1,1,1
1393,6,194,38,67,80,1,1921.719,64,947.95,MORE,638,632,1270,1,2,13,1.218630999,13,0.698430296,0.241989641,-0.632783098,147,67,80,0,-0.259285357,-0.507216907,0,-1.424065968,0.462378694,0.462378694,0,-0.507216907,1,0,1
1394,6,195,38,80,67,0,2037.211,44,1808.751,MORE,258,934,1192,3,2,-13,-1.218630999,13,0.698430296,-0.658436931,-0.526703094,147,80,67,1,-0.259285357,0,-0.507216907,0.024136711,-0.054296185,0.054296185,-0.507216907,0,0,1,0
1395,6,196,36,70,80,1,2503.706,94,2165.997,MORE,1700,1052,2752,2,2,10,0.937408461,10,0.174607574,1.5926295,-0.098225005,150,70,80,0,-0.199450275,-0.390166852,0,-0.699964628,1.906349014,1.906349014,0,-0.390166852,1,0,1
1396,6,197,45,110,122,1,2870.153,54,1910.509,MORE,950,1122,2072,2,2,12,1.124890153,12,0.523822722,-0.208223645,0.238358475,232,110,122,0,1.436041979,1.170500555,1.638700776,-0.699964628,0.886595963,0.886595963,1.638700776,1.170500555,0,0,1
1397,6,198,42,110,115,1,1684.625,84,1718.972,MORE,1560,784,2344,1,2,5,0.46870423,5,-0.698430296,1.142416214,-0.850555172,225,110,115,0,1.296426786,1.170500555,1.36558398,-1.424065968,1.715995111,1.715995111,1.36558398,1.170500555,1,0,1
1398,6,199,41,110,112,1,2492.483,54,1504.745,MORE,54,1012,1066,3,2,2,0.187481692,2,-1.222253018,-0.208223645,-0.108533389,222,110,112,0,1.236591704,1.170500555,1.248533925,0.024136711,-0.331669014,0.331669014,1.248533925,1.170500555,0,1,0
1399,6,200,53,110,103,0,5907.275,24,1954.021,MORE,-1412,2692,1280,3,2,-7,-0.656185922,7,-0.349215148,-1.558863504,3.027970862,213,110,103,1,1.057086457,1.170500555,0.897383758,0.024136711,-2.32494631,2.32494631,0.897383758,1.170500555,0,0,0
1400,6,201,3,50,53,0,1731.005,54,2411.519,LESS,-334,978,644,2,2,3,0.281222538,3,-1.047645444,-0.208223645,-0.807954901,103,50,53,1,-1.136866566,-1.170500555,-1.053450499,-0.699964628,-0.859221259,0.859221259,-1.053450499,-1.170500555,0,0,0
1401,6,202,20,50,40,1,2851.458,44,1695.909,LESS,576,1040,1616,3,2,-10,-0.937408461,10,0.174607574,-0.658436931,0.22118702,90,50,40,0,-1.396151924,-1.170500555,-1.560667406,0.024136711,0.378079109,0.378079109,-1.560667406,-1.170500555,0,1,1
1402,6,203,25,80,88,1,2398.445,24,1759.187,LESS,474,938,1412,3,1,8,0.749926769,8,-0.174607574,-1.558863504,-0.194907782,168,80,88,1,0.15956022,0,0.312133481,0.024136711,0.239392694,0.239392694,0.312133481,0,0,1,1
1403,6,204,42,115,110,1,1463.681,44,1676.023,LESS,696,382,1078,1,2,-5,-0.46870423,5,-0.698430296,-0.658436931,-1.053493388,225,115,110,0,1.296426786,1.36558398,1.170500555,-1.424065968,0.541239597,0.541239597,1.170500555,1.36558398,0,0,1
1404,6,205,53,103,110,0,2014.43,44,2142.188,LESS,-504,1310,806,4,1,7,0.656185922,7,-0.349215148,-0.658436931,-0.547627561,213,103,110,1,1.057086457,0.897383758,1.170500555,0.748238051,-1.090365284,1.090365284,1.170500555,0.897383758,0,1,0
1405,6,206,26,90,80,1,2120.2,64,2038.573,LESS,190,1022,1212,3,2,-10,-0.937408461,10,0.174607574,0.241989641,-0.450477265,170,90,80,0,0.199450275,0.390166852,0,0.024136711,-0.146753795,0.146753795,0,0.390166852,1,0,1
1406,6,207,35,80,72,0,1590.71,74,1286.309,LESS,58,978,1036,2,2,-8,-0.749926769,8,-0.174607574,0.692202928,-0.936816589,152,80,72,0,-0.15956022,0,-0.312133481,-0.699964628,-0.326230331,0.326230331,-0.312133481,0,1,0,0
1407,6,208,28,93,80,1,3189.212,34,1443.971,LESS,170,1396,1566,5,2,-13,-1.218630999,13,0.698430296,-1.108650218,0.531415829,173,93,80,0,0.259285357,0.507216907,0,1.47233939,-0.173947209,0.173947209,0,0.507216907,0,1,0
1408,6,209,26,80,90,0,1438.044,74,1699.037,LESS,270,1064,1334,3,2,10,0.937408461,10,0.174607574,0.692202928,-1.077041106,170,80,90,1,0.199450275,0,0.390166852,0.024136711,-0.037980136,0.037980136,0.390166852,0,1,1,1
1409,6,210,25,88,80,0,1940.528,54,1269.054,LESS,-524,1208,684,2,2,-8,-0.749926769,8,-0.174607574,-0.208223645,-0.615506933,168,88,80,0,0.15956022,0.312133481,0,-0.699964628,-1.117558699,1.117558699,0,0.312133481,0,0,0
1410,6,211,36,80,70,0,4441.81,34,2181.421,LESS,-234,2004,1770,5,2,-10,-0.937408461,10,0.174607574,-1.108650218,1.681933621,150,80,70,0,-0.199450275,0,-0.390166852,1.47233939,-0.723254186,0.723254186,-0.390166852,0,0,1,0
1411,6,212,28,80,93,0,1528.134,74,1577.445,LESS,536,986,1522,2,2,13,1.218630999,13,0.698430296,0.692202928,-0.994292972,173,80,93,1,0.259285357,0,0.507216907,-0.699964628,0.323692279,0.323692279,0.507216907,0,1,0,1
1412,6,213,21,82,80,0,1431.446,64,1804.58,LESS,-224,906,682,2,2,-2,-0.187481692,2,-1.222253018,0.241989641,-1.083101404,162,82,80,0,0.039890055,0.07803337,0,-0.699964628,-0.709657478,0.709657478,0,0.07803337,1,0,0
1413,6,214,19,50,41,0,1663.206,64,1170.064,LESS,312,696,1008,3,2,-9,-0.843667615,9,0,0.241989641,-0.870228636,91,50,41,0,-1.376206896,-1.170500555,-1.521650721,0.024136711,0.019126035,0.019126035,-1.521650721,-1.170500555,1,0,1
1414,6,215,56,96,110,0,1442.37,74,2069.264,LESS,162,920,1082,2,2,14,1.312371845,14,0.87303787,0.692202928,-1.073067653,206,96,110,1,0.917471264,0.624266962,1.170500555,-0.699964628,-0.184824575,0.184824575,1.170500555,0.624266962,1,0,0
1415,6,216,23,80,85,0,2646.513,24,1393.355,LESS,-622,1498,876,4,1,5,0.46870423,5,-0.698430296,-1.558863504,0.032943969,165,80,85,1,0.099725137,0,0.195083426,0.748238051,-1.250806431,1.250806431,0.195083426,0,0,1,0
1416,6,217,10,60,50,1,3014.756,34,2097.882,LESS,322,1268,1590,5,2,-10,-0.937408461,10,0.174607574,-1.108650218,0.371177084,110,60,50,0,-0.997251374,-0.780333703,-1.170500555,1.47233939,0.032722742,0.032722742,-1.170500555,-0.780333703,0,1,1
1417,6,218,19,41,50,0,1225.74,44,1531.016,LESS,-342,890,548,2,1,9,0.843667615,9,0,-0.658436931,-1.272043437,91,41,50,1,-1.376206896,-1.521650721,-1.170500555,-0.699964628,-0.870098625,0.870098625,-1.170500555,-1.521650721,0,0,0
1418,6,219,56,110,96,1,2014.943,54,1733.702,LESS,458,730,1188,3,2,-14,-1.312371845,14,0.87303787,-0.208223645,-0.547156368,206,110,96,0,0.917471264,1.170500555,0.624266962,0.024136711,0.217637962,0.217637962,0.624266962,1.170500555,0,1,1
1419,6,220,35,72,80,0,1310.065,74,806.9,LESS,28,888,916,3,2,8,0.749926769,8,-0.174607574,0.692202928,-1.194590485,152,72,80,1,-0.15956022,-0.312133481,0,0.024136711,-0.367020453,0.367020453,0,-0.312133481,1,0,0
1420,6,221,11,49,50,1,3393.889,54,1269.015,LESS,184,1430,1614,5,2,1,0.093740846,1,-1.396860592,-0.208223645,0.71941272,99,49,50,1,-1.216646676,-1.20951724,-1.170500555,1.47233939,-0.154911819,0.154911819,-1.170500555,-1.20951724,0,1,0
1421,6,222,17,43,50,0,1245.218,64,2234.645,LESS,416,750,1166,2,2,7,0.656185922,7,-0.349215148,0.241989641,-1.254152792,93,43,50,1,-1.336316841,-1.443617351,-1.170500555,-0.699964628,0.160531791,0.160531791,-1.170500555,-1.443617351,1,0,1
1422,6,223,1,51,50,0,1462.408,74,1776.984,LESS,190,960,1150,2,2,-1,-0.093740846,1,-1.396860592,0.692202928,-1.054662645,101,51,50,0,-1.176756621,-1.131483869,-1.170500555,-0.699964628,-0.146753795,0.146753795,-1.170500555,-1.131483869,1,0,1
1423,6,224,41,112,110,0,1597.046,64,1012.81,LESS,-406,972,566,2,2,-2,-0.187481692,2,-1.222253018,0.241989641,-0.93099694,222,112,110,0,1.236591704,1.248533925,1.170500555,-0.699964628,-0.957117552,0.957117552,1.170500555,1.248533925,1,0,0
1424,6,225,20,40,50,0,1587.007,64,1901.517,LESS,-654,1030,376,2,1,10,0.937408461,10,0.174607574,0.241989641,-0.940217814,90,40,50,1,-1.396151924,-1.560667406,-1.170500555,-0.699964628,-1.294315894,1.294315894,-1.170500555,-1.560667406,1,0,0
1425,6,226,1,50,51,0,1592.751,74,2016.448,LESS,-144,902,758,1,2,1,0.093740846,1,-1.396860592,0.692202928,-0.93494192,101,50,51,1,-1.176756621,-1.170500555,-1.131483869,-1.424065968,-0.60088382,0.60088382,-1.131483869,-1.170500555,1,0,0
1426,6,227,23,85,80,1,4144.806,4,2358.724,LESS,-456,2234,1778,4,1,-5,-0.46870423,5,-0.698430296,-2.459290076,1.409133899,165,85,80,0,0.099725137,0.195083426,0,0.748238051,-1.025101089,1.025101089,0,0.195083426,0,1,0
1427,6,228,11,50,49,0,1656.356,34,1557.58,LESS,-614,972,358,1,1,-1,-0.093740846,1,-1.396860592,-1.108650218,-0.876520396,99,50,49,0,-1.216646676,-1.170500555,-1.20951724,-1.424065968,-1.239929065,1.239929065,-1.20951724,-1.170500555,0,0,0
1428,6,229,17,50,43,0,1462.895,44,1291.634,LESS,-440,860,420,2,1,-7,-0.656185922,7,-0.349215148,-0.658436931,-1.054215333,93,50,43,0,-1.336316841,-1.170500555,-1.443617351,-0.699964628,-1.003346357,1.003346357,-1.443617351,-1.170500555,0,0,0
1429,6,230,21,80,82,0,1550.981,54,2025.337,LESS,-732,1174,442,2,1,2,0.187481692,2,-1.222253018,-0.208223645,-0.973307883,162,80,82,1,0.039890055,0,0.07803337,-0.699964628,-1.400370211,1.400370211,0.07803337,0,0,0,0
1430,6,231,10,50,60,0,1503.257,64,1145.208,LESS,-500,908,408,2,1,10,0.937408461,10,0.174607574,0.241989641,-1.017142626,110,50,60,1,-0.997251374,-1.170500555,-0.780333703,-0.699964628,-1.084926601,1.084926601,-0.780333703,-1.170500555,1,0,0
1431,6,232,3,53,50,0,1716.808,54,1815.222,LESS,-608,1198,590,2,2,-3,-0.281222538,3,-1.047645444,-0.208223645,-0.820994919,103,53,50,0,-1.136866566,-1.053450499,-1.170500555,-0.699964628,-1.23177104,1.23177104,-1.170500555,-1.053450499,0,0,0
1432,6,233,45,122,110,1,1170.135,74,1465.951,LESS,816,478,1294,1,2,-12,-1.124890153,12,0.523822722,0.692202928,-1.323116919,232,122,110,0,1.436041979,1.638700776,1.170500555,-1.424065968,0.704400085,0.704400085,1.170500555,1.638700776,1,0,1
1433,6,234,38,67,80,0,1385.53,64,982.675,LESS,42,808,850,2,2,13,1.218630999,13,0.698430296,0.241989641,-1.125275489,147,67,80,1,-0.259285357,-0.507216907,0,-0.699964628,-0.347985063,0.347985063,0,-0.507216907,1,0,0
1434,6,235,38,80,67,1,1559.527,74,1535.303,LESS,704,516,1220,1,2,-13,-1.218630999,13,0.698430296,0.692202928,-0.965458337,147,80,67,0,-0.259285357,0,-0.507216907,-1.424065968,0.552116963,0.552116963,-0.507216907,0,1,0,1
1435,6,236,36,70,80,0,1404.849,84,1032.374,LESS,400,800,1200,2,2,10,0.937408461,10,0.174607574,1.142416214,-1.107530887,150,70,80,1,-0.199450275,-0.390166852,0,-0.699964628,0.13877706,0.13877706,0,-0.390166852,1,0,1
1436,6,237,45,110,122,0,4426.453,14,980.493,LESS,-470,2168,1698,5,1,12,1.124890153,12,0.523822722,-2.00907679,1.667828136,232,110,122,1,1.436041979,1.170500555,1.638700776,1.47233939,-1.044136479,1.044136479,1.638700776,1.170500555,0,1,0
1437,6,238,42,110,115,0,1465.382,64,1364.275,LESS,48,902,950,2,2,5,0.46870423,5,-0.698430296,0.241989641,-1.051931011,225,110,115,1,1.296426786,1.170500555,1.36558398,-0.699964628,-0.339827039,0.339827039,1.36558398,1.170500555,1,0,0
1438,6,239,41,110,112,1,1831.341,44,1301.537,LESS,296,730,1026,3,2,2,0.187481692,2,-1.222253018,-0.658436931,-0.715795762,222,110,112,1,1.236591704,1.170500555,1.248533925,0.024136711,-0.002628697,0.002628697,1.248533925,1.170500555,0,1,1
1439,6,240,53,110,103,1,1191.365,44,1822.287,LESS,-112,756,644,3,2,-7,-0.656185922,7,-0.349215148,-0.658436931,-1.303617053,213,110,103,0,1.057086457,1.170500555,0.897383758,0.024136711,-0.557374356,0.557374356,0.897383758,1.170500555,0,1,0
1440,7,1,49,110,131,1,4083.058,70,999.476,MORE,-852,2158,1306,3,2,21,1.968557767,21,2.095290887,0.49580623,-0.149408255,241,110,131,0,1.615547226,1.170500555,1.989850943,-0.331569253,-0.434867684,0.434867684,1.989850943,1.170500555,1,0,0
1441,7,2,13,47,50,1,4313.189,80,1378.333,MORE,-1108,2378,1270,3,2,3,0.281222538,3,-1.047645444,0.874766405,-0.085168894,97,47,50,0,-1.256536731,-1.28755061,-1.170500555,-0.331569253,-0.684021611,0.684021611,-1.170500555,-1.28755061,1,1,0
1442,7,3,16,50,44,0,11158.922,30,1334.765,MORE,-1682,5674,3992,7,1,-6,-0.562445076,6,-0.523822722,-1.020034473,1.825766665,94,50,44,1,-1.316371814,-1.170500555,-1.404600665,1.633285577,-1.242671432,1.242671432,-1.404600665,-1.170500555,0,1,0
1443,7,4,7,57,50,0,5597.954,20,1276.14,MORE,-3020,4302,1282,4,1,-7,-0.656185922,7,-0.349215148,-1.398994648,0.27346372,107,57,50,1,-1.057086457,-0.897383758,-1.170500555,0.159644455,-2.544890005,2.544890005,-1.170500555,-0.897383758,0,1,0
1444,7,5,18,42,50,1,1564.923,80,1835.487,MORE,-44,900,856,1,2,8,0.749926769,8,-0.174607574,0.874766405,-0.852326951,92,42,50,0,-1.356261869,-1.482634036,-1.170500555,-1.313996667,0.351524398,0.351524398,-1.170500555,-1.482634036,1,0,1
1445,7,6,51,108,110,1,15107.624,10,1378.668,MORE,-1542,7840,6298,8,1,2,0.187481692,2,-1.222253018,-1.777954824,2.928017523,218,108,110,0,1.156811594,1.092467184,1.170500555,2.124499285,-1.106415379,1.106415379,1.170500555,1.092467184,0,1,0
1446,7,7,31,78,80,0,9450.808,20,1738.249,MORE,-1986,5230,3244,6,1,2,0.187481692,2,-1.222253018,-1.398994648,1.34895932,158,78,80,0,-0.039890055,-0.07803337,0,1.14207187,-1.538541721,1.538541721,0,-0.07803337,0,1,0
1447,7,8,58,110,92,0,4452.746,40,1420.156,MORE,-290,2074,1784,4,1,-18,-1.687335229,18,1.571468165,-0.641074297,-0.046212594,202,110,92,1,0.837691154,1.170500555,0.468200222,0.159644455,0.112103046,0.112103046,0.468200222,1.170500555,0,1,0
1448,7,9,12,50,48,1,1721.744,70,2214.439,MORE,-546,1142,596,1,1,-2,-0.187481692,2,-1.222253018,0.49580623,-0.808551533,98,50,48,1,-1.236591704,-1.170500555,-1.248533925,-1.313996667,-0.137050881,0.137050881,-1.248533925,-1.170500555,0,0,0
1449,7,10,54,110,101,0,11827.374,30,1710.043,MORE,-694,5834,5140,6,2,-9,-0.843667615,9,0,-1.020034473,2.01236008,211,110,101,1,1.017196402,1.170500555,0.819350388,1.14207187,-0.281092995,0.281092995,0.819350388,1.170500555,0,1,0
1450,7,11,14,46,50,1,3334.369,80,1452.102,MORE,-236,1670,1434,3,2,4,0.374963384,4,-0.87303787,0.874766405,-0.358399233,96,46,50,0,-1.276481759,-1.326567295,-1.170500555,-0.331569253,0.164658953,0.164658953,-1.170500555,-1.326567295,1,1,0
1451,7,12,22,80,83,1,2647.196,70,1233.237,MORE,452,1354,1806,3,2,3,0.281222538,3,-1.047645444,0.49580623,-0.550218476,163,80,83,0,0.059835082,0,0.117050055,-0.331569253,0.834260132,0.834260132,0.117050055,0,0,1,1
1452,7,13,6,50,56,1,1496.54,80,1632.572,MORE,416,534,950,1,2,6,0.562445076,6,-0.523822722,0.874766405,-0.871415558,106,50,56,0,-1.077031484,-1.170500555,-0.936400444,-1.313996667,0.799222861,0.799222861,-0.936400444,-1.170500555,1,0,1
1453,7,14,13,50,47,0,5530.412,40,1257.929,MORE,-268,2712,2444,4,1,-3,-0.281222538,3,-1.047645444,-0.641074297,0.254609872,97,50,47,1,-1.256536731,-1.170500555,-1.28755061,0.159644455,0.133514712,0.133514712,-1.28755061,-1.170500555,0,1,0
1454,7,15,46,110,124,0,9395.325,40,1538.372,MORE,14,4320,4334,4,1,14,1.312371845,14,0.87303787,-0.641074297,1.333471652,234,110,124,0,1.475932034,1.170500555,1.716734147,0.159644455,0.407973335,0.407973335,1.716734147,1.170500555,0,1,1
1455,7,16,27,91,80,0,11928.201,20,679.075,MORE,-762,5800,5038,8,1,-11,-1.031149307,11,0.349215148,-1.398994648,2.040505189,171,91,80,1,0.219395302,0.429183537,0,2.124499285,-0.347274507,0.347274507,0,0.429183537,0,1,0
1456,7,17,40,64,80,1,1513.154,70,778.833,MORE,340,596,936,1,2,16,1.499853537,16,1.222253018,0.49580623,-0.866777883,144,64,80,0,-0.31912044,-0.624266962,0,-1.313996667,0.725255289,0.725255289,0,-0.624266962,0,0,1
1457,7,18,22,83,80,1,2556.452,80,1243.85,MORE,66,1318,1384,3,2,-3,-0.281222538,3,-1.047645444,0.874766405,-0.57554899,163,83,80,1,0.059835082,0.117050055,0,-0.331569253,0.458582726,0.458582726,0,0.117050055,1,0,1
1458,7,19,54,101,110,1,8147.533,50,1263.967,MORE,1836,2858,4694,4,2,9,0.843667615,9,0,-0.262114121,0.985159776,211,101,110,0,1.017196402,0.819350388,1.170500555,0.159644455,2.18124855,2.18124855,1.170500555,0.819350388,0,1,1
1459,7,20,6,56,50,0,3727.561,40,1026.169,MORE,-558,1962,1404,4,1,-6,-0.562445076,6,-0.523822722,-0.641074297,-0.248642604,106,56,50,1,-1.077031484,-0.936400444,-1.170500555,0.159644455,-0.148729971,0.148729971,-1.170500555,-0.936400444,0,1,0
1460,7,21,18,50,42,1,3034.284,60,1171.367,MORE,-510,1612,1102,3,2,-8,-0.749926769,8,-0.174607574,0.116846054,-0.442165733,92,50,42,1,-1.356261869,-1.170500555,-1.482634036,-0.331569253,-0.10201361,0.10201361,-1.482634036,-1.170500555,0,1,0
1461,7,22,43,110,117,1,8183.827,60,2110.993,MORE,108,3642,3750,4,2,7,0.656185922,7,-0.349215148,0.116846054,0.995290977,227,110,117,0,1.336316841,1.170500555,1.443617351,0.159644455,0.499459542,0.499459542,1.443617351,1.170500555,0,1,1
1462,7,23,32,77,80,1,2979.43,70,1904.789,MORE,-214,1410,1196,3,2,3,0.281222538,3,-1.047645444,0.49580623,-0.45747782,157,77,80,0,-0.059835082,-0.117050055,0,-0.331569253,0.186070618,0.186070618,0,-0.117050055,1,0,0
1463,7,24,27,80,91,1,1699.13,80,1671.309,MORE,44,890,934,1,2,11,1.031149307,11,0.349215148,0.874766405,-0.814864063,171,80,91,0,0.219395302,0,0.429183537,-1.313996667,0.437171061,0.437171061,0.429183537,0,1,0,1
1464,7,25,16,44,50,1,2417.411,80,1360.914,MORE,4,1174,1178,3,2,6,0.562445076,6,-0.523822722,0.874766405,-0.614361253,94,44,50,0,-1.316371814,-1.404600665,-1.170500555,-0.331569253,0.398240759,0.398240759,-1.170500555,-1.404600665,1,0,1
1465,7,26,7,50,57,1,4118.085,50,1405.935,MORE,322,1860,2182,3,2,7,0.656185922,7,-0.349215148,-0.262114121,-0.139630728,107,50,57,0,-1.057086457,-1.170500555,-0.897383758,-0.331569253,0.707736653,0.707736653,-0.897383758,-1.170500555,0,0,1
1466,7,27,14,50,46,1,12443.439,10,2199.566,MORE,-1866,6896,5030,9,1,-4,-0.374963384,4,-0.87303787,-1.777954824,2.184330053,96,50,46,1,-1.276481759,-1.170500555,-1.326567295,2.615712992,-1.421750818,1.421750818,-1.326567295,-1.170500555,0,1,0
1467,7,28,51,110,108,1,3872.137,10,1147.383,MORE,-792,2362,1570,3,1,-2,-0.187481692,2,-1.222253018,-1.777954824,-0.208285287,218,110,108,1,1.156811594,1.170500555,1.092467184,-0.331569253,-0.376472233,0.376472233,1.092467184,1.170500555,0,0,0
1468,7,29,50,133,110,1,7794.385,20,1823.72,MORE,-664,4272,3608,7,1,-23,-2.15603946,23,2.444506035,-1.398994648,0.886581133,243,133,110,1,1.655437281,2.067884313,1.170500555,1.633285577,-0.251895269,0.251895269,1.170500555,2.067884313,0,1,0
1469,7,30,49,131,110,0,15631.356,20,1204.53,MORE,-1544,7840,6296,10,1,-21,-1.968557767,21,2.095290887,-1.398994648,3.074213423,241,131,110,1,1.615547226,1.989850943,1.170500555,3.106926699,-1.108361894,1.108361894,1.170500555,1.989850943,0,1,0
1470,7,31,47,126,110,1,15260.773,10,1834.596,MORE,-1090,7558,6468,5,1,-16,-1.499853537,16,1.222253018,-1.777954824,2.970767929,236,126,110,1,1.515822089,1.794767517,1.170500555,0.650858162,-0.666502976,0.666502976,1.170500555,1.794767517,0,1,0
1471,7,32,50,110,133,1,3851.631,70,1164.59,MORE,-76,2098,2022,3,2,23,2.15603946,23,2.444506035,0.49580623,-0.214009384,243,110,133,0,1.655437281,1.170500555,2.067884313,-0.331569253,0.320380157,0.320380157,2.067884313,1.170500555,1,1,1
1472,7,33,47,110,126,1,3440.122,30,1011.76,MORE,-1052,1798,746,3,2,16,1.499853537,16,1.222253018,-1.020034473,-0.328879068,236,110,126,0,1.515822089,1.170500555,1.794767517,-0.331569253,-0.62951919,0.62951919,1.794767517,1.170500555,0,1,0
1473,7,34,12,48,50,1,2026.291,80,2726.119,MORE,1908,1034,2942,1,2,2,0.187481692,2,-1.222253018,0.874766405,-0.723539498,98,48,50,0,-1.236591704,-1.248533925,-1.170500555,-1.313996667,2.251323092,2.251323092,-1.170500555,-1.248533925,1,0,1
1474,7,35,32,80,77,1,3003.111,40,1559.403,MORE,86,1360,1446,3,2,-3,-0.281222538,3,-1.047645444,-0.641074297,-0.450867445,157,80,77,1,-0.059835082,0,-0.117050055,-0.331569253,0.478047877,0.478047877,-0.117050055,0,0,1,1
1475,7,36,43,117,110,0,11883.827,20,2163.159,MORE,-1602,6046,4444,7,1,-7,-0.656185922,7,-0.349215148,-1.398994648,2.028118516,227,117,110,1,1.336316841,1.443617351,1.170500555,1.633285577,-1.16481083,1.16481083,1.170500555,1.443617351,0,1,0
1476,7,37,40,80,64,0,2465.224,80,1827.828,MORE,212,1700,1912,2,2,-16,-1.499853537,16,1.222253018,0.874766405,-0.601014609,144,80,64,1,-0.31912044,0,-0.624266962,-0.82278296,0.600678325,0.600678325,-0.624266962,0,1,0,1
1477,7,38,31,80,78,1,4102.412,50,1795.226,MORE,-540,2266,1726,3,2,-2,-0.187481692,2,-1.222253018,-0.262114121,-0.14400573,158,80,78,1,-0.039890055,0,-0.07803337,-0.331569253,-0.131211336,0.131211336,-0.07803337,0,0,1,0
1478,7,39,46,124,110,0,5583.298,50,1457.862,MORE,-948,3126,2178,4,2,-14,-1.312371845,14,0.87303787,-0.262114121,0.269372607,234,124,110,1,1.475932034,1.716734147,1.170500555,0.159644455,-0.528300407,0.528300407,1.170500555,1.716734147,0,1,0
1479,7,40,58,92,110,1,2509.03,70,1738.535,MORE,-816,2416,1600,1,1,18,1.687335229,18,1.571468165,0.49580623,-0.588786489,202,92,110,0,0.837691154,0.468200222,1.170500555,-1.313996667,-0.399830413,0.399830413,1.170500555,0.468200222,1,0,0
1480,7,41,49,110,131,0,2540.528,100,1537.138,LESS,-158,1724,1566,2,2,21,1.968557767,21,2.095290887,1.632686757,-0.579994056,241,110,131,1,1.615547226,1.170500555,1.989850943,-0.82278296,0.24057304,0.24057304,1.989850943,1.170500555,1,0,1
1481,7,42,13,47,50,0,1803.085,80,2363.957,LESS,-596,1538,942,2,2,3,0.281222538,3,-1.047645444,0.874766405,-0.785845797,97,47,50,1,-1.256536731,-1.28755061,-1.170500555,-0.82278296,-0.185713757,0.185713757,-1.170500555,-1.28755061,1,0,1
1482,7,43,16,50,44,0,1677.886,90,1433.72,LESS,-78,1110,1032,2,2,-6,-0.562445076,6,-0.523822722,1.253726581,-0.820794168,94,50,44,0,-1.316371814,-1.170500555,-1.404600665,-0.82278296,0.318433642,0.318433642,-1.404600665,-1.170500555,1,0,1
1483,7,44,7,57,50,1,4365.371,30,1533.43,LESS,-758,2782,2024,5,1,-7,-0.656185922,7,-0.349215148,-1.020034473,-0.070602676,107,57,50,0,-1.057086457,-0.897383758,-1.170500555,0.650858162,-0.343381477,0.343381477,-1.170500555,-0.897383758,0,1,0
1484,7,45,18,42,50,0,2389.287,80,844.201,LESS,-874,1550,676,2,2,8,0.749926769,8,-0.174607574,0.874766405,-0.622211859,92,42,50,1,-1.356261869,-1.482634036,-1.170500555,-0.82278296,-0.45627935,0.45627935,-1.170500555,-1.482634036,1,0,0
1485,7,46,51,108,110,0,3377.805,50,1563.969,LESS,-796,1940,1144,4,1,2,0.187481692,2,-1.222253018,-0.262114121,-0.346274396,218,108,110,1,1.156811594,1.092467184,1.170500555,0.159644455,-0.380365263,0.380365263,1.170500555,1.092467184,0,1,0
1486,7,47,31,78,80,0,3784.675,50,2417.966,LESS,-1072,2286,1214,4,1,2,0.187481692,2,-1.222253018,-0.262114121,-0.232699655,158,78,80,1,-0.039890055,-0.07803337,0,0.159644455,-0.64898434,0.64898434,0,-0.07803337,0,1,0
1487,7,48,58,110,92,1,16413.455,10,1395.507,LESS,1906,6846,8752,7,1,-18,-1.687335229,18,1.571468165,-1.777954824,3.292530555,202,110,92,0,0.837691154,1.170500555,0.468200222,1.633285577,2.249376577,2.249376577,0.468200222,1.170500555,0,1,1
1488,7,49,12,50,48,0,5827.548,10,2110.696,LESS,-848,3600,2752,4,1,-2,-0.187481692,2,-1.222253018,-1.777954824,0.337553181,98,50,48,0,-1.236591704,-1.170500555,-1.248533925,0.159644455,-0.430974654,0.430974654,-1.248533925,-1.170500555,0,1,0
1489,7,50,54,110,101,0,12620.652,20,1629.461,LESS,1574,4990,6564,6,1,-9,-0.843667615,9,0,-1.398994648,2.233797746,211,110,101,0,1.017196402,1.170500555,0.819350388,1.14207187,1.926255078,1.926255078,0.819350388,1.170500555,0,1,1
1490,7,51,14,46,50,1,9482.994,10,1212.383,LESS,776,4370,5146,5,1,4,0.374963384,4,-0.87303787,-1.777954824,1.357943803,96,46,50,1,-1.276481759,-1.326567295,-1.170500555,0.650858162,1.149595571,1.149595571,-1.170500555,-1.326567295,0,1,1
1491,7,52,22,80,83,0,3521.427,60,1322.309,LESS,-1154,2240,1086,4,1,3,0.281222538,3,-1.047645444,0.116846054,-0.30618338,163,80,83,1,0.059835082,0,0.117050055,0.159644455,-0.728791458,0.728791458,0.117050055,0,1,1,0
1492,7,53,6,50,56,0,2778.823,60,2922.806,LESS,-966,2136,1170,2,2,6,0.562445076,6,-0.523822722,0.116846054,-0.513475776,106,50,56,1,-1.077031484,-1.170500555,-0.936400444,-0.82278296,-0.545819043,0.545819043,-0.936400444,-1.170500555,1,0,0
1493,7,54,13,50,47,0,8080.843,70,3859.423,LESS,-1980,4742,2762,6,1,-3,-0.281222538,3,-1.047645444,0.49580623,0.966543757,97,50,47,0,-1.256536731,-1.170500555,-1.28755061,1.14207187,-1.532702176,1.532702176,-1.28755061,-1.170500555,1,1,0
1494,7,55,46,110,124,0,12239.264,40,2908.534,LESS,-1952,6628,4676,7,1,14,1.312371845,14,0.87303787,-0.641074297,2.127336117,234,110,124,1,1.475932034,1.170500555,1.716734147,1.633285577,-1.505450965,1.505450965,1.716734147,1.170500555,0,1,0
1495,7,56,27,91,80,0,4362.292,50,3185.823,LESS,-1202,2656,1454,4,1,-11,-1.031149307,11,0.349215148,-0.262114121,-0.071462156,171,91,80,0,0.219395302,0.429183537,0,0.159644455,-0.775507819,0.775507819,0,0.429183537,0,1,0
1496,7,57,40,64,80,0,3057.76,80,801.886,LESS,-1314,2208,894,2,2,16,1.499853537,16,1.222253018,0.874766405,-0.435612582,144,64,80,1,-0.31912044,-0.624266962,0,-0.82278296,-0.884512662,0.884512662,0,-0.624266962,1,0,0
1497,7,58,22,83,80,0,3561.9,50,969.494,LESS,-580,1762,1182,4,1,-3,-0.281222538,3,-1.047645444,-0.262114121,-0.294885643,163,83,80,0,0.059835082,0.117050055,0,0.159644455,-0.170141637,0.170141637,0,0.117050055,1,1,1
1498,7,59,54,101,110,0,3161.163,70,1970.956,LESS,822,1814,2636,4,2,9,0.843667615,9,0,0.49580623,-0.406748402,211,101,110,1,1.017196402,0.819350388,1.170500555,0.159644455,1.194365417,1.194365417,1.170500555,0.819350388,1,1,1
1499,7,60,6,56,50,0,11508.136,30,1104.21,LESS,-1286,6032,4746,6,1,-6,-0.562445076,6,-0.523822722,-1.020034473,1.923247162,106,56,50,0,-1.077031484,-0.936400444,-1.170500555,1.14207187,-0.857261451,0.857261451,-1.170500555,-0.936400444,0,1,0
1500,7,61,18,50,42,0,10793.268,20,1507.739,LESS,-1278,5638,4360,7,1,-8,-0.749926769,8,-0.174607574,-1.398994648,1.723697065,92,50,42,0,-1.356261869,-1.170500555,-1.482634036,1.633285577,-0.849475391,0.849475391,-1.482634036,-1.170500555,0,1,0
1501,7,62,43,110,117,0,2590.077,80,1764.426,LESS,-930,2256,1326,3,2,7,0.656185922,7,-0.349215148,0.874766405,-0.566162821,227,110,117,1,1.336316841,1.170500555,1.443617351,-0.331569253,-0.510781772,0.510781772,1.443617351,1.170500555,1,0,0
1502,7,63,32,77,80,0,3393.646,50,1133.687,LESS,-670,1888,1218,3,1,3,0.281222538,3,-1.047645444,-0.262114121,-0.341852498,157,77,80,1,-0.059835082,-0.117050055,0,-0.331569253,-0.257734814,0.257734814,0,-0.117050055,0,0,1
1503,7,64,27,80,91,0,4699.779,80,730.933,LESS,-1132,2964,1832,3,2,11,1.031149307,11,0.349215148,0.874766405,0.022744835,171,80,91,1,0.219395302,0,0.429183537,-0.331569253,-0.707379792,0.707379792,0.429183537,0,1,0,0
1504,7,65,16,44,50,0,2150.871,80,1347.389,LESS,330,1346,1676,2,2,6,0.562445076,6,-0.523822722,0.874766405,-0.688763916,94,44,50,1,-1.316371814,-1.404600665,-1.170500555,-0.82278296,0.715522713,0.715522713,-1.170500555,-1.404600665,1,0,1
1505,7,66,7,50,57,0,3551.735,80,1210.232,LESS,74,1974,2048,3,2,7,0.656185922,7,-0.349215148,0.874766405,-0.297723127,107,50,57,1,-1.057086457,-1.170500555,-0.897383758,-0.331569253,0.466368786,0.466368786,-0.897383758,-1.170500555,1,0,1
1506,7,67,14,50,46,0,10303.177,30,1133.188,LESS,-850,5172,4322,6,1,-4,-0.374963384,4,-0.87303787,-1.020034473,1.5868918,96,50,46,0,-1.276481759,-1.170500555,-1.326567295,1.14207187,-0.432921169,0.432921169,-1.326567295,-1.170500555,0,1,0
1507,7,68,51,110,108,0,11565.877,20,1682.711,LESS,-1072,5696,4624,6,1,-2,-0.187481692,2,-1.222253018,-1.398994648,1.939365133,218,110,108,0,1.156811594,1.170500555,1.092467184,1.14207187,-0.64898434,0.64898434,1.092467184,1.170500555,0,1,0
1508,7,69,50,133,110,1,19757.21,10,1332.93,LESS,-1132,9996,8864,7,1,-23,-2.15603946,23,2.444506035,-1.777954824,4.225914947,243,133,110,0,1.655437281,2.067884313,1.170500555,1.633285577,-0.707379792,0.707379792,1.170500555,2.067884313,0,1,0
1509,7,70,49,131,110,1,4363.442,40,1315.901,LESS,-346,2480,2134,3,2,-21,-1.968557767,21,2.095290887,-0.641074297,-0.071141142,241,131,110,0,1.615547226,1.989850943,1.170500555,-0.331569253,0.057600625,0.057600625,1.170500555,1.989850943,0,0,1
1510,7,71,47,126,110,1,8813.949,20,1096.187,LESS,160,4236,4396,7,1,-16,-1.499853537,16,1.222253018,-1.398994648,1.171184856,236,126,110,0,1.515822089,1.794767517,1.170500555,1.633285577,0.550068934,0.550068934,1.170500555,1.794767517,0,1,1
1511,7,72,50,110,133,0,4360.618,30,975.129,LESS,-552,2356,1804,4,1,23,2.15603946,23,2.444506035,-1.020034473,-0.071929441,243,110,133,1,1.655437281,1.170500555,2.067884313,0.159644455,-0.142890426,0.142890426,2.067884313,1.170500555,0,1,1
1512,7,73,47,110,126,0,3519.583,80,674.389,LESS,-1350,2486,1136,2,2,16,1.499853537,16,1.222253018,0.874766405,-0.306698119,236,110,126,1,1.515822089,1.170500555,1.794767517,-0.82278296,-0.919549933,0.919549933,1.794767517,1.170500555,1,0,0
1513,7,74,12,48,50,0,5913.826,50,1751.437,LESS,-740,3096,2356,6,1,2,0.187481692,2,-1.222253018,-0.262114121,0.361637045,98,48,50,1,-1.236591704,-1.248533925,-1.170500555,1.14207187,-0.325862841,0.325862841,-1.170500555,-1.248533925,1,1,0
1514,7,75,32,80,77,0,2326.993,80,1575.891,LESS,210,1584,1794,2,2,-3,-0.281222538,3,-1.047645444,0.874766405,-0.639600767,157,80,77,0,-0.059835082,0,-0.117050055,-0.82278296,0.59873181,0.59873181,-0.117050055,0,1,0,1
1515,7,76,43,117,110,0,10471.065,20,893.384,LESS,-5722,7816,2094,4,1,-7,-0.656185922,7,-0.349215148,-1.398994648,1.633756489,227,117,110,0,1.336316841,1.443617351,1.170500555,0.159644455,-5.174631845,5.174631845,1.170500555,1.443617351,0,1,0
1516,7,77,40,80,64,1,3836.047,40,2492.894,LESS,-570,2046,1476,5,2,-16,-1.499853537,16,1.222253018,-0.641074297,-0.218359542,144,80,64,0,-0.31912044,0,-0.624266962,0.650858162,-0.160409062,0.160409062,-0.624266962,0,0,1,1
1517,7,78,31,80,78,0,3412.04,30,1692.656,LESS,-2122,3142,1020,4,1,-2,-0.187481692,2,-1.222253018,-1.020034473,-0.33671795,158,80,78,0,-0.039890055,0,-0.07803337,0.159644455,-1.670904745,1.670904745,-0.07803337,0,0,1,0
1518,7,79,46,124,110,1,10925.699,40,966.459,LESS,-2170,6080,3910,6,2,-14,-1.312371845,14,0.87303787,-0.641074297,1.760664196,234,124,110,0,1.475932034,1.716734147,1.170500555,1.14207187,-1.717621106,1.717621106,1.170500555,1.716734147,0,1,0
1519,7,80,58,92,110,0,7813.467,60,1725.102,LESS,-3462,5352,1890,4,1,18,1.687335229,18,1.571468165,0.116846054,0.891907731,202,92,110,1,0.837691154,0.468200222,1.170500555,0.159644455,-2.975069832,2.975069832,1.170500555,0.468200222,1,1,0
1520,7,81,48,128,110,0,4146.132,70,1034.434,MORE,202,2106,2308,4,2,-18,-1.687335229,18,1.571468165,0.49580623,-0.131801616,238,128,110,1,1.555712144,1.872800887,1.170500555,0.159644455,0.59094575,0.59094575,1.170500555,1.872800887,1,1,1
1521,7,82,8,50,58,1,5066.16,80,1168.707,MORE,-1188,3198,2010,3,2,8,0.749926769,8,-0.174607574,0.874766405,0.125017372,108,50,58,0,-1.037141429,-1.170500555,-0.858367073,-0.331569253,-0.761882214,0.761882214,-0.858367073,-1.170500555,1,1,0
1522,7,83,4,54,50,1,2065.108,70,1846.702,MORE,340,676,1016,1,2,-4,-0.374963384,4,-0.87303787,0.49580623,-0.712704021,104,54,50,1,-1.116921539,-1.014433814,-1.170500555,-1.313996667,0.725255289,0.725255289,-1.170500555,-1.014433814,1,0,1
1523,7,84,37,80,69,0,2471.352,70,1855.221,MORE,-1408,1984,576,2,1,-11,-1.031149307,11,0.349215148,0.49580623,-0.599304023,149,80,69,1,-0.219395302,0,-0.429183537,-0.82278296,-0.97599887,0.97599887,-0.429183537,0,1,0,0
1524,7,85,52,105,110,0,14248.641,20,1614.264,MORE,-1334,7486,6152,10,1,5,0.46870423,5,-0.698430296,-1.398994648,2.688238793,215,105,110,0,1.096976512,0.975417129,1.170500555,3.106926699,-0.903977813,0.903977813,1.170500555,0.975417129,0,1,0
1525,7,86,5,55,50,0,7423.447,40,1600.186,MORE,-1752,4216,2464,5,1,-5,-0.46870423,5,-0.698430296,-0.641074297,0.783036543,105,55,50,1,-1.096976512,-0.975417129,-1.170500555,0.650858162,-1.310799459,1.310799459,-1.170500555,-0.975417129,0,1,0
1526,7,87,30,96,80,1,5118.518,40,938.655,MORE,-814,2668,1854,5,2,-16,-1.499853537,16,1.222253018,-0.641074297,0.139632719,176,96,80,1,0.31912044,0.624266962,0,0.650858162,-0.397883898,0.397883898,0,0.624266962,0,1,0
1527,7,88,33,80,75,1,7975.717,80,1354.626,MORE,-66,3798,3732,7,2,-5,-0.46870423,5,-0.698430296,0.874766405,0.937198615,155,80,75,1,-0.099725137,0,-0.195083426,1.633285577,0.330112732,0.330112732,-0.195083426,0,1,1,1
1528,7,89,48,110,128,1,12748.498,70,1113.254,MORE,1028,5348,6376,5,2,18,1.687335229,18,1.571468165,0.49580623,2.269485008,238,110,128,0,1.555712144,1.170500555,1.872800887,0.650858162,1.394856468,1.394856468,1.872800887,1.170500555,0,1,1
1529,7,90,9,59,50,1,1561.601,80,1587.999,MORE,534,594,1128,1,2,-9,-0.843667615,9,0,0.874766405,-0.853254263,109,59,50,1,-1.017196402,-0.819350388,-1.170500555,-1.313996667,0.914067249,0.914067249,-1.170500555,-0.819350388,1,0,1
1530,7,91,44,110,119,1,2412.444,90,760.754,MORE,132,1162,1294,3,2,9,0.843667615,9,0,1.253726581,-0.615747754,229,110,119,0,1.376206896,1.170500555,1.521650721,-0.331569253,0.522817723,0.522817723,1.521650721,1.170500555,1,1,1
1531,7,92,2,52,50,0,4049.958,30,1714.741,MORE,-870,2292,1422,4,1,-2,-0.187481692,2,-1.222253018,-1.020034473,-0.158647874,102,52,50,1,-1.156811594,-1.092467184,-1.170500555,0.159644455,-0.45238632,0.45238632,-1.170500555,-1.092467184,0,1,0
1532,7,93,8,58,50,0,6057.979,40,1285.614,MORE,-472,2962,2490,6,1,-8,-0.749926769,8,-0.174607574,-0.641074297,0.401876285,108,58,50,1,-1.037141429,-0.858367073,-1.170500555,1.14207187,-0.065029824,0.065029824,-1.170500555,-0.858367073,0,1,0
1533,7,94,44,119,110,1,5368.815,60,1295.725,MORE,760,2220,2980,5,2,-9,-0.843667615,9,0,0.116846054,0.209501269,229,119,110,1,1.376206896,1.521650721,1.170500555,0.650858162,1.13402345,1.13402345,1.170500555,1.521650721,0,1,1
1534,7,95,34,74,80,1,2718.774,70,1072.487,MORE,346,1142,1488,3,2,6,0.562445076,6,-0.523822722,0.49580623,-0.530238008,154,74,80,0,-0.119670165,-0.234100111,0,-0.331569253,0.731094834,0.731094834,0,-0.234100111,1,0,1
1535,7,96,24,86,80,1,4263.372,50,1245.65,MORE,42,1970,2012,3,2,-6,-0.562445076,6,-0.523822722,-0.262114121,-0.09907494,166,86,80,1,0.119670165,0.234100111,0,-0.331569253,0.435224545,0.435224545,0,0.234100111,0,0,1
1536,7,97,39,66,80,1,1263.261,80,1406.108,MORE,820,550,1370,1,2,14,1.312371845,14,0.87303787,0.874766405,-0.93653366,146,66,80,0,-0.279230385,-0.546233592,0,-1.313996667,1.192418902,1.192418902,0,-0.546233592,1,0,1
1537,7,98,9,50,59,1,1384.323,80,1985.567,MORE,2004,582,2586,1,2,9,0.843667615,9,0,0.874766405,-0.902740101,109,50,59,0,-1.017196402,-1.170500555,-0.819350388,-1.313996667,2.344755815,2.344755815,-0.819350388,-1.170500555,1,0,1
1538,7,99,57,94,110,1,3093.112,70,894.366,MORE,446,1424,1870,3,2,16,1.499853537,16,1.222253018,0.49580623,-0.425744334,204,94,110,0,0.877581209,0.546233592,1.170500555,-0.331569253,0.828420587,0.828420587,1.170500555,0.546233592,1,0,1
1539,7,100,60,110,87,0,4106.658,60,1591.075,MORE,-606,2354,1748,5,2,-23,-2.15603946,23,2.444506035,0.116846054,-0.14282049,197,110,87,1,0.737966017,1.170500555,0.273116796,0.650858162,-0.195446333,0.195446333,0.273116796,1.170500555,0,1,0
1540,7,101,33,75,80,1,8186.085,30,1436.178,MORE,274,3598,3872,7,2,5,0.46870423,5,-0.698430296,-1.020034473,0.995921281,155,75,80,0,-0.099725137,-0.195083426,0,1.633285577,0.661020292,0.661020292,0,-0.195083426,0,1,1
1541,7,102,15,50,45,1,13449.288,20,1104.007,MORE,-1562,6862,5300,11,2,-5,-0.46870423,5,-0.698430296,-1.398994648,2.465105336,95,50,45,1,-1.296426786,-1.170500555,-1.36558398,3.598140407,-1.125880529,1.125880529,-1.36558398,-1.170500555,0,1,0
1542,7,103,59,89,110,1,3480.991,50,1142.065,MORE,-556,1854,1298,3,2,21,1.968557767,21,2.095290887,-0.262114121,-0.31747079,199,89,110,0,0.777856072,0.351150166,1.170500555,-0.331569253,-0.146783456,0.146783456,1.170500555,0.351150166,0,0,0
1543,7,104,29,80,94,1,3189.641,70,1235.786,MORE,988,1470,2458,3,2,14,1.312371845,14,0.87303787,0.49580623,-0.39879898,174,80,94,0,0.279230385,0,0.546233592,-0.331569253,1.355926167,1.355926167,0.546233592,0,1,0,1
1544,7,105,55,110,98,0,2569.138,90,1123.823,MORE,-120,1572,1452,2,2,-12,-1.124890153,12,0.523822722,1.253726581,-0.572007787,208,110,98,1,0.957361319,1.170500555,0.702300333,-0.82278296,0.277556826,0.277556826,0.702300333,1.170500555,1,0,0
1545,7,106,29,94,80,0,13104.227,20,1359,MORE,-1998,6844,4846,8,1,-14,-1.312371845,14,0.87303787,-1.398994648,2.368784119,174,94,80,1,0.279230385,0.546233592,0,2.124499285,-1.550220811,1.550220811,0,0.546233592,0,1,0
1546,7,107,57,110,94,0,2316.53,80,751.564,MORE,-372,1462,1090,2,2,-16,-1.499853537,16,1.222253018,0.874766405,-0.642521435,204,110,94,1,0.877581209,1.170500555,0.546233592,-0.82278296,0.032295929,0.032295929,0.546233592,1.170500555,1,0,0
1547,7,108,39,80,66,0,2093.287,70,1068.941,MORE,-40,1360,1320,2,2,-14,-1.312371845,14,0.87303787,0.49580623,-0.704838062,146,80,66,1,-0.279230385,0,-0.546233592,-0.82278296,0.355417428,0.355417428,-0.546233592,0,1,0,1
1548,7,109,4,50,54,0,4197.348,30,2314.072,MORE,-746,2218,1472,4,1,4,0.374963384,4,-0.87303787,-1.020034473,-0.11750505,104,50,54,0,-1.116921539,-1.170500555,-1.014433814,0.159644455,-0.331702386,0.331702386,-1.014433814,-1.170500555,0,1,0
1549,7,110,55,98,110,1,1885.133,80,3219.39,MORE,324,1668,1992,3,2,12,1.124890153,12,0.523822722,0.874766405,-0.762942706,208,98,110,0,0.957361319,0.702300333,1.170500555,-0.331569253,0.709683168,0.709683168,1.170500555,0.702300333,1,0,1
1550,7,111,2,50,52,1,2367.676,40,2105.622,MORE,-432,1642,1210,3,1,2,0.187481692,2,-1.222253018,-0.641074297,-0.628244409,102,50,52,0,-1.156811594,-1.170500555,-1.092467184,-0.331569253,-0.026099523,0.026099523,-1.092467184,-1.170500555,0,0,0
1551,7,112,59,110,89,0,2318.676,50,1189.63,MORE,-472,1436,964,3,2,-21,-1.968557767,21,2.095290887,-0.262114121,-0.641922396,199,110,89,1,0.777856072,1.170500555,0.351150166,-0.331569253,-0.065029824,0.065029824,0.351150166,1.170500555,0,0,0
1552,7,113,60,87,110,1,2718.215,60,1179.095,MORE,-142,1256,1114,3,2,23,2.15603946,23,2.444506035,0.116846054,-0.530394049,197,87,110,0,0.737966017,0.273116796,1.170500555,-0.331569253,0.25614516,0.25614516,1.170500555,0.273116796,0,0,0
1553,7,114,52,110,105,0,4299.052,60,1130.079,MORE,-790,2336,1546,4,1,-5,-0.46870423,5,-0.698430296,0.116846054,-0.089115133,215,110,105,1,1.096976512,1.170500555,0.975417129,0.159644455,-0.374525718,0.374525718,0.975417129,1.170500555,0,1,0
1554,7,115,30,80,96,1,4727.753,80,1938.915,MORE,-2060,3524,1464,1,2,16,1.499853537,16,1.222253018,0.874766405,0.03055357,176,80,96,0,0.31912044,0,0.624266962,-1.313996667,-1.610562778,1.610562778,0.624266962,0,1,0,0
1555,7,116,24,80,86,1,2908.156,80,828.129,MORE,294,1364,1658,3,2,6,0.562445076,6,-0.523822722,0.874766405,-0.477373428,166,80,86,0,0.119670165,0,0.234100111,-0.331569253,0.680485442,0.680485442,0.234100111,0,1,0,1
1556,7,117,5,50,55,1,1443.693,80,1463.03,MORE,700,590,1290,1,2,5,0.46870423,5,-0.698430296,0.874766405,-0.886167406,105,50,55,0,-1.096976512,-1.170500555,-0.975417129,-1.313996667,1.075627999,1.075627999,-0.975417129,-1.170500555,1,0,1
1557,7,118,34,80,74,0,2914.18,50,1059.379,MORE,-782,1770,988,4,1,-6,-0.562445076,6,-0.523822722,-0.262114121,-0.475691874,154,80,74,1,-0.119670165,0,-0.234100111,0.159644455,-0.366739657,0.366739657,-0.234100111,0,0,1,0
1558,7,119,15,45,50,1,5322.768,80,1392.804,MORE,1434,2172,3606,5,2,5,0.46870423,5,-0.698430296,0.874766405,0.196647591,95,45,50,0,-1.296426786,-1.36558398,-1.170500555,0.650858162,1.789999024,1.789999024,-1.170500555,-1.36558398,1,1,1
1559,7,120,37,69,80,1,2847.647,100,1951.381,MORE,1682,1460,3142,2,2,11,1.031149307,11,0.349215148,1.632686757,-0.494264067,149,69,80,0,-0.219395302,-0.429183537,0,-0.82278296,2.031366891,2.031366891,0,-0.429183537,1,0,1
1560,7,121,48,128,110,1,5965.564,10,1197.907,LESS,-380,2800,2420,5,1,-18,-1.687335229,18,1.571468165,-1.777954824,0.376079323,238,128,110,0,1.555712144,1.872800887,1.170500555,0.650858162,0.024509869,0.024509869,1.170500555,1.872800887,0,1,1
1561,7,122,8,50,58,0,3822.554,50,1582.403,LESS,-772,2238,1466,5,1,8,0.749926769,8,-0.174607574,-0.262114121,-0.222126013,108,50,58,1,-1.037141429,-1.170500555,-0.858367073,0.650858162,-0.357007082,0.357007082,-0.858367073,-1.170500555,1,1,0
1562,7,123,4,54,50,1,4079.596,0,2677.711,LESS,-890,3020,2130,3,1,-4,-0.374963384,4,-0.87303787,-2.156914999,-0.150374647,104,54,50,0,-1.116921539,-1.014433814,-1.170500555,-0.331569253,-0.47185147,0.47185147,-1.170500555,-1.014433814,0,0,0
1563,7,124,37,80,69,1,9497.507,10,1380.584,LESS,68,4822,4890,7,1,-11,-1.031149307,11,0.349215148,-1.777954824,1.361994999,149,80,69,0,-0.219395302,0,-0.429183537,1.633285577,0.460529241,0.460529241,-0.429183537,0,0,1,1
1564,7,125,52,105,110,0,6977.591,50,1322.615,LESS,-1124,3584,2460,3,1,5,0.46870423,5,-0.698430296,-0.262114121,0.65857915,215,105,110,1,1.096976512,0.975417129,1.170500555,-0.331569253,-0.699593732,0.699593732,1.170500555,0.975417129,0,0,0
1565,7,126,5,55,50,0,2314.086,70,821.887,LESS,-1088,1708,620,2,2,-5,-0.46870423,5,-0.698430296,0.49580623,-0.64320366,105,55,50,0,-1.096976512,-0.975417129,-1.170500555,-0.82278296,-0.664556461,0.664556461,-1.170500555,-0.975417129,1,0,0
1566,7,127,30,96,80,1,2606.052,80,1823.061,LESS,874,1266,2140,3,2,-16,-1.499853537,16,1.222253018,0.874766405,-0.561703518,176,96,80,0,0.31912044,0.624266962,0,-0.331569253,1.244974809,1.244974809,0,0.624266962,1,0,1
1567,7,128,33,80,75,0,1906.373,60,1061.419,LESS,-224,1236,1012,3,2,-5,-0.46870423,5,-0.698430296,0.116846054,-0.757013718,155,80,75,0,-0.099725137,0,-0.195083426,-0.331569253,0.176338043,0.176338043,-0.195083426,0,1,0,1
1568,7,129,48,110,128,1,3149.876,10,1667.041,LESS,-506,2076,1570,3,1,18,1.687335229,18,1.571468165,-1.777954824,-0.409899084,238,110,128,1,1.555712144,1.170500555,1.872800887,-0.331569253,-0.09812058,0.09812058,1.872800887,1.170500555,0,0,1
1569,7,130,9,59,50,1,1323.84,10,4525.71,LESS,-1068,1810,742,1,1,-9,-0.843667615,9,0,-1.777954824,-0.919623482,109,59,50,0,-1.017196402,-0.819350388,-1.170500555,-1.313996667,-0.64509131,0.64509131,-1.170500555,-0.819350388,0,0,0
1570,7,131,44,110,119,0,2000.422,90,1720.988,LESS,-114,1454,1340,2,2,9,0.843667615,9,0,1.253726581,-0.730760638,229,110,119,1,1.376206896,1.170500555,1.521650721,-0.82278296,0.283396371,0.283396371,1.521650721,1.170500555,1,0,1
1571,7,132,2,52,50,1,5809.339,10,1357.771,LESS,-650,2850,2200,4,1,-2,-0.187481692,2,-1.222253018,-1.777954824,0.332470274,102,52,50,0,-1.156811594,-1.092467184,-1.170500555,0.159644455,-0.238269664,0.238269664,-1.170500555,-1.092467184,0,1,1
1572,7,133,8,58,50,1,11412.856,20,1323.549,LESS,-872,5518,4646,9,2,-8,-0.749926769,8,-0.174607574,-1.398994648,1.896650457,108,58,50,0,-1.037141429,-0.858367073,-1.170500555,2.615712992,-0.454332835,0.454332835,-1.170500555,-0.858367073,0,1,0
1573,7,134,44,119,110,0,4894.394,30,1349.78,LESS,-1674,3058,1384,4,1,-9,-0.843667615,9,0,-1.020034473,0.077070168,229,119,110,0,1.376206896,1.521650721,1.170500555,0.159644455,-1.234885372,1.234885372,1.170500555,1.521650721,0,1,0
1574,7,135,34,74,80,0,1918.664,100,952.38,LESS,12,1316,1328,3,2,6,0.562445076,6,-0.523822722,1.632686757,-0.753582777,154,74,80,1,-0.119670165,-0.234100111,0,-0.331569253,0.40602682,0.40602682,0,-0.234100111,1,0,1
1575,7,136,24,86,80,1,16962.564,10,1101.78,LESS,-2554,9216,6662,10,1,-6,-0.562445076,6,-0.523822722,-1.777954824,3.445810257,166,86,80,0,0.119670165,0.234100111,0,3.106926699,-2.091351997,2.091351997,0,0.234100111,0,1,0
1576,7,137,39,66,80,0,2624.68,50,1527.762,LESS,68,1446,1514,4,2,14,1.312371845,14,0.87303787,-0.262114121,-0.55650365,146,66,80,1,-0.279230385,-0.546233592,0,0.159644455,0.460529241,0.460529241,0,-0.546233592,0,1,1
1577,7,138,9,50,59,0,1981.838,80,778.637,LESS,-724,1416,692,2,2,9,0.843667615,9,0,0.874766405,-0.735948223,109,50,59,1,-1.017196402,-1.170500555,-0.819350388,-0.82278296,-0.310290721,0.310290721,-0.819350388,-1.170500555,1,0,0
1578,7,139,57,94,110,0,1826.308,100,1206.331,LESS,190,1212,1402,2,2,16,1.499853537,16,1.222253018,1.632686757,-0.779363269,204,94,110,1,0.877581209,0.546233592,1.170500555,-0.82278296,0.57926666,0.57926666,1.170500555,0.546233592,1,0,1
1579,7,140,60,110,87,1,2720.901,80,1179.662,LESS,1212,1158,2370,3,2,-23,-2.15603946,23,2.444506035,0.874766405,-0.529644272,197,110,87,0,0.737966017,1.170500555,0.273116796,-0.331569253,1.573935853,1.573935853,0.273116796,1.170500555,1,0,1
1580,7,141,33,75,80,0,7352.448,40,1132.214,LESS,-208,3434,3226,7,1,5,0.46870423,5,-0.698430296,-0.641074297,0.763217699,155,75,80,1,-0.099725137,-0.195083426,0,1.633285577,0.191910164,0.191910164,0,-0.195083426,0,1,1
1581,7,142,15,50,45,1,7470.792,10,1117.349,LESS,372,3154,3526,7,1,-5,-0.46870423,5,-0.698430296,-1.777954824,0.796252548,95,50,45,0,-1.296426786,-1.170500555,-1.36558398,1.633285577,0.75639953,0.75639953,-1.36558398,-1.170500555,0,1,1
1582,7,143,59,89,110,0,1978.485,90,1192.351,LESS,298,1186,1484,2,2,21,1.968557767,21,2.095290887,1.253726581,-0.736884188,199,89,110,1,0.777856072,0.351150166,1.170500555,-0.82278296,0.684378473,0.684378473,1.170500555,0.351150166,1,0,1
1583,7,144,29,80,94,0,1912.798,90,1395.972,LESS,148,1398,1546,3,2,14,1.312371845,14,0.87303787,1.253726581,-0.755220227,174,80,94,1,0.279230385,0,0.546233592,-0.331569253,0.538389843,0.538389843,0.546233592,0,1,0,1
1584,7,145,55,110,98,1,12046.814,30,7237.475,LESS,2228,5648,7876,8,1,-12,-1.124890153,12,0.523822722,-1.020034473,2.073615128,208,110,98,0,0.957361319,1.170500555,0.702300333,2.124499285,2.562765501,2.562765501,0.702300333,1.170500555,0,1,1
1585,7,146,29,94,80,0,3841.352,10,1025.693,LESS,-1426,2642,1216,4,1,-14,-1.312371845,14,0.87303787,-1.777954824,-0.216878691,174,94,80,0,0.279230385,0.546233592,0,0.159644455,-0.993517505,0.993517505,0,0.546233592,0,1,0
1586,7,147,57,110,94,1,3467.74,70,2409.044,LESS,618,1450,2068,3,2,-16,-1.499853537,16,1.222253018,0.49580623,-0.321169708,204,110,94,0,0.877581209,1.170500555,0.546233592,-0.331569253,0.995820881,0.995820881,0.546233592,1.170500555,1,0,1
1587,7,148,39,80,66,1,12776.036,30,1815.827,LESS,-958,6318,5360,11,2,-14,-1.312371845,14,0.87303787,-1.020034473,2.277172037,146,80,66,0,-0.279230385,0,-0.546233592,3.598140407,-0.538032982,0.538032982,-0.546233592,0,0,1,0
1588,7,149,4,50,54,0,2286.018,80,686.633,LESS,-576,1538,962,2,2,4,0.374963384,4,-0.87303787,0.874766405,-0.651038634,104,50,54,1,-1.116921539,-1.170500555,-1.014433814,-0.82278296,-0.166248607,0.166248607,-1.014433814,-1.170500555,1,0,1
1589,7,150,55,98,110,0,5683.752,70,1878.777,LESS,-728,2408,1680,3,2,12,1.124890153,12,0.523822722,0.49580623,0.297413595,208,98,110,1,0.957361319,0.702300333,1.170500555,-0.331569253,-0.314183751,0.314183751,1.170500555,0.702300333,1,0,0
1590,7,151,2,50,52,1,2816.834,70,2315.8,LESS,24,1152,1176,2,2,2,0.187481692,2,-1.222253018,0.49580623,-0.502865287,102,50,52,1,-1.156811594,-1.170500555,-1.092467184,-0.82278296,0.41770591,0.41770591,-1.092467184,-1.170500555,1,0,1
1591,7,152,59,110,89,1,2519.755,80,1278.614,LESS,496,1248,1744,3,2,-21,-1.968557767,21,2.095290887,0.874766405,-0.585792685,199,110,89,0,0.777856072,1.170500555,0.351150166,-0.331569253,0.877083463,0.877083463,0.351150166,1.170500555,1,0,1
1592,7,153,60,87,110,0,3017.106,80,1942.479,LESS,-750,2124,1374,4,2,23,2.15603946,23,2.444506035,0.874766405,-0.446960845,197,87,110,1,0.737966017,0.273116796,1.170500555,0.159644455,-0.335595417,0.335595417,1.170500555,0.273116796,1,1,0
1593,7,154,52,110,105,0,2250.793,90,757.325,LESS,-772,1596,824,2,2,-5,-0.46870423,5,-0.698430296,1.253726581,-0.660871431,215,110,105,0,1.096976512,1.170500555,0.975417129,-0.82278296,-0.357007082,0.357007082,0.975417129,1.170500555,1,0,0
1594,7,155,30,80,96,0,3324.625,90,1215.812,LESS,-1514,2712,1198,2,2,16,1.499853537,16,1.222253018,1.253726581,-0.361119198,176,80,96,1,0.31912044,0,0.624266962,-0.82278296,-1.079164168,1.079164168,0.624266962,0,1,0,0
1595,7,156,24,80,86,0,2641.159,50,1748.693,LESS,-1584,2186,602,2,1,6,0.562445076,6,-0.523822722,-0.262114121,-0.551903659,166,80,86,1,0.119670165,0,0.234100111,-0.82278296,-1.147292195,1.147292195,0.234100111,0,0,0,0
1596,7,157,5,50,55,0,3210.068,30,1251.327,LESS,-90,1678,1588,4,1,5,0.46870423,5,-0.698430296,-1.020034473,-0.393096934,105,50,55,1,-1.096976512,-1.170500555,-0.975417129,0.159644455,0.306754552,0.306754552,-0.975417129,-1.170500555,0,1,1
1597,7,158,34,80,74,0,3212.384,70,818.044,LESS,-656,1820,1164,4,2,-6,-0.562445076,6,-0.523822722,0.49580623,-0.39245044,154,80,74,0,-0.119670165,0,-0.234100111,0.159644455,-0.244109209,0.244109209,-0.234100111,0,1,1,1
1598,7,159,15,45,50,0,1866.3,100,2208.612,LESS,524,1234,1758,2,2,5,0.46870423,5,-0.698430296,1.632686757,-0.768199799,95,45,50,1,-1.296426786,-1.36558398,-1.170500555,-0.82278296,0.904334674,0.904334674,-1.170500555,-1.36558398,1,0,1
1599,7,160,37,69,80,0,3729.593,60,1462.908,LESS,-1140,2450,1310,4,2,11,1.031149307,11,0.349215148,0.116846054,-0.248075386,149,69,80,1,-0.219395302,-0.429183537,0,0.159644455,-0.715165852,0.715165852,0,-0.429183537,1,1,0
1600,7,161,3,50,53,0,4640.823,40,1032.92,MORE,-1850,3074,1224,4,1,3,0.281222538,3,-1.047645444,-0.641074297,0.006287705,103,50,53,0,-1.136866566,-1.170500555,-1.053450499,0.159644455,-1.406178697,1.406178697,-1.053450499,-1.170500555,0,1,0
1601,7,162,20,50,40,0,6168.617,60,960.85,MORE,-2122,3892,1770,4,1,-10,-0.937408461,10,0.174607574,0.116846054,0.432760061,90,50,40,1,-1.396151924,-1.170500555,-1.560667406,0.159644455,-1.670904745,1.670904745,-1.560667406,-1.170500555,0,1,0
1602,7,163,25,80,88,1,1488.768,90,1343.995,MORE,1092,646,1738,1,2,8,0.749926769,8,-0.174607574,1.253726581,-0.873585054,168,80,88,0,0.15956022,0,0.312133481,-1.313996667,1.45714495,1.45714495,0.312133481,0,1,0,1
1603,7,164,42,115,110,1,4667.444,30,1049.818,MORE,384,1932,2316,5,2,-5,-0.46870423,5,-0.698430296,-1.020034473,0.01371876,225,115,110,1,1.296426786,1.36558398,1.170500555,0.650858162,0.76807862,0.76807862,1.170500555,1.36558398,0,1,1
1604,7,165,53,103,110,1,3948.767,70,1355.711,MORE,-1890,2906,1016,3,2,7,0.656185922,7,-0.349215148,0.49580623,-0.186894591,213,103,110,0,1.057086457,0.897383758,1.170500555,-0.331569253,-1.445108998,1.445108998,1.170500555,0.897383758,0,0,0
1605,7,166,26,90,80,0,5512.26,80,1032.782,MORE,-1044,3032,1988,6,2,-10,-0.937408461,10,0.174607574,0.874766405,0.249542876,170,90,80,1,0.199450275,0.390166852,0,1.14207187,-0.62173313,0.62173313,0,0.390166852,1,1,0
1606,7,167,35,80,72,1,2251.195,100,1658.612,MORE,914,1152,2066,3,2,-8,-0.749926769,8,-0.174607574,1.632686757,-0.660759216,152,80,72,1,-0.15956022,0,-0.312133481,-0.331569253,1.28390511,1.28390511,-0.312133481,0,1,0,1
1607,7,168,28,93,80,0,1813.576,80,1808.321,MORE,-132,1102,970,3,2,-13,-1.218630999,13,0.698430296,0.874766405,-0.782917312,173,93,80,1,0.259285357,0.507216907,0,-0.331569253,0.265877736,0.265877736,0,0.507216907,1,0,0
1608,7,169,26,80,90,1,2808.504,90,792.1,MORE,-144,1520,1376,3,2,10,0.937408461,10,0.174607574,1.253726581,-0.505190545,170,80,90,0,0.199450275,0,0.390166852,-0.331569253,0.254198645,0.254198645,0.390166852,0,1,0,0
1609,7,170,25,88,80,1,2526.192,70,845.143,MORE,356,1104,1460,3,2,-8,-0.749926769,8,-0.174607574,0.49580623,-0.583995844,168,88,80,1,0.15956022,0.312133481,0,-0.331569253,0.740827409,0.740827409,0,0.312133481,0,0,1
1610,7,171,36,80,70,1,2766.042,70,1760.242,MORE,298,1164,1462,3,2,-10,-0.937408461,10,0.174607574,0.49580623,-0.517043497,150,80,70,1,-0.199450275,0,-0.390166852,-0.331569253,0.684378473,0.684378473,-0.390166852,0,0,0,1
1611,7,172,28,80,93,1,1804.396,90,1216.2,MORE,148,1360,1508,2,2,13,1.218630999,13,0.698430296,1.253726581,-0.785479841,173,80,93,0,0.259285357,0,0.507216907,-0.82278296,0.538389843,0.538389843,0.507216907,0,1,0,1
1612,7,173,21,82,80,0,4606.689,70,1759.4,MORE,1102,2444,3546,7,2,-2,-0.187481692,2,-1.222253018,0.49580623,-0.003240548,162,82,80,1,0.039890055,0.07803337,0,1.633285577,1.466877525,1.466877525,0,0.07803337,0,1,1
1613,7,174,19,50,41,1,2456.038,40,1173.385,MORE,164,1168,1332,3,2,-9,-0.843667615,9,0,-0.641074297,-0.603578813,91,50,41,1,-1.376206896,-1.170500555,-1.521650721,-0.331569253,0.553961964,0.553961964,-1.521650721,-1.170500555,0,0,1
1614,7,175,56,96,110,1,1383.182,100,1224.429,MORE,1052,498,1550,1,2,14,1.312371845,14,0.87303787,1.632686757,-0.903058603,206,96,110,0,0.917471264,0.624266962,1.170500555,-1.313996667,1.418214649,1.418214649,1.170500555,0.624266962,1,0,1
1615,7,176,23,80,85,1,2131.568,70,92.333,MORE,222,882,1104,3,2,5,0.46870423,5,-0.698430296,0.49580623,-0.694152205,165,80,85,0,0.099725137,0,0.195083426,-0.331569253,0.6104109,0.6104109,0.195083426,0,0,0,1
1616,7,177,10,60,50,0,12090.306,90,1873.781,MORE,-96,1322,1226,2,2,-10,-0.937408461,10,0.174607574,1.253726581,2.085755597,110,60,50,1,-0.997251374,-0.780333703,-1.170500555,-0.82278296,0.300915007,0.300915007,-1.170500555,-0.780333703,1,0,1
1617,7,178,19,41,50,1,3136.882,80,1768.616,MORE,-348,1820,1472,1,2,9,0.843667615,9,0,0.874766405,-0.413526263,91,41,50,0,-1.376206896,-1.521650721,-1.170500555,-1.313996667,0.05565411,0.05565411,-1.170500555,-1.521650721,1,0,0
1618,7,179,56,110,96,1,2550.215,60,1114.28,MORE,294,1134,1428,3,2,-14,-1.312371845,14,0.87303787,0.116846054,-0.577290002,206,110,96,1,0.917471264,1.170500555,0.624266962,-0.331569253,0.680485442,0.680485442,0.624266962,1.170500555,0,0,1
1619,7,180,35,72,80,1,1454.421,90,868.279,MORE,924,530,1454,1,2,8,0.749926769,8,-0.174607574,1.253726581,-0.883172765,152,72,80,0,-0.15956022,-0.312133481,0,-1.313996667,1.293637685,1.293637685,0,-0.312133481,1,0,1
1620,7,181,11,49,50,0,3341.082,30,1567.369,MORE,-1084,2172,1088,4,1,1,0.093740846,1,-1.396860592,-1.020034473,-0.356525349,99,49,50,0,-1.216646676,-1.20951724,-1.170500555,0.159644455,-0.660663431,0.660663431,-1.170500555,-1.20951724,0,1,0
1621,7,182,17,43,50,1,1343.957,80,788.213,MORE,602,544,1146,1,2,7,0.656185922,7,-0.349215148,0.874766405,-0.91400797,93,43,50,0,-1.336316841,-1.443617351,-1.170500555,-1.313996667,0.980248761,0.980248761,-1.170500555,-1.443617351,1,0,1
1622,7,183,1,51,50,0,3425.812,70,1003.183,MORE,-634,1884,1250,4,2,-1,-0.093740846,1,-1.396860592,0.49580623,-0.332873598,101,51,50,1,-1.176756621,-1.131483869,-1.170500555,0.159644455,-0.222697543,0.222697543,-1.170500555,-1.131483869,1,1,0
1623,7,184,41,112,110,0,2157.652,70,849.154,MORE,-450,1612,1162,3,2,-2,-0.187481692,2,-1.222253018,0.49580623,-0.68687105,222,112,110,1,1.236591704,1.248533925,1.170500555,-0.331569253,-0.043618158,0.043618158,1.170500555,1.248533925,1,1,0
1624,7,185,20,40,50,1,1216.547,80,1236.169,MORE,582,440,1022,1,2,10,0.937408461,10,0.174607574,0.874766405,-0.949573526,90,40,50,0,-1.396151924,-1.560667406,-1.170500555,-1.313996667,0.96078361,0.96078361,-1.170500555,-1.560667406,1,0,1
1625,7,186,1,50,51,0,3568.159,60,1150.439,MORE,-1074,2168,1094,4,1,1,0.093740846,1,-1.396860592,0.116846054,-0.293138489,101,50,51,0,-1.176756621,-1.170500555,-1.131483869,0.159644455,-0.650930856,0.650930856,-1.131483869,-1.170500555,0,1,0
1626,7,187,23,85,80,0,3399.878,70,945.821,MORE,-776,1984,1208,4,1,-5,-0.46870423,5,-0.698430296,0.49580623,-0.340112882,165,85,80,1,0.099725137,0.195083426,0,0.159644455,-0.360900112,0.360900112,0,0.195083426,1,1,0
1627,7,188,11,50,49,1,3012.47,70,2069.922,MORE,578,1070,1648,3,2,-1,-0.093740846,1,-1.396860592,0.49580623,-0.44825495,99,50,49,1,-1.216646676,-1.170500555,-1.20951724,-0.331569253,0.95689058,0.95689058,-1.20951724,-1.170500555,1,1,1
1628,7,189,17,50,43,1,2355.175,70,1163.014,MORE,894,1088,1982,3,2,-7,-0.656185922,7,-0.349215148,0.49580623,-0.631733971,93,50,43,1,-1.336316841,-1.170500555,-1.443617351,-0.331569253,1.264439959,1.264439959,-1.443617351,-1.170500555,1,1,1
1629,7,190,21,80,82,0,3481.451,70,1579.263,MORE,-1288,2412,1124,4,1,2,0.187481692,2,-1.222253018,0.49580623,-0.317342384,162,80,82,0,0.039890055,0,0.07803337,0.159644455,-0.859207967,0.859207967,0.07803337,0,1,1,0
1630,7,191,10,50,60,1,1541.305,100,1274.704,MORE,786,778,1564,1,2,10,0.937408461,10,0.174607574,1.632686757,-0.858919741,110,50,60,0,-0.997251374,-1.170500555,-0.780333703,-1.313996667,1.159328146,1.159328146,-0.780333703,-1.170500555,1,0,1
1631,7,192,3,53,50,0,3198.916,70,1240.167,MORE,-342,1850,1508,2,2,-3,-0.281222538,3,-1.047645444,0.49580623,-0.396209932,103,53,50,1,-1.136866566,-1.053450499,-1.170500555,-0.82278296,0.061493655,0.061493655,-1.170500555,-1.053450499,1,0,0
1632,7,193,45,122,110,1,1410.329,80,1012.688,MORE,666,564,1230,1,2,-12,-1.124890153,12,0.523822722,0.874766405,-0.895480719,232,122,110,1,1.436041979,1.638700776,1.170500555,-1.313996667,1.042537243,1.042537243,1.170500555,1.638700776,1,0,1
1633,7,194,38,67,80,1,1376.219,80,1172.171,MORE,1148,500,1648,1,2,13,1.218630999,13,0.698430296,0.874766405,-0.905002272,147,67,80,0,-0.259285357,-0.507216907,0,-1.313996667,1.511647371,1.511647371,0,-0.507216907,1,0,1
1634,7,195,38,80,67,0,2630.958,60,2068.106,MORE,262,1512,1774,4,2,-13,-1.218630999,13,0.698430296,0.116846054,-0.554751193,147,80,67,1,-0.259285357,0,-0.507216907,0.159644455,0.649341202,0.649341202,-0.507216907,0,0,1,1
1635,7,196,36,70,80,1,1467.97,90,1975.197,MORE,1568,542,2110,1,2,10,0.937408461,10,0.174607574,1.253726581,-0.879390662,150,70,80,0,-0.199450275,-0.390166852,0,-1.313996667,1.920415533,1.920415533,0,-0.390166852,1,0,1
1636,7,197,45,110,122,1,1521.71,70,1209.567,MORE,1336,500,1836,1,2,12,1.124890153,12,0.523822722,0.49580623,-0.86438954,232,110,122,0,1.436041979,1.170500555,1.638700776,-1.313996667,1.694619786,1.694619786,1.638700776,1.170500555,1,0,1
1637,7,198,42,110,115,1,1211.751,90,1823.632,MORE,2068,438,2506,1,2,5,0.46870423,5,-0.698430296,1.253726581,-0.950912294,225,110,115,0,1.296426786,1.170500555,1.36558398,-1.313996667,2.407044297,2.407044297,1.36558398,1.170500555,1,0,1
1638,7,199,41,110,112,1,2661.007,80,1040.681,MORE,834,1084,1918,3,2,2,0.187481692,2,-1.222253018,0.874766405,-0.546363238,222,110,112,0,1.236591704,1.170500555,1.248533925,-0.331569253,1.206044507,1.206044507,1.248533925,1.170500555,1,0,1
1639,7,200,53,110,103,0,7486.021,60,1288.694,MORE,-736,4016,3280,6,2,-7,-0.656185922,7,-0.349215148,0.116846054,0.800503611,213,110,103,1,1.057086457,1.170500555,0.897383758,1.14207187,-0.321969811,0.321969811,0.897383758,1.170500555,0,1,0
1640,7,201,3,50,53,0,3734.464,20,1519.637,LESS,-744,2202,1458,4,1,3,0.281222538,3,-1.047645444,-1.398994648,-0.246715683,103,50,53,1,-1.136866566,-1.170500555,-1.053450499,0.159644455,-0.329755871,0.329755871,-1.053450499,-1.170500555,0,0,0
1641,7,202,20,50,40,0,7637.415,20,1814.371,LESS,-742,3652,2910,7,1,-10,-0.937408461,10,0.174607574,-1.398994648,0.842764122,90,50,40,0,-1.396151924,-1.170500555,-1.560667406,1.633285577,-0.327809356,0.327809356,-1.560667406,-1.170500555,0,1,0
1642,7,203,25,80,88,0,1796.056,80,1089.892,LESS,340,1028,1368,2,2,8,0.749926769,8,-0.174607574,0.874766405,-0.78780789,168,80,88,1,0.15956022,0,0.312133481,-0.82278296,0.725255289,0.725255289,0.312133481,0,1,0,1
1643,7,204,42,115,110,0,3441.307,40,1320.048,LESS,-736,1996,1260,4,1,-5,-0.46870423,5,-0.698430296,-0.641074297,-0.328548284,225,115,110,0,1.296426786,1.36558398,1.170500555,0.159644455,-0.321969811,0.321969811,1.170500555,1.36558398,0,1,0
1644,7,205,53,103,110,0,2410.442,50,3028.966,LESS,-1692,2548,856,4,1,7,0.656185922,7,-0.349215148,-0.262114121,-0.616306598,213,103,110,1,1.057086457,0.897383758,1.170500555,0.159644455,-1.252404008,1.252404008,1.170500555,0.897383758,0,1,0
1645,7,206,26,90,80,0,1535.273,10,1334.531,LESS,-1366,1812,446,2,1,-10,-0.937408461,10,0.174607574,-1.777954824,-0.860603529,170,90,80,0,0.199450275,0.390166852,0,-0.82278296,-0.935122054,0.935122054,0,0.390166852,0,0,0
1646,7,207,35,80,72,1,8279.899,20,3743.924,LESS,-310,4038,3728,4,1,-8,-0.749926769,8,-0.174607574,-1.398994648,1.022108762,152,80,72,0,-0.15956022,0,-0.312133481,0.159644455,0.092637896,0.092637896,-0.312133481,0,0,1,1
1647,7,208,28,93,80,0,3695.598,60,2679.066,LESS,-1016,2356,1340,4,2,-13,-1.218630999,13,0.698430296,0.116846054,-0.257564838,173,93,80,0,0.259285357,0.507216907,0,0.159644455,-0.594481919,0.594481919,0,0.507216907,1,1,0
1648,7,209,26,80,90,0,1793.599,100,2393.827,LESS,1328,1122,2450,2,2,10,0.937408461,10,0.174607574,1.632686757,-0.788493743,170,80,90,1,0.199450275,0,0.390166852,-0.82278296,1.686833726,1.686833726,0.390166852,0,1,0,1
1649,7,210,25,88,80,0,2049.971,70,2141.259,LESS,-544,1566,1022,4,1,-8,-0.749926769,8,-0.174607574,0.49580623,-0.716929402,168,88,80,0,0.15956022,0.312133481,0,0.159644455,-0.135104366,0.135104366,0,0.312133481,1,1,1
1650,7,211,36,80,70,1,6454.18,70,1836.634,LESS,314,2882,3196,7,2,-10,-0.937408461,10,0.174607574,0.49580623,0.512472853,150,80,70,0,-0.199450275,0,-0.390166852,1.633285577,0.699950593,0.699950593,-0.390166852,0,1,1,1
1651,7,212,28,80,93,0,1652.482,80,1740.959,LESS,-424,1178,754,2,2,13,1.218630999,13,0.698430296,0.874766405,-0.827885506,173,80,93,1,0.259285357,0,0.507216907,-0.82278296,-0.018313462,0.018313462,0.507216907,0,1,0,1
1652,7,213,21,82,80,1,4602.482,40,1464.032,LESS,490,2120,2610,5,2,-2,-0.187481692,2,-1.222253018,-0.641074297,-0.0044149,162,82,80,0,0.039890055,0.07803337,0,0.650858162,0.871243918,0.871243918,0,0.07803337,0,1,1
1653,7,214,19,50,41,0,2436.168,20,4731.647,LESS,-1024,2114,1090,5,1,-9,-0.843667615,9,0,-1.398994648,-0.609125376,91,50,41,0,-1.376206896,-1.170500555,-1.521650721,0.650858162,-0.602267979,0.602267979,-1.521650721,-1.170500555,0,1,0
1654,7,215,56,96,110,0,3877.406,10,2218.635,LESS,-1646,2900,1254,4,1,14,1.312371845,14,0.87303787,-1.777954824,-0.206814484,206,96,110,1,0.917471264,0.624266962,1.170500555,0.159644455,-1.207634161,1.207634161,1.170500555,0.624266962,0,1,0
1655,7,216,23,80,85,0,1958.408,80,1471.443,LESS,-32,1402,1370,2,2,5,0.46870423,5,-0.698430296,0.874766405,-0.742488534,165,80,85,1,0.099725137,0,0.195083426,-0.82278296,0.363203488,0.363203488,0.195083426,0,1,0,1
1656,7,217,10,60,50,1,7497.271,20,921.951,LESS,-936,3986,3050,7,1,-10,-0.937408461,10,0.174607574,-1.398994648,0.803643965,110,60,50,0,-0.997251374,-0.780333703,-1.170500555,1.633285577,-0.516621317,0.516621317,-1.170500555,-0.780333703,0,1,0
1657,7,218,19,41,50,0,1909.779,100,1652.126,LESS,-378,1414,1036,2,2,9,0.843667615,9,0,1.632686757,-0.756062958,91,41,50,1,-1.376206896,-1.521650721,-1.170500555,-0.82278296,0.026456384,0.026456384,-1.170500555,-1.521650721,1,0,1
1658,7,219,56,110,96,0,2824.291,20,1417.168,LESS,-334,1514,1180,4,1,-14,-1.312371845,14,0.87303787,-1.398994648,-0.500783721,206,110,96,0,0.917471264,1.170500555,0.624266962,0.159644455,0.069279715,0.069279715,0.624266962,1.170500555,0,1,1
1659,7,220,35,72,80,0,1675.047,80,673.994,LESS,-642,1180,538,2,2,8,0.749926769,8,-0.174607574,0.874766405,-0.821586654,152,72,80,1,-0.15956022,-0.312133481,0,-0.82278296,-0.230483604,0.230483604,0,-0.312133481,1,0,1
1660,7,221,11,49,50,0,1788.353,60,1167.817,LESS,-620,1300,680,2,2,1,0.093740846,1,-1.396860592,0.116846054,-0.789958125,99,49,50,1,-1.216646676,-1.20951724,-1.170500555,-0.82278296,-0.209071938,0.209071938,-1.170500555,-1.20951724,1,0,1
1661,7,222,17,43,50,0,1869.825,80,1646.078,LESS,-666,1274,608,2,2,7,0.656185922,7,-0.349215148,0.874766405,-0.767215821,93,43,50,1,-1.336316841,-1.443617351,-1.170500555,-0.82278296,-0.253841784,0.253841784,-1.170500555,-1.443617351,1,0,1
1662,7,223,1,51,50,0,5750.016,80,1912.459,LESS,-1156,4058,2902,4,2,-1,-0.093740846,1,-1.396860592,0.874766405,0.315910699,101,51,50,0,-1.176756621,-1.131483869,-1.170500555,0.159644455,-0.730737973,0.730737973,-1.170500555,-1.131483869,1,1,0
1663,7,224,41,112,110,0,2405.223,20,1001.763,LESS,-1566,2040,474,2,1,-2,-0.187481692,2,-1.222253018,-1.398994648,-0.617763443,222,112,110,0,1.236591704,1.248533925,1.170500555,-0.82278296,-1.129773559,1.129773559,1.170500555,1.248533925,0,0,0
1664,7,225,20,40,50,0,1763.336,60,1634.845,LESS,-736,1238,502,2,1,10,0.937408461,10,0.174607574,0.116846054,-0.796941435,90,40,50,1,-1.396151924,-1.560667406,-1.170500555,-0.82278296,-0.321969811,0.321969811,-1.170500555,-1.560667406,1,0,0
1665,7,226,1,50,51,0,1657.99,70,1777.661,LESS,-1240,1830,590,2,2,1,0.093740846,1,-1.396860592,0.49580623,-0.826347989,101,50,51,1,-1.176756621,-1.170500555,-1.131483869,-0.82278296,-0.812491605,0.812491605,-1.131483869,-1.170500555,1,0,0
1666,7,227,23,85,80,1,2819.102,40,2683.06,LESS,18,1588,1606,3,1,-5,-0.46870423,5,-0.698430296,-0.641074297,-0.502232192,165,85,80,0,0.099725137,0.195083426,0,-0.331569253,0.411866365,0.411866365,0,0.195083426,0,0,1
1667,7,228,11,50,49,0,1617.067,90,1873.583,LESS,504,1072,1576,3,2,-1,-0.093740846,1,-1.396860592,1.253726581,-0.837771341,99,50,49,0,-1.216646676,-1.170500555,-1.20951724,-0.331569253,0.884869523,0.884869523,-1.20951724,-1.170500555,1,0,1
1668,7,229,17,50,43,1,8980.375,40,1078.006,LESS,-2808,5466,2658,7,2,-7,-0.656185922,7,-0.349215148,-0.641074297,1.217641439,93,50,43,0,-1.336316841,-1.170500555,-1.443617351,1.633285577,-2.338559409,2.338559409,-1.443617351,-1.170500555,0,1,0
1669,7,230,21,80,82,0,1706.915,40,1020.273,LESS,-600,1088,488,2,1,2,0.187481692,2,-1.222253018,-0.641074297,-0.812690938,162,80,82,1,0.039890055,0,0.07803337,-0.82278296,-0.189606787,0.189606787,0.07803337,0,0,0,1
1670,7,231,10,50,60,0,1909.258,40,1782.612,LESS,-420,1078,658,2,1,10,0.937408461,10,0.174607574,-0.641074297,-0.756208392,110,50,60,1,-0.997251374,-1.170500555,-0.780333703,-0.82278296,-0.014420432,0.014420432,-0.780333703,-1.170500555,0,0,1
1671,7,232,3,53,50,1,3047.705,60,1869.933,LESS,412,1360,1772,3,2,-3,-0.281222538,3,-1.047645444,0.116846054,-0.438419361,103,53,50,0,-1.136866566,-1.053450499,-1.170500555,-0.331569253,0.795329831,0.795329831,-1.170500555,-1.053450499,1,0,1
1672,7,233,45,122,110,0,1574.966,90,749.96,LESS,-66,1062,996,3,2,-12,-1.124890153,12,0.523822722,1.253726581,-0.849523522,232,122,110,0,1.436041979,1.638700776,1.170500555,-0.331569253,0.330112732,0.330112732,1.170500555,1.638700776,1,0,1
1673,7,234,38,67,80,0,2869.004,50,2641.936,LESS,-724,1736,1012,4,1,13,1.218630999,13,0.698430296,-0.262114121,-0.488302419,147,67,80,1,-0.259285357,-0.507216907,0,0.159644455,-0.310290721,0.310290721,0,-0.507216907,0,1,0
1674,7,235,38,80,67,1,2347.152,40,1332.425,LESS,-78,1276,1198,3,2,-13,-1.218630999,13,0.698430296,-0.641074297,-0.633973531,147,80,67,0,-0.259285357,0,-0.507216907,-0.331569253,0.318433642,0.318433642,-0.507216907,0,0,0,1
1675,7,236,36,70,80,0,4466.404,70,671.713,LESS,-1144,2534,1390,3,2,10,0.937408461,10,0.174607574,0.49580623,-0.042400064,150,70,80,1,-0.199450275,-0.390166852,0,-0.331569253,-0.719058883,0.719058883,0,-0.390166852,1,0,0
1676,7,237,45,110,122,0,3036.197,100,1217.768,LESS,-1342,2402,1060,2,2,12,1.124890153,12,0.523822722,1.632686757,-0.441631734,232,110,122,1,1.436041979,1.170500555,1.638700776,-0.82278296,-0.911763873,0.911763873,1.638700776,1.170500555,1,0,0
1677,7,238,42,110,115,0,5712.335,10,820.631,LESS,-3250,4496,1246,4,1,5,0.46870423,5,-0.698430296,-1.777954824,0.305392328,225,110,115,1,1.296426786,1.170500555,1.36558398,0.159644455,-2.768739236,2.768739236,1.36558398,1.170500555,0,1,0
1678,7,239,41,110,112,0,2082.118,70,935.406,LESS,-796,1356,560,2,2,2,0.187481692,2,-1.222253018,0.49580623,-0.707955806,222,110,112,1,1.236591704,1.170500555,1.248533925,-0.82278296,-0.380365263,0.380365263,1.248533925,1.170500555,1,0,0
1679,7,240,53,110,103,0,5657.609,50,900.427,LESS,360,2552,2912,4,1,-7,-0.656185922,7,-0.349215148,-0.262114121,0.290115971,213,110,103,0,1.057086457,1.170500555,0.897383758,0.159644455,0.744720439,0.744720439,0.897383758,1.170500555,0,1,1
1680,8,1,49,110,131,0,4931.005,74,925.315,LESS,-638,2418,1780,4,1,21,1.968557767,21,2.095290887,1.205502443,1.022143727,241,110,131,1,1.615547226,1.170500555,1.989850943,1.131323875,-0.505436506,0.505436506,1.989850943,1.170500555,1,1,0
1681,8,2,13,47,50,0,2201.311,84,2107.361,LESS,336,1264,1600,2,2,3,0.281222538,3,-1.047645444,1.641357499,-0.415941898,97,47,50,1,-1.256536731,-1.28755061,-1.170500555,-0.465839243,0.748765414,0.748765414,-1.170500555,-1.28755061,1,1,1
1682,8,3,16,50,44,1,3136.24,44,2570.353,LESS,296,1390,1686,4,1,-6,-0.562445076,6,-0.523822722,-0.102062726,0.076607067,94,50,44,0,-1.316371814,-1.170500555,-1.404600665,1.131323875,0.697258148,0.697258148,-1.404600665,-1.170500555,0,1,1
1683,8,4,7,57,50,0,6726.24,34,1276.36,LESS,-378,2846,2468,6,1,-7,-0.656185922,7,-0.349215148,-0.537917782,1.967927997,107,57,50,0,-1.057086457,-0.897383758,-1.170500555,2.728486994,-0.170639279,0.170639279,-1.170500555,-0.897383758,0,1,1
1684,8,5,18,42,50,0,1825.579,64,870.649,LESS,-554,1030,476,2,1,8,0.749926769,8,-0.174607574,0.769647387,-0.613888916,92,42,50,1,-1.356261869,-1.482634036,-1.170500555,-0.465839243,-0.397271248,0.397271248,-1.170500555,-1.482634036,1,0,0
1685,8,6,51,108,110,1,7191.191,24,1526.2,LESS,1512,2726,4238,5,1,2,0.187481692,2,-1.222253018,-0.973772838,2.212878292,218,108,110,1,1.156811594,1.092467184,1.170500555,1.929905435,2.263079025,2.263079025,1.170500555,1.092467184,0,1,1
1686,8,7,31,78,80,0,5022.577,34,2317.064,LESS,-576,2460,1884,6,1,2,0.187481692,2,-1.222253018,-0.537917782,1.070386635,158,78,80,1,-0.039890055,-0.07803337,0,2.728486994,-0.425600244,0.425600244,0,-0.07803337,0,1,0
1687,8,8,58,110,92,1,5351.962,20,2568.405,LESS,-1328,4320,2992,6,1,-18,-1.687335229,18,1.571468165,-1.14811486,1.243916648,202,110,92,0,0.837691154,1.170500555,0.468200222,2.728486994,-1.393936839,1.393936839,0.468200222,1.170500555,0,1,0
1688,8,9,12,50,48,1,6017.398,74,1432.184,LESS,164,2638,2802,5,2,-2,-0.187481692,2,-1.222253018,1.205502443,1.594488523,98,50,48,0,-1.236591704,-1.170500555,-1.248533925,1.929905435,0.527284171,0.527284171,-1.248533925,-1.170500555,1,1,1
1689,8,10,54,110,101,1,4302.345,54,2246.62,LESS,1708,1556,3264,3,2,-9,-0.843667615,9,0,0.33379233,0.690946564,211,110,101,0,1.017196402,1.170500555,0.819350388,0.332742316,2.515464627,2.515464627,0.819350388,1.170500555,1,1,1
1690,8,11,14,46,50,0,3725.712,34,1360.242,LESS,-254,1962,1708,2,1,4,0.374963384,4,-0.87303787,-0.537917782,0.387158803,96,46,50,1,-1.276481759,-1.326567295,-1.170500555,-0.465839243,-0.010966755,0.010966755,-1.170500555,-1.326567295,0,0,1
1691,8,12,22,80,83,1,8632.844,24,1274.414,LESS,174,3662,3836,5,2,3,0.281222538,3,-1.047645444,-0.973772838,2.972384836,163,80,83,1,0.059835082,0,0.117050055,1.929905435,0.540160988,0.540160988,0.117050055,0,0,1,1
1692,8,13,6,50,56,0,3949.768,34,1091.923,LESS,-312,1900,1588,2,1,6,0.562445076,6,-0.523822722,-0.537917782,0.505198302,106,50,56,1,-1.077031484,-1.170500555,-0.936400444,-0.465839243,-0.085652291,0.085652291,-0.936400444,-1.170500555,0,1,1
1693,8,14,13,50,47,1,4871.738,44,1462.76,LESS,-246,2462,2216,3,2,-3,-0.281222538,3,-1.047645444,-0.102062726,0.990920073,97,50,47,0,-1.256536731,-1.170500555,-1.28755061,0.332742316,-0.000665302,0.000665302,-1.28755061,-1.170500555,0,1,1
1694,8,15,46,110,124,0,7526.366,24,2402.152,LESS,-890,3582,2692,3,2,14,1.312371845,14,0.87303787,-0.973772838,2.389458652,234,110,124,1,1.475932034,1.170500555,1.716734147,0.332742316,-0.82993228,0.82993228,1.716734147,1.170500555,0,1,0
1695,8,16,27,91,80,1,4214.918,54,1733.612,LESS,176,2102,2278,3,2,-11,-1.031149307,11,0.349215148,0.33379233,0.644887368,171,91,80,0,0.219395302,0.429183537,0,0.332742316,0.542736351,0.542736351,0,0.429183537,1,1,1
1696,8,17,40,64,80,0,2437.981,64,2063.552,LESS,-1422,2076,654,2,1,16,1.499853537,16,1.222253018,0.769647387,-0.291256961,144,64,80,1,-0.31912044,-0.624266962,0,-0.465839243,-1.514978914,1.514978914,0,-0.624266962,1,0,0
1697,8,18,22,83,80,0,4873.235,44,1345.648,LESS,-622,2692,2070,4,1,-3,-0.281222538,3,-1.047645444,-0.102062726,0.991708738,163,83,80,0,0.059835082,0.117050055,0,1.131323875,-0.4848336,0.4848336,0,0.117050055,0,1,0
1698,8,19,54,101,110,0,4016.557,54,2378.819,LESS,-2140,3408,1268,4,1,9,0.843667615,9,0,0.33379233,0.540384774,211,101,110,1,1.017196402,0.819350388,1.170500555,1.131323875,-2.439534333,2.439534333,1.170500555,0.819350388,0,1,0
1699,8,20,6,56,50,1,7753.638,24,1528.267,LESS,-142,4002,3860,4,1,-6,-0.562445076,6,-0.523822722,-0.973772838,2.509192437,106,56,50,0,-1.077031484,-0.936400444,-1.170500555,1.131323875,0.133253589,0.133253589,-1.170500555,-0.936400444,0,1,1
1700,8,21,18,50,42,0,1978.586,54,2124.277,LESS,-566,1156,590,2,1,-8,-0.749926769,8,-0.174607574,0.33379233,-0.533280186,92,50,42,0,-1.356261869,-1.170500555,-1.482634036,-0.465839243,-0.412723428,0.412723428,-1.482634036,-1.170500555,0,1,0
1701,8,22,43,110,117,0,7250.301,64,1616.402,LESS,-1950,4686,2736,2,1,7,0.656185922,7,-0.349215148,0.769647387,2.244019233,227,110,117,1,1.336316841,1.170500555,1.443617351,-0.465839243,-2.194874821,2.194874821,1.443617351,1.170500555,1,1,0
1702,8,23,32,77,80,0,6621.583,34,1824.555,LESS,-726,3218,2492,3,2,3,0.281222538,3,-1.047645444,-0.537917782,1.912791514,157,77,80,1,-0.059835082,-0.117050055,0,0.332742316,-0.618752491,0.618752491,0,-0.117050055,0,1,0
1703,8,24,27,80,91,0,2099.569,64,1440.452,LESS,-938,1530,592,2,1,11,1.031149307,11,0.349215148,0.769647387,-0.469542671,171,80,91,1,0.219395302,0,0.429183537,-0.465839243,-0.891740999,0.891740999,0.429183537,0,1,1,0
1704,8,25,16,44,50,0,2055.446,84,1337.098,LESS,-474,1216,742,2,2,6,0.562445076,6,-0.523822722,1.641357499,-0.492788006,94,44,50,1,-1.316371814,-1.404600665,-1.170500555,-0.465839243,-0.294256717,0.294256717,-1.170500555,-1.404600665,1,1,1
1705,8,26,7,50,57,0,2333.077,84,2127.344,LESS,-372,1414,1042,2,2,7,0.656185922,7,-0.349215148,1.641357499,-0.346523571,107,50,57,1,-1.057086457,-1.170500555,-0.897383758,-0.465839243,-0.162913189,0.162913189,-0.897383758,-1.170500555,1,1,1
1706,8,27,14,50,46,0,4594.955,64,1333.42,LESS,-426,1966,1540,3,1,-4,-0.374963384,4,-0.87303787,0.769647387,0.845102391,96,50,46,0,-1.276481759,-1.170500555,-1.326567295,0.332742316,-0.232447998,0.232447998,-1.326567295,-1.170500555,1,1,1
1707,8,28,51,110,108,0,9217.327,24,1636.235,LESS,-364,4818,4454,5,1,-2,-0.187481692,2,-1.222253018,-0.973772838,3.280308215,218,110,108,0,1.156811594,1.170500555,1.092467184,1.929905435,-0.152611736,0.152611736,1.092467184,1.170500555,0,1,1
1708,8,29,50,133,110,1,3333.158,24,1401.695,LESS,432,1190,1622,3,2,-23,-2.15603946,23,2.444506035,-0.973772838,0.180349445,243,133,110,0,1.655437281,2.067884313,1.170500555,0.332742316,0.872382851,0.872382851,1.170500555,2.067884313,0,1,1
1709,8,30,49,131,110,1,12462.491,54,2057.634,LESS,-670,5664,4994,6,2,-21,-1.968557767,21,2.095290887,0.33379233,4.989959076,241,131,110,0,1.615547226,1.989850943,1.170500555,2.728486994,-0.546642319,0.546642319,1.170500555,1.989850943,0,1,0
1710,8,31,47,126,110,1,2664.239,64,1915.109,LESS,1158,878,2036,1,2,-16,-1.499853537,16,1.222253018,0.769647387,-0.172057381,236,126,110,0,1.515822089,1.794767517,1.170500555,-1.264420802,1.807239724,1.807239724,1.170500555,1.794767517,1,0,1
1711,8,32,50,110,133,0,10809.408,44,1580.938,LESS,-1980,6286,4306,4,1,23,2.15603946,23,2.444506035,-0.102062726,4.119064793,243,110,133,1,1.655437281,1.170500555,2.067884313,1.131323875,-2.23350527,2.23350527,2.067884313,1.170500555,0,1,0
1712,8,33,47,110,126,0,3254.214,64,1047.154,LESS,-446,1692,1246,4,1,16,1.499853537,16,1.222253018,0.769647387,0.13875935,236,110,126,1,1.515822089,1.170500555,1.794767517,1.131323875,-0.258201631,0.258201631,1.794767517,1.170500555,1,1,1
1713,8,34,12,48,50,0,1827.608,64,1948.463,LESS,-624,1166,542,2,1,2,0.187481692,2,-1.222253018,0.769647387,-0.612819977,98,48,50,1,-1.236591704,-1.248533925,-1.170500555,-0.465839243,-0.487408963,0.487408963,-1.170500555,-1.248533925,1,0,0
1714,8,35,32,80,77,0,6628.51,64,846.639,LESS,662,2682,3344,4,1,-3,-0.281222538,3,-1.047645444,0.769647387,1.916440868,157,80,77,0,-0.059835082,0,-0.117050055,1.131323875,1.168549629,1.168549629,-0.117050055,0,1,1,1
1715,8,36,43,117,110,1,9029.66,54,1685.321,LESS,-78,4454,4376,5,1,-7,-0.656185922,7,-0.349215148,0.33379233,3.181439545,227,117,110,0,1.336316841,1.443617351,1.170500555,1.929905435,0.215665214,0.215665214,1.170500555,1.443617351,1,1,1
1716,8,37,40,80,64,1,8494.599,64,2714.808,LESS,30,3970,4000,7,1,-16,-1.499853537,16,1.222253018,0.769647387,2.899553175,144,80,64,0,-0.31912044,0,-0.624266962,3.527068553,0.354734831,0.354734831,-0.624266962,0,1,1,1
1717,8,38,31,80,78,0,2609.038,54,2289.457,LESS,-1266,1978,712,2,1,-2,-0.187481692,2,-1.222253018,0.33379233,-0.201138943,158,80,78,0,-0.039890055,0,-0.07803337,-0.465839243,-1.314100578,1.314100578,-0.07803337,0,1,0,0
1718,8,39,46,124,110,1,3992.917,4,1374.028,LESS,-460,2420,1960,3,1,-14,-1.312371845,14,0.87303787,-1.84548295,0.527930505,234,124,110,0,1.475932034,1.716734147,1.170500555,0.332742316,-0.276229174,0.276229174,1.170500555,1.716734147,0,1,1
1719,8,40,58,92,110,0,6079.516,44,2203.323,LESS,936,2630,3566,4,1,18,1.687335229,18,1.571468165,-0.102062726,1.627214171,202,92,110,1,0.837691154,0.468200222,1.170500555,1.131323875,1.521374399,1.521374399,1.170500555,0.468200222,0,1,1
1720,8,41,49,110,131,1,4993.562,74,1516.415,MORE,914,1780,2694,4,2,21,1.968557767,21,2.095290887,1.205502443,1.055100653,241,110,131,0,1.615547226,1.170500555,1.989850943,1.131323875,1.493045403,1.493045403,1.989850943,1.170500555,1,1,1
1721,8,42,13,47,50,1,3795.373,24,1723.592,MORE,1088,1096,2184,2,2,3,0.281222538,3,-1.047645444,-0.973772838,0.423858332,97,47,50,0,-1.256536731,-1.28755061,-1.170500555,-0.465839243,1.717102009,1.717102009,-1.170500555,-1.28755061,0,0,1
1722,8,43,16,50,44,1,4768.419,14,1866.708,MORE,530,1986,2516,5,1,-6,-0.562445076,6,-0.523822722,-1.409627894,0.936488489,94,50,44,1,-1.316371814,-1.170500555,-1.404600665,1.929905435,0.998575652,0.998575652,-1.404600665,-1.170500555,0,1,1
1723,8,44,7,57,50,0,7074.001,14,696.277,MORE,-1682,4252,2570,6,1,-7,-0.656185922,7,-0.349215148,-1.409627894,2.151139044,107,57,50,1,-1.057086457,-0.897383758,-1.170500555,2.728486994,-1.849776141,1.849776141,-1.170500555,-0.897383758,0,1,0
1724,8,45,18,42,50,1,7010.269,64,1501.955,MORE,646,2516,3162,4,2,8,0.749926769,8,-0.174607574,0.769647387,2.117563093,92,42,50,0,-1.356261869,-1.482634036,-1.170500555,1.131323875,1.147946723,1.147946723,-1.170500555,-1.482634036,1,1,1
1725,8,46,51,108,110,1,3297.75,64,1961.747,MORE,1550,1224,2774,3,2,2,0.187481692,2,-1.222253018,0.769647387,0.161695436,218,108,110,0,1.156811594,1.092467184,1.170500555,0.332742316,2.312010928,2.312010928,1.170500555,1.092467184,1,1,1
1726,8,47,31,78,80,0,2028.401,4,966.298,MORE,-1110,1730,620,2,1,2,0.187481692,2,-1.222253018,-1.84548295,-0.507036132,158,78,80,0,-0.039890055,-0.07803337,0,-0.465839243,-1.113222241,1.113222241,0,-0.07803337,0,0,0
1727,8,48,58,110,92,0,7001.148,14,2176.115,MORE,-1408,3848,2440,5,1,-18,-1.687335229,18,1.571468165,-1.409627894,2.112757873,202,110,92,1,0.837691154,1.170500555,0.468200222,1.929905435,-1.496951371,1.496951371,0.468200222,1.170500555,0,1,0
1728,8,49,12,50,48,0,1904.903,84,2073.659,MORE,-812,1432,620,2,1,-2,-0.187481692,2,-1.222253018,1.641357499,-0.572098626,98,50,48,1,-1.236591704,-1.170500555,-1.248533925,-0.465839243,-0.729493112,0.729493112,-1.248533925,-1.170500555,1,0,0
1729,8,50,54,110,101,0,6137.828,24,689.951,MORE,-230,2552,2322,5,1,-9,-0.843667615,9,0,-0.973772838,1.657934702,211,110,101,1,1.017196402,1.170500555,0.819350388,1.929905435,0.019937604,0.019937604,0.819350388,1.170500555,0,1,0
1730,8,51,14,46,50,1,1789.591,64,1408.092,MORE,708,562,1270,1,2,4,0.374963384,4,-0.87303787,0.769647387,-0.632848487,96,46,50,0,-1.276481759,-1.326567295,-1.170500555,-1.264420802,1.227782985,1.227782985,-1.170500555,-1.326567295,1,0,1
1731,8,52,22,80,83,1,1607.714,84,964.204,MORE,974,566,1540,2,2,3,0.281222538,3,-1.047645444,1.641357499,-0.728666809,163,80,83,0,0.059835082,0,0.117050055,-0.465839243,1.570306302,1.570306302,0.117050055,0,1,0,1
1732,8,53,6,50,56,1,1430.633,64,1845.498,MORE,-272,1104,832,1,1,6,0.562445076,6,-0.523822722,0.769647387,-0.821958453,106,50,56,0,-1.077031484,-1.170500555,-0.936400444,-1.264420802,-0.034145025,0.034145025,-0.936400444,-1.170500555,1,0,0
1733,8,54,13,50,47,0,1845.803,24,2201.731,MORE,-256,1088,832,2,2,-3,-0.281222538,3,-1.047645444,-0.973772838,-0.603234299,97,50,47,1,-1.256536731,-1.170500555,-1.28755061,-0.465839243,-0.013542119,0.013542119,-1.28755061,-1.170500555,0,0,0
1734,8,55,46,110,124,0,2698.17,24,1727.056,MORE,-396,1408,1012,2,1,14,1.312371845,14,0.87303787,-0.973772838,-0.154181501,234,110,124,0,1.475932034,1.170500555,1.716734147,-0.465839243,-0.193817549,0.193817549,1.716734147,1.170500555,0,0,0
1735,8,56,27,91,80,1,2192.458,24,2150.305,MORE,356,1050,1406,2,1,-11,-1.031149307,11,0.349215148,-0.973772838,-0.420605927,171,91,80,1,0.219395302,0.429183537,0,-0.465839243,0.774519047,0.774519047,0,0.429183537,0,0,1
1736,8,57,40,64,80,1,2213.166,74,688.687,MORE,314,836,1150,3,2,16,1.499853537,16,1.222253018,1.205502443,-0.409696324,144,64,80,0,-0.31912044,-0.624266962,0,0.332742316,0.720436418,0.720436418,0,-0.624266962,1,1,1
1737,8,58,22,83,80,0,2714.831,84,799.848,MORE,-8,1502,1494,2,2,-3,-0.281222538,3,-1.047645444,1.641357499,-0.14540398,163,83,80,1,0.059835082,0.117050055,0,-0.465839243,0.305802929,0.305802929,0,0.117050055,1,1,0
1738,8,59,54,101,110,0,3723.87,24,1608.841,MORE,-122,1674,1552,4,1,9,0.843667615,9,0,-0.973772838,0.386188382,211,101,110,0,1.017196402,0.819350388,1.170500555,1.131323875,0.159007221,0.159007221,1.170500555,0.819350388,0,1,0
1739,8,60,6,56,50,0,2246.661,74,1280.635,MORE,-626,1342,716,2,1,-6,-0.562445076,6,-0.523822722,1.205502443,-0.392050142,106,56,50,1,-1.077031484,-0.936400444,-1.170500555,-0.465839243,-0.489984326,0.489984326,-1.170500555,-0.936400444,1,1,0
1740,8,61,18,50,42,0,3688.427,24,1723.461,MORE,132,1622,1754,4,2,-8,-0.749926769,8,-0.174607574,-0.973772838,0.367515934,92,50,42,1,-1.356261869,-1.170500555,-1.482634036,1.131323875,0.486078359,0.486078359,-1.482634036,-1.170500555,0,1,0
1741,8,62,43,110,117,1,1567.154,14,1225.682,MORE,402,464,866,1,2,7,0.656185922,7,-0.349215148,-1.409627894,-0.750035047,227,110,117,0,1.336316841,1.170500555,1.443617351,-1.264420802,0.833752402,0.833752402,1.443617351,1.170500555,0,0,1
1742,8,63,32,77,80,0,2141.277,24,663.021,MORE,-252,1098,846,2,1,3,0.281222538,3,-1.047645444,-0.973772838,-0.447569631,157,77,80,0,-0.059835082,-0.117050055,0,-0.465839243,-0.008391392,0.008391392,0,-0.117050055,0,1,0
1743,8,64,27,80,91,1,2819.997,14,1465.882,MORE,0,1392,1392,3,1,11,1.031149307,11,0.349215148,-1.409627894,-0.089999341,171,80,91,0,0.219395302,0,0.429183537,0.332742316,0.316104382,0.316104382,0.429183537,0,0,1,0
1744,8,65,16,44,50,1,1751.997,64,1466.815,MORE,370,566,936,1,2,6,0.562445076,6,-0.523822722,0.769647387,-0.652654146,94,44,50,0,-1.316371814,-1.404600665,-1.170500555,-1.264420802,0.79254659,0.79254659,-1.170500555,-1.404600665,1,0,1
1745,8,66,7,50,57,1,1681.426,54,1614.911,MORE,748,418,1166,1,2,7,0.656185922,7,-0.349215148,0.33379233,-0.689833091,107,50,57,0,-1.057086457,-1.170500555,-0.897383758,-1.264420802,1.27929025,1.27929025,-0.897383758,-1.170500555,1,0,1
1746,8,67,14,50,46,1,3260.446,24,1662.742,MORE,136,1478,1614,3,1,-4,-0.374963384,4,-0.87303787,-0.973772838,0.142042557,96,50,46,1,-1.276481759,-1.170500555,-1.326567295,0.332742316,0.491229085,0.491229085,-1.326567295,-1.170500555,0,1,1
1747,8,68,51,110,108,1,2745.432,54,1068.561,MORE,214,1090,1304,3,2,-2,-0.187481692,2,-1.222253018,0.33379233,-0.129282445,218,110,108,1,1.156811594,1.170500555,1.092467184,0.332742316,0.591668253,0.591668253,1.092467184,1.170500555,1,1,1
1748,8,69,50,133,110,1,3064.343,44,1983.687,MORE,654,1326,1980,3,2,-23,-2.15603946,23,2.444506035,-0.102062726,0.038729546,243,133,110,1,1.655437281,2.067884313,1.170500555,0.332742316,1.158248176,1.158248176,1.170500555,2.067884313,0,1,1
1749,8,70,49,131,110,0,3042.958,64,1176.042,MORE,-404,1538,1134,2,1,-21,-1.968557767,21,2.095290887,0.769647387,0.027463279,241,131,110,1,1.615547226,1.989850943,1.170500555,-0.465839243,-0.204119002,0.204119002,1.170500555,1.989850943,1,1,0
1750,8,71,47,126,110,0,2689.534,64,1293.446,MORE,-356,1248,892,2,1,-16,-1.499853537,16,1.222253018,0.769647387,-0.158731208,236,126,110,1,1.515822089,1.794767517,1.170500555,-0.465839243,-0.142310283,0.142310283,1.170500555,1.794767517,1,1,0
1751,8,72,50,110,133,1,3982.511,44,2224.305,MORE,764,1086,1850,1,2,23,2.15603946,23,2.444506035,-0.102062726,0.522448308,243,110,133,0,1.655437281,1.170500555,2.067884313,-1.264420802,1.299893157,1.299893157,2.067884313,1.170500555,0,0,1
1752,8,73,47,110,126,1,1819.573,74,988.667,MORE,482,710,1192,1,2,16,1.499853537,16,1.222253018,1.205502443,-0.617053059,236,110,126,0,1.515822089,1.170500555,1.794767517,-1.264420802,0.936766934,0.936766934,1.794767517,1.170500555,1,0,1
1753,8,74,12,48,50,1,6171.741,54,1323.166,MORE,48,2684,2732,7,2,2,0.187481692,2,-1.222253018,0.33379233,1.675801099,98,48,50,0,-1.236591704,-1.248533925,-1.170500555,3.527068553,0.377913101,0.377913101,-1.170500555,-1.248533925,1,1,0
1754,8,75,32,80,77,1,1524.247,64,2276.526,MORE,398,632,1030,1,1,-3,-0.281222538,3,-1.047645444,0.769647387,-0.772639757,157,80,77,1,-0.059835082,0,-0.117050055,-1.264420802,0.828601676,0.828601676,-0.117050055,0,1,0,1
1755,8,76,43,117,110,1,4600.759,24,754.523,MORE,770,1796,2566,3,1,-7,-0.656185922,7,-0.349215148,-0.973772838,0.848160114,227,117,110,1,1.336316841,1.443617351,1.170500555,0.332742316,1.307619247,1.307619247,1.170500555,1.443617351,0,1,1
1756,8,77,40,80,64,0,2025.769,64,1350.939,MORE,-374,1084,710,2,1,-16,-1.499853537,16,1.222253018,0.769647387,-0.50842275,144,80,64,1,-0.31912044,0,-0.624266962,-0.465839243,-0.165488552,0.165488552,-0.624266962,0,1,1,0
1757,8,78,31,80,78,1,1791.142,64,2404.707,MORE,-94,1356,1262,1,1,-2,-0.187481692,2,-1.222253018,0.769647387,-0.632031373,158,80,78,1,-0.039890055,0,-0.07803337,-1.264420802,0.195062307,0.195062307,-0.07803337,0,1,0,0
1758,8,79,46,124,110,0,2225.989,24,2000.816,MORE,-280,1332,1052,2,1,-14,-1.312371845,14,0.87303787,-0.973772838,-0.402940779,234,124,110,1,1.475932034,1.716734147,1.170500555,-0.465839243,-0.044446478,0.044446478,1.170500555,1.716734147,0,0,0
1759,8,80,58,92,110,0,2391.515,4,1980.087,MORE,-1590,2210,620,2,1,18,1.687335229,18,1.571468165,-1.84548295,-0.315736659,202,92,110,0,0.837691154,0.468200222,1.170500555,-0.465839243,-1.73130943,1.73130943,1.170500555,0.468200222,0,0,0
1760,8,81,48,128,110,0,2798.97,64,1832.279,LESS,300,1568,1868,4,2,-18,-1.687335229,18,1.571468165,0.769647387,-0.101077002,238,128,110,0,1.555712144,1.872800887,1.170500555,1.131323875,0.702408875,0.702408875,1.170500555,1.872800887,1,1,1
1761,8,82,8,50,58,0,1729.804,14,1285.979,LESS,-782,1314,532,2,1,8,0.749926769,8,-0.174607574,-1.409627894,-0.664346092,108,50,58,1,-1.037141429,-1.170500555,-0.858367073,-0.465839243,-0.690862663,0.690862663,-0.858367073,-1.170500555,0,0,0
1762,8,83,4,54,50,0,1877.844,14,1933.26,LESS,-948,1576,628,2,1,-4,-0.374963384,4,-0.87303787,-1.409627894,-0.586354128,104,54,50,0,-1.116921539,-1.014433814,-1.170500555,-0.465839243,-0.904617815,0.904617815,-1.170500555,-1.014433814,0,1,0
1763,8,84,37,80,69,1,3232.736,4,1286.895,LESS,354,1260,1614,3,1,-11,-1.031149307,11,0.349215148,-1.84548295,0.127444088,149,80,69,0,-0.219395302,0,-0.429183537,0.332742316,0.771943683,0.771943683,-0.429183537,0,0,1,1
1764,8,85,52,105,110,0,2248.897,4,1210.043,LESS,-1226,1878,652,2,1,5,0.46870423,5,-0.698430296,-1.84548295,-0.390872149,215,105,110,1,1.096976512,0.975417129,1.170500555,-0.465839243,-1.262593312,1.262593312,1.170500555,0.975417129,0,1,0
1765,8,86,5,55,50,0,2051.915,34,1560.175,LESS,-512,1196,684,2,1,-5,-0.46870423,5,-0.698430296,-0.537917782,-0.494648244,105,55,50,0,-1.096976512,-0.975417129,-1.170500555,-0.465839243,-0.343188619,0.343188619,-1.170500555,-0.975417129,0,1,1
1766,8,87,30,96,80,1,1535.46,54,1587.867,LESS,672,512,1184,1,2,-16,-1.499853537,16,1.222253018,0.33379233,-0.766732408,176,96,80,0,0.31912044,0.624266962,0,-1.264420802,1.181426446,1.181426446,0,0.624266962,1,0,1
1767,8,88,33,80,75,1,3373.361,4,1690.515,LESS,-130,1906,1776,3,1,-5,-0.46870423,5,-0.698430296,-1.84548295,0.201529605,155,80,75,0,-0.099725137,0,-0.195083426,0.332742316,0.148705768,0.148705768,-0.195083426,0,0,1,1
1768,8,89,48,110,128,0,1809.149,94,1336.633,LESS,642,986,1628,2,2,18,1.687335229,18,1.571468165,2.077212555,-0.622544739,238,110,128,1,1.555712144,1.170500555,1.872800887,-0.465839243,1.142795996,1.142795996,1.872800887,1.170500555,1,1,1
1769,8,90,9,59,50,1,2734.632,4,1952.1,LESS,-646,1940,1294,3,1,-9,-0.843667615,9,0,-1.84548295,-0.134972213,109,59,50,0,-1.017196402,-0.819350388,-1.170500555,0.332742316,-0.515737959,0.515737959,-1.170500555,-0.819350388,0,1,0
1770,8,91,44,110,119,1,2794.365,44,1737.466,LESS,-736,1952,1216,3,1,9,0.843667615,9,0,-0.102062726,-0.103503056,229,110,119,1,1.376206896,1.170500555,1.521650721,0.332742316,-0.631629307,0.631629307,1.521650721,1.170500555,0,1,0
1771,8,92,2,52,50,0,2546.506,34,871.087,LESS,-612,1290,678,2,1,-2,-0.187481692,2,-1.222253018,-0.537917782,-0.234082698,102,52,50,0,-1.156811594,-1.092467184,-1.170500555,-0.465839243,-0.471956783,0.471956783,-1.170500555,-1.092467184,0,1,0
1772,8,93,8,58,50,1,2131.962,34,1488.057,LESS,48,974,1022,3,2,-8,-0.749926769,8,-0.174607574,-0.537917782,-0.452477055,108,58,50,0,-1.037141429,-0.858367073,-1.170500555,0.332742316,0.377913101,0.377913101,-1.170500555,-0.858367073,0,1,1
1773,8,94,44,119,110,0,3849.161,14,718.732,LESS,-678,2292,1614,4,1,-9,-0.843667615,9,0,-1.409627894,0.452195482,229,119,110,0,1.376206896,1.521650721,1.170500555,1.131323875,-0.556943772,0.556943772,1.170500555,1.521650721,0,1,0
1774,8,95,34,74,80,0,3392.605,24,1606.112,LESS,-520,1688,1168,4,1,6,0.562445076,6,-0.523822722,-0.973772838,0.211667928,154,74,80,1,-0.119670165,-0.234100111,0,1.131323875,-0.353490072,0.353490072,0,-0.234100111,0,1,1
1775,8,96,24,86,80,0,3605.734,24,1196.431,LESS,-20,1620,1600,4,1,-6,-0.562445076,6,-0.523822722,-0.973772838,0.323950752,166,86,80,0,0.119670165,0.234100111,0,1.131323875,0.290350749,0.290350749,0,0.234100111,0,1,1
1776,8,97,39,66,80,0,2144.74,24,1328.295,LESS,-474,1196,722,2,1,14,1.312371845,14,0.87303787,-0.973772838,-0.445745217,146,66,80,1,-0.279230385,-0.546233592,0,-0.465839243,-0.294256717,0.294256717,0,-0.546233592,0,0,1
1777,8,98,9,50,59,0,2174.261,54,2555.75,LESS,-2094,2640,546,2,1,9,0.843667615,9,0,0.33379233,-0.430192659,109,50,59,1,-1.017196402,-1.170500555,-0.819350388,-0.465839243,-2.380300978,2.380300978,-0.819350388,-1.170500555,1,0,0
1778,8,99,57,94,110,0,1571.94,54,1430.328,LESS,-662,1156,494,2,1,16,1.499853537,16,1.222253018,0.33379233,-0.747513637,204,94,110,1,0.877581209,0.546233592,1.170500555,-0.465839243,-0.536340865,0.536340865,1.170500555,0.546233592,1,0,0
1779,8,100,60,110,87,0,1742.637,4,1298.982,LESS,-1222,1798,576,2,1,-23,-2.15603946,23,2.444506035,-1.84548295,-0.657585278,197,110,87,0,0.737966017,1.170500555,0.273116796,-0.465839243,-1.257442585,1.257442585,0.273116796,1.170500555,0,0,0
1780,8,101,33,75,80,1,2352.831,54,916.648,LESS,44,1108,1152,3,2,5,0.46870423,5,-0.698430296,0.33379233,-0.336116564,155,75,80,1,-0.099725137,-0.195083426,0,0.332742316,0.372762374,0.372762374,0,-0.195083426,1,1,1
1781,8,102,15,50,45,1,6759.439,64,1476.461,LESS,444,2758,3202,6,2,-5,-0.46870423,5,-0.698430296,0.769647387,1.985418238,95,50,45,0,-1.296426786,-1.170500555,-1.36558398,2.728486994,0.887835031,0.887835031,-1.36558398,-1.170500555,1,1,1
1782,8,103,59,89,110,0,2251.397,24,965.516,LESS,-738,1502,764,2,1,21,1.968557767,21,2.095290887,-0.973772838,-0.389555073,199,89,110,1,0.777856072,0.351150166,1.170500555,-0.465839243,-0.63420467,0.63420467,1.170500555,0.351150166,0,0,0
1783,8,104,29,80,94,0,2173.127,24,1355.405,LESS,-626,1404,778,2,1,14,1.312371845,14,0.87303787,-0.973772838,-0.430790084,174,80,94,1,0.279230385,0,0.546233592,-0.465839243,-0.489984326,0.489984326,0.546233592,0,0,0,0
1784,8,105,55,110,98,1,1704.156,14,1225.832,LESS,-78,994,916,1,1,-12,-1.124890153,12,0.523822722,-1.409627894,-0.677858237,208,110,98,0,0.957361319,1.170500555,0.702300333,-1.264420802,0.215665214,0.215665214,0.702300333,1.170500555,0,0,1
1785,8,106,29,94,80,1,1743.33,64,1941.259,LESS,-162,1230,1068,1,1,-14,-1.312371845,14,0.87303787,0.769647387,-0.657220185,174,94,80,0,0.279230385,0.546233592,0,-1.264420802,0.107499956,0.107499956,0,0.546233592,1,0,1
1786,8,107,57,110,94,1,1646.439,64,1105.614,LESS,526,428,954,1,2,-16,-1.499853537,16,1.222253018,0.769647387,-0.708265304,204,110,94,0,0.877581209,1.170500555,0.546233592,-1.264420802,0.993424926,0.993424926,0.546233592,1.170500555,1,0,1
1787,8,108,39,80,66,1,2039.622,24,1849.381,LESS,272,576,848,1,2,-14,-1.312371845,14,0.87303787,-0.973772838,-0.501124569,146,80,66,0,-0.279230385,0,-0.546233592,-1.264420802,0.666353789,0.666353789,-0.546233592,0,0,0,1
1788,8,109,4,50,54,0,1675.742,4,1559.547,LESS,-1734,2300,566,2,1,4,0.374963384,4,-0.87303787,-1.84548295,-0.692827594,104,50,54,1,-1.116921539,-1.170500555,-1.014433814,-0.465839243,-1.916735586,1.916735586,-1.014433814,-1.170500555,0,0,0
1789,8,110,55,98,110,0,1763.484,74,1363.222,LESS,-446,1026,580,2,1,12,1.124890153,12,0.523822722,1.205502443,-0.646602446,208,98,110,1,0.957361319,0.702300333,1.170500555,-0.465839243,-0.258201631,0.258201631,1.170500555,0.702300333,1,0,1
1790,8,111,2,50,52,0,2261.381,74,1023.498,LESS,-668,1382,714,2,1,2,0.187481692,2,-1.222253018,1.205502443,-0.384295199,102,50,52,1,-1.156811594,-1.170500555,-1.092467184,-0.465839243,-0.544066955,0.544066955,-1.092467184,-1.170500555,1,0,0
1791,8,112,59,110,89,1,2515.522,54,996.82,LESS,296,970,1266,3,2,-21,-1.968557767,21,2.095290887,0.33379233,-0.250406009,199,110,89,0,0.777856072,1.170500555,0.351150166,0.332742316,0.697258148,0.697258148,0.351150166,1.170500555,0,1,1
1792,8,113,60,87,110,1,3370.842,14,1704.864,LESS,-490,2014,1524,5,1,23,2.15603946,23,2.444506035,-1.409627894,0.200202519,197,87,110,1,0.737966017,0.273116796,1.170500555,1.929905435,-0.314859623,0.314859623,1.170500555,0.273116796,0,1,1
1793,8,114,52,110,105,1,2468.761,14,1357.827,LESS,18,1202,1220,3,1,-5,-0.46870423,5,-0.698430296,-1.409627894,-0.275041123,215,110,105,0,1.096976512,1.170500555,0.975417129,0.332742316,0.339282651,0.339282651,0.975417129,1.170500555,0,1,1
1794,8,115,30,80,96,0,1909.49,64,1325.891,LESS,-560,1120,560,2,1,16,1.499853537,16,1.222253018,0.769647387,-0.569682055,176,80,96,1,0.31912044,0,0.624266962,-0.465839243,-0.404997338,0.404997338,0.624266962,0,1,0,0
1795,8,116,24,80,86,0,4207.208,14,2860.326,LESS,-1276,2840,1564,4,1,6,0.562445076,6,-0.523822722,-1.409627894,0.640825506,166,80,86,1,0.119670165,0,0.234100111,1.131323875,-1.326977394,1.326977394,0.234100111,0,0,1,0
1796,8,117,5,50,55,0,1917.889,74,1653.066,LESS,8,1178,1186,2,2,5,0.46870423,5,-0.698430296,1.205502443,-0.565257207,105,50,55,1,-1.096976512,-1.170500555,-0.975417129,-0.465839243,0.326405835,0.326405835,-0.975417129,-1.170500555,1,0,1
1797,8,118,34,80,74,0,2471.071,64,1116.823,LESS,-1100,1582,482,2,1,-6,-0.562445076,6,-0.523822722,0.769647387,-0.273824145,154,80,74,0,-0.119670165,0,-0.234100111,-0.465839243,-1.100345425,1.100345425,-0.234100111,0,1,0,0
1798,8,119,15,45,50,0,2157.019,64,1612.639,LESS,-368,1082,714,2,1,5,0.46870423,5,-0.698430296,0.769647387,-0.439276267,95,45,50,1,-1.296426786,-1.36558398,-1.170500555,-0.465839243,-0.157762463,0.157762463,-1.170500555,-1.36558398,1,0,1
1799,8,120,37,69,80,0,2608.648,4,2193.084,LESS,-1706,2318,612,2,1,11,1.031149307,11,0.349215148,-1.84548295,-0.201344407,149,69,80,1,-0.219395302,-0.429183537,0,-0.465839243,-1.8806805,1.8806805,0,-0.429183537,0,0,0
1800,8,121,48,128,110,1,3815.021,24,1784.456,MORE,1436,1018,2454,4,2,-18,-1.687335229,18,1.571468165,-0.973772838,0.434209494,238,128,110,1,1.555712144,1.872800887,1.170500555,1.131323875,2.165215221,2.165215221,1.170500555,1.872800887,0,1,1
1801,8,122,8,50,58,1,1408.148,74,1192.008,MORE,1026,524,1550,1,2,8,0.749926769,8,-0.174607574,1.205502443,-0.833804233,108,50,58,0,-1.037141429,-1.170500555,-0.858367073,-1.264420802,1.637265747,1.637265747,-0.858367073,-1.170500555,1,0,1
1802,8,123,4,54,50,1,1627.54,24,1544.582,MORE,550,472,1022,1,2,-4,-0.374963384,4,-0.87303787,-0.973772838,-0.71822187,104,54,50,1,-1.116921539,-1.014433814,-1.170500555,-1.264420802,1.024329285,1.024329285,-1.170500555,-1.014433814,0,0,1
1803,8,124,37,80,69,0,2892.416,14,2010.363,MORE,-554,2082,1528,2,1,-11,-1.031149307,11,0.349215148,-1.409627894,-0.051846814,149,80,69,1,-0.219395302,0,-0.429183537,-0.465839243,-0.397271248,0.397271248,-0.429183537,0,0,0,0
1804,8,125,52,105,110,1,2685.763,14,1823.105,MORE,142,1592,1734,3,1,5,0.46870423,5,-0.698430296,-1.409627894,-0.160717885,215,105,110,0,1.096976512,0.975417129,1.170500555,0.332742316,0.498955175,0.498955175,1.170500555,0.975417129,0,1,1
1805,8,126,5,55,50,0,6899.668,14,1110.34,MORE,-858,3910,3052,6,1,-5,-0.46870423,5,-0.698430296,-1.409627894,2.05929513,105,55,50,1,-1.096976512,-0.975417129,-1.170500555,2.728486994,-0.788726467,0.788726467,-1.170500555,-0.975417129,0,1,0
1806,8,127,30,96,80,1,3338.149,54,1909.693,MORE,488,1330,1818,3,2,-16,-1.499853537,16,1.222253018,0.33379233,0.182978855,176,96,80,1,0.31912044,0.624266962,0,0.332742316,0.944493023,0.944493023,0,0.624266962,1,1,1
1807,8,128,33,80,75,0,5372.894,4,1140.248,MORE,-1332,3548,2216,4,1,-5,-0.46870423,5,-0.698430296,-1.84548295,1.25494426,155,80,75,1,-0.099725137,0,-0.195083426,1.131323875,-1.399087566,1.399087566,-0.195083426,0,0,1,0
1808,8,129,48,110,128,1,8255.298,44,1500.945,MORE,-410,2460,2050,5,2,18,1.687335229,18,1.571468165,-0.102062726,2.773482147,238,110,128,0,1.555712144,1.170500555,1.872800887,1.929905435,-0.211845092,0.211845092,1.872800887,1.170500555,0,1,0
1809,8,130,9,59,50,0,2263.993,44,2629.106,MORE,-1078,2168,1090,4,1,-9,-0.843667615,9,0,-0.102062726,-0.382919118,109,59,50,1,-1.017196402,-0.819350388,-1.170500555,1.131323875,-1.072016429,1.072016429,-1.170500555,-0.819350388,0,1,0
1810,8,131,44,110,119,1,2397.12,64,863.228,MORE,354,882,1236,3,2,9,0.843667615,9,0,0.769647387,-0.312783775,229,110,119,0,1.376206896,1.170500555,1.521650721,0.332742316,0.771943683,0.771943683,1.521650721,1.170500555,1,1,1
1811,8,132,2,52,50,0,2290.511,34,3672.838,MORE,-872,1600,728,2,1,-2,-0.187481692,2,-1.222253018,-0.537917782,-0.368948631,102,52,50,1,-1.156811594,-1.092467184,-1.170500555,-0.465839243,-0.80675401,0.80675401,-1.170500555,-1.092467184,0,0,0
1812,8,133,8,58,50,0,3064.158,14,936.646,MORE,-826,1990,1164,3,1,-8,-0.749926769,8,-0.174607574,-1.409627894,0.038632083,108,58,50,1,-1.037141429,-0.858367073,-1.170500555,0.332742316,-0.747520655,0.747520655,-1.170500555,-0.858367073,0,1,0
1813,8,134,44,119,110,1,3191.691,34,1512.461,MORE,600,1222,1822,3,2,-9,-0.843667615,9,0,-0.537917782,0.105820337,229,119,110,1,1.376206896,1.521650721,1.170500555,0.332742316,1.088713367,1.088713367,1.170500555,1.521650721,0,1,1
1814,8,135,34,74,80,1,1773.727,24,1601.635,MORE,-24,1078,1054,2,1,6,0.562445076,6,-0.523822722,-0.973772838,-0.641206123,154,74,80,0,-0.119670165,-0.234100111,0,-0.465839243,0.285200022,0.285200022,0,-0.234100111,0,0,0
1815,8,136,24,86,80,0,5151.366,64,1782.739,MORE,-906,3150,2244,2,1,-6,-0.562445076,6,-0.523822722,0.769647387,1.138236588,166,86,80,1,0.119670165,0.234100111,0,-0.465839243,-0.850535186,0.850535186,0,0.234100111,1,0,0
1816,8,137,39,66,80,1,3350.238,34,3228.813,MORE,654,1254,1908,3,1,14,1.312371845,14,0.87303787,-0.537917782,0.189347707,146,66,80,0,-0.279230385,-0.546233592,0,0.332742316,1.158248176,1.158248176,0,-0.546233592,0,1,1
1817,8,138,9,50,59,1,1429.867,84,1076.959,MORE,432,532,964,1,2,9,0.843667615,9,0,1.641357499,-0.822362005,109,50,59,0,-1.017196402,-1.170500555,-0.819350388,-1.264420802,0.872382851,0.872382851,-0.819350388,-1.170500555,1,0,1
1818,8,139,57,94,110,1,2588.006,64,1119.055,MORE,158,1072,1230,3,2,16,1.499853537,16,1.222253018,0.769647387,-0.212219239,204,94,110,0,0.877581209,0.546233592,1.170500555,0.332742316,0.519558081,0.519558081,1.170500555,0.546233592,1,1,1
1819,8,140,60,110,87,1,3949.258,24,2999.515,MORE,324,2296,2620,3,1,-23,-2.15603946,23,2.444506035,-0.973772838,0.504929619,197,110,87,1,0.737966017,1.170500555,0.273116796,0.332742316,0.733313234,0.733313234,0.273116796,1.170500555,0,1,1
1820,8,141,33,75,80,0,2819.317,54,1258.794,MORE,-576,1350,774,1,1,5,0.46870423,5,-0.698430296,0.33379233,-0.090357585,155,75,80,0,-0.099725137,-0.195083426,0,-1.264420802,-0.425600244,0.425600244,0,-0.195083426,1,0,0
1821,8,142,15,50,45,0,2724.465,64,937.57,MORE,-630,1482,852,2,1,-5,-0.46870423,5,-0.698430296,0.769647387,-0.140328497,95,50,45,1,-1.296426786,-1.170500555,-1.36558398,-0.465839243,-0.495135053,0.495135053,-1.36558398,-1.170500555,1,0,0
1822,8,143,59,89,110,1,1768.763,64,1817.318,MORE,546,488,1034,1,2,21,1.968557767,21,2.095290887,0.769647387,-0.643821309,199,89,110,0,0.777856072,0.351150166,1.170500555,-1.264420802,1.019178559,1.019178559,1.170500555,0.351150166,1,0,1
1823,8,144,29,80,94,1,2662.831,74,1375.022,MORE,136,1136,1272,3,2,14,1.312371845,14,0.87303787,1.205502443,-0.172799158,174,80,94,0,0.279230385,0,0.546233592,0.332742316,0.491229085,0.491229085,0.546233592,0,1,1,0
1824,8,145,55,110,98,0,2720.735,14,1484.584,MORE,-1718,2434,716,2,1,-12,-1.124890153,12,0.523822722,-1.409627894,-0.142293574,208,110,98,1,0.957361319,1.170500555,0.702300333,-0.465839243,-1.89613268,1.89613268,0.702300333,1.170500555,0,0,0
1825,8,146,29,94,80,0,2168.314,14,1136.924,MORE,-914,1512,598,2,1,-14,-1.312371845,14,0.87303787,-1.409627894,-0.433325719,174,94,80,1,0.279230385,0.546233592,0,-0.465839243,-0.860836639,0.860836639,0,0.546233592,0,0,0
1826,8,147,57,110,94,0,2177.405,14,2861.682,MORE,-1478,2610,1132,2,1,-16,-1.499853537,16,1.222253018,-1.409627894,-0.428536304,204,110,94,1,0.877581209,1.170500555,0.546233592,-0.465839243,-1.587089086,1.587089086,0.546233592,1.170500555,0,0,0
1827,8,148,39,80,66,1,2734.053,34,1367.982,MORE,234,1054,1288,3,2,-14,-1.312371845,14,0.87303787,-0.537917782,-0.135277248,146,80,66,1,-0.279230385,0,-0.546233592,0.332742316,0.617421886,0.617421886,-0.546233592,0,0,1,1
1828,8,149,4,50,54,1,7071.145,24,849.036,MORE,-1642,4182,2540,4,1,4,0.374963384,4,-0.87303787,-0.973772838,2.149634416,104,50,54,0,-1.116921539,-1.170500555,-1.014433814,1.131323875,-1.798268875,1.798268875,-1.014433814,-1.170500555,0,1,0
1829,8,150,55,98,110,1,3290.315,64,2344.618,MORE,758,1134,1892,2,1,12,1.124890153,12,0.523822722,0.769647387,0.157778452,208,98,110,0,0.957361319,0.702300333,1.170500555,-0.465839243,1.292167067,1.292167067,1.170500555,0.702300333,1,0,1
1830,8,151,2,50,52,1,1529.663,64,1133.469,MORE,684,428,1112,1,2,2,0.187481692,2,-1.222253018,0.769647387,-0.769786444,102,50,52,0,-1.156811594,-1.170500555,-1.092467184,-1.264420802,1.196878625,1.196878625,-1.092467184,-1.170500555,1,0,1
1831,8,152,59,110,89,0,6277.282,44,1032.306,MORE,-110,2914,2804,2,1,-21,-1.968557767,21,2.095290887,-0.102062726,1.7314033,199,110,89,1,0.777856072,1.170500555,0.351150166,-0.465839243,0.174459401,0.174459401,0.351150166,1.170500555,0,0,0
1832,8,153,60,87,110,1,3580.267,24,1158.812,MORE,630,1312,1942,3,2,23,2.15603946,23,2.444506035,-0.973772838,0.310533964,197,87,110,0,0.737966017,0.273116796,1.170500555,0.332742316,1.127343817,1.127343817,1.170500555,0.273116796,0,1,1
1833,8,154,52,110,105,0,2067.727,74,2588.152,MORE,616,1252,1868,2,2,-5,-0.46870423,5,-0.698430296,1.205502443,-0.486318002,215,110,105,1,1.096976512,1.170500555,0.975417129,-0.465839243,1.109316274,1.109316274,0.975417129,1.170500555,1,0,1
1834,8,155,30,80,96,1,2687.155,54,1555.828,MORE,538,1278,1816,3,2,16,1.499853537,16,1.222253018,0.33379233,-0.159984537,176,80,96,0,0.31912044,0,0.624266962,0.332742316,1.008877106,1.008877106,0.624266962,0,1,1,1
1835,8,156,24,80,86,1,2634.212,64,1402.294,MORE,-152,1258,1106,3,2,6,0.562445076,6,-0.523822722,0.769647387,-0.187876516,166,80,86,0,0.119670165,0,0.234100111,0.332742316,0.120376772,0.120376772,0.234100111,0,1,1,0
1836,8,157,5,50,55,1,5321.699,14,916.803,MORE,-1202,3108,1906,5,1,5,0.46870423,5,-0.698430296,-1.409627894,1.227973181,105,50,55,0,-1.096976512,-1.170500555,-0.975417129,1.929905435,-1.231688952,1.231688952,-0.975417129,-1.170500555,0,1,0
1837,8,158,34,80,74,0,6242.055,24,2113.855,MORE,-942,3384,2442,2,2,-6,-0.562445076,6,-0.523822722,-0.973772838,1.712844648,154,80,74,1,-0.119670165,0,-0.234100111,-0.465839243,-0.896891725,0.896891725,-0.234100111,0,0,0,0
1838,8,159,15,45,50,1,3841.281,44,1440.598,MORE,682,1244,1926,2,1,5,0.46870423,5,-0.698430296,-0.102062726,0.448044059,95,45,50,0,-1.296426786,-1.36558398,-1.170500555,-0.465839243,1.194303262,1.194303262,-1.170500555,-1.36558398,0,1,1
1839,8,160,37,69,80,1,1794.327,74,1269.576,MORE,722,458,1180,1,2,11,1.031149307,11,0.349215148,1.205502443,-0.630353418,149,69,80,0,-0.219395302,-0.429183537,0,-1.264420802,1.245810528,1.245810528,0,-0.429183537,1,0,1
1840,8,161,3,50,53,0,5953.334,64,2403.66,LESS,-1472,2358,886,3,1,3,0.281222538,3,-1.047645444,0.769647387,1.560737664,103,50,53,1,-1.136866566,-1.170500555,-1.053450499,0.332742316,-1.579362996,1.579362996,-1.053450499,-1.170500555,1,1,0
1841,8,162,20,50,40,1,1816.584,34,1981.971,LESS,1220,322,1542,1,2,-10,-0.937408461,10,0.174607574,-0.537917782,-0.618627755,90,50,40,0,-1.396151924,-1.170500555,-1.560667406,-1.264420802,1.887075986,1.887075986,-1.560667406,-1.170500555,0,0,1
1842,8,163,25,80,88,0,1597.207,94,939.532,LESS,158,1000,1158,2,2,8,0.749926769,8,-0.174607574,2.077212555,-0.734202215,168,80,88,1,0.15956022,0,0.312133481,-0.465839243,0.519558081,0.519558081,0.312133481,0,1,0,1
1843,8,164,42,115,110,1,2356.35,14,1010.61,LESS,1798,292,2090,1,2,-5,-0.46870423,5,-0.698430296,-1.409627894,-0.334262648,225,115,110,0,1.296426786,1.36558398,1.170500555,-1.264420802,2.631355975,2.631355975,1.170500555,1.36558398,0,0,1
1844,8,165,53,103,110,0,1568.646,34,1458.519,LESS,-534,968,434,2,1,7,0.656185922,7,-0.349215148,-0.537917782,-0.749249017,213,103,110,1,1.057086457,0.897383758,1.170500555,-0.465839243,-0.371517615,0.371517615,1.170500555,0.897383758,0,0,0
1845,8,166,26,90,80,0,1684.202,24,1153.275,LESS,-1104,1512,408,2,1,-10,-0.937408461,10,0.174607574,-0.973772838,-0.688370609,170,90,80,0,0.199450275,0.390166852,0,-0.465839243,-1.105496151,1.105496151,0,0.390166852,0,0,0
1846,8,167,35,80,72,0,1487.091,34,1731.004,LESS,-872,1294,422,2,1,-8,-0.749926769,8,-0.174607574,-0.537917782,-0.792214665,152,80,72,0,-0.15956022,0,-0.312133481,-0.465839243,-0.80675401,0.80675401,-0.312133481,0,0,0,0
1847,8,168,28,93,80,0,1492.972,24,654.325,LESS,-808,1232,424,2,1,-13,-1.218630999,13,0.698430296,-0.973772838,-0.789116376,173,93,80,0,0.259285357,0.507216907,0,-0.465839243,-0.724342385,0.724342385,0,0.507216907,0,0,0
1848,8,169,26,80,90,0,1482.492,74,1403.472,LESS,-396,928,532,2,1,10,0.937408461,10,0.174607574,1.205502443,-0.794637558,170,80,90,1,0.199450275,0,0.390166852,-0.465839243,-0.193817549,0.193817549,0.390166852,0,1,0,1
1849,8,170,25,88,80,1,1957.235,74,1242.813,LESS,440,728,1168,3,2,-8,-0.749926769,8,-0.174607574,1.205502443,-0.544528541,168,88,80,0,0.15956022,0.312133481,0,0.332742316,0.882684305,0.882684305,0,0.312133481,1,1,1
1850,8,171,36,80,70,1,1489.436,64,1964.742,LESS,-494,1450,956,1,1,-10,-0.937408461,10,0.174607574,0.769647387,-0.790979248,150,80,70,0,-0.199450275,0,-0.390166852,-1.264420802,-0.32001035,0.32001035,-0.390166852,0,1,0,1
1851,8,172,28,80,93,0,1604.745,14,1969.499,LESS,-1002,1736,734,2,1,13,1.218630999,13,0.698430296,-1.409627894,-0.730230968,173,80,93,1,0.259285357,0,0.507216907,-0.465839243,-0.974152624,0.974152624,0.507216907,0,0,0,0
1852,8,173,21,82,80,0,1681.695,24,1166.53,LESS,-578,1120,542,2,1,-2,-0.187481692,2,-1.222253018,-0.973772838,-0.689691373,162,82,80,0,0.039890055,0.07803337,0,-0.465839243,-0.428175608,0.428175608,0,0.07803337,0,0,0
1853,8,174,19,50,41,1,1654.863,74,725.806,LESS,560,482,1042,1,2,-9,-0.843667615,9,0,1.205502443,-0.703827285,91,50,41,0,-1.376206896,-1.170500555,-1.521650721,-1.264420802,1.037206102,1.037206102,-1.521650721,-1.170500555,1,0,1
1854,8,175,56,96,110,0,1608.159,64,1468.595,LESS,-524,976,452,2,1,14,1.312371845,14,0.87303787,0.769647387,-0.728432369,206,96,110,1,0.917471264,0.624266962,1.170500555,-0.465839243,-0.358640799,0.358640799,1.170500555,0.624266962,1,0,1
1855,8,176,23,80,85,0,1337.638,84,1092.205,LESS,-736,1136,400,2,1,5,0.46870423,5,-0.698430296,1.641357499,-0.87095104,165,80,85,1,0.099725137,0,0.195083426,-0.465839243,-0.631629307,0.631629307,0.195083426,0,1,0,0
1856,8,177,10,60,50,1,2440.471,14,827.848,LESS,-242,1594,1352,3,1,-10,-0.937408461,10,0.174607574,-1.409627894,-0.289945153,110,60,50,0,-0.997251374,-0.780333703,-1.170500555,0.332742316,0.004485424,0.004485424,-1.170500555,-0.780333703,0,1,1
1857,8,178,19,41,50,0,1575.245,34,1213.155,LESS,-1518,2026,508,2,1,9,0.843667615,9,0,-0.537917782,-0.745772463,91,41,50,1,-1.376206896,-1.521650721,-1.170500555,-0.465839243,-1.638596351,1.638596351,-1.170500555,-1.521650721,0,0,0
1858,8,179,56,110,96,0,2015.823,24,1732.621,LESS,-1658,2160,502,2,1,-14,-1.312371845,14,0.87303787,-0.973772838,-0.513662604,206,110,96,0,0.917471264,1.170500555,0.624266962,-0.465839243,-1.818871781,1.818871781,0.624266962,1.170500555,0,0,0
1859,8,180,35,72,80,0,2109.254,64,1325.034,LESS,-292,1146,854,3,1,8,0.749926769,8,-0.174607574,0.769647387,-0.464440319,152,72,80,1,-0.15956022,-0.312133481,0,0.332742316,-0.059898658,0.059898658,0,-0.312133481,1,1,1
1860,8,181,11,49,50,0,1834.646,54,1063.9,LESS,-778,1196,418,2,1,1,0.093740846,1,-1.396860592,0.33379233,-0.609112145,99,49,50,1,-1.216646676,-1.20951724,-1.170500555,-0.465839243,-0.685711936,0.685711936,-1.170500555,-1.20951724,1,0,0
1861,8,182,17,43,50,0,1710.672,54,858.313,LESS,-882,1334,452,2,1,7,0.656185922,7,-0.349215148,0.33379233,-0.67442541,93,43,50,1,-1.336316841,-1.443617351,-1.170500555,-0.465839243,-0.819630827,0.819630827,-1.170500555,-1.443617351,1,0,0
1862,8,183,1,51,50,0,1792.779,64,1086.181,LESS,-598,1064,466,2,1,-1,-0.093740846,1,-1.396860592,0.769647387,-0.631168951,101,51,50,0,-1.176756621,-1.131483869,-1.170500555,-0.465839243,-0.45392924,0.45392924,-1.170500555,-1.131483869,1,0,0
1863,8,184,41,112,110,0,1716.701,54,1923.709,LESS,-726,1162,436,2,1,-2,-0.187481692,2,-1.222253018,0.33379233,-0.67124915,222,112,110,0,1.236591704,1.248533925,1.170500555,-0.465839243,-0.618752491,0.618752491,1.170500555,1.248533925,1,0,0
1864,8,185,20,40,50,0,1792.024,64,1791.392,LESS,-1740,2204,464,2,1,10,0.937408461,10,0.174607574,0.769647387,-0.631566708,90,40,50,1,-1.396151924,-1.560667406,-1.170500555,-0.465839243,-1.924461676,1.924461676,-1.170500555,-1.560667406,1,0,0
1865,8,186,1,50,51,0,3222.881,44,2541.476,LESS,-1800,2974,1174,4,1,1,0.093740846,1,-1.396860592,-0.102062726,0.122252175,101,50,51,1,-1.176756621,-1.170500555,-1.131483869,1.131323875,-2.001722575,2.001722575,-1.131483869,-1.170500555,0,1,0
1866,8,187,23,85,80,0,1853.679,44,1158.598,LESS,-1620,1998,378,2,1,-5,-0.46870423,5,-0.698430296,-0.102062726,-0.599084984,165,85,80,0,0.099725137,0.195083426,0,-0.465839243,-1.769939879,1.769939879,0,0.195083426,0,0,0
1867,8,188,11,50,49,0,1256.672,64,762.367,LESS,-364,722,358,2,1,-1,-0.093740846,1,-1.396860592,0.769647387,-0.913606386,99,50,49,0,-1.216646676,-1.170500555,-1.20951724,-0.465839243,-0.152611736,0.152611736,-1.20951724,-1.170500555,1,0,1
1868,8,189,17,50,43,0,1255.339,34,1198.486,LESS,-588,954,366,2,1,-7,-0.656185922,7,-0.349215148,-0.537917782,-0.914308651,93,50,43,0,-1.336316841,-1.170500555,-1.443617351,-0.465839243,-0.441052424,0.441052424,-1.443617351,-1.170500555,0,0,0
1869,8,190,21,80,82,0,1437.843,64,1345.087,LESS,-1258,1640,382,2,1,2,0.187481692,2,-1.222253018,0.769647387,-0.818160006,162,80,82,1,0.039890055,0,0.07803337,-0.465839243,-1.303799124,1.303799124,0.07803337,0,1,0,0
1870,8,191,10,50,60,0,1549.129,64,2070.396,LESS,-854,1254,400,2,1,10,0.937408461,10,0.174607574,0.769647387,-0.759531164,110,50,60,1,-0.997251374,-1.170500555,-0.780333703,-0.465839243,-0.783575741,0.783575741,-0.780333703,-1.170500555,1,0,0
1871,8,192,3,53,50,0,1246.492,74,1818.285,LESS,-696,1080,384,2,1,-3,-0.281222538,3,-1.047645444,1.205502443,-0.918969519,103,53,50,0,-1.136866566,-1.053450499,-1.170500555,-0.465839243,-0.580122041,0.580122041,-1.170500555,-1.053450499,1,0,0
1872,8,193,45,122,110,1,1726.535,64,1365.902,LESS,-22,1102,1080,3,1,-12,-1.124890153,12,0.523822722,0.769647387,-0.666068301,232,122,110,0,1.436041979,1.638700776,1.170500555,0.332742316,0.287775386,0.287775386,1.170500555,1.638700776,1,1,1
1873,8,194,38,67,80,0,1176.152,84,1183.264,LESS,-866,1178,312,2,1,13,1.218630999,13,0.698430296,1.641357499,-0.956026765,147,67,80,1,-0.259285357,-0.507216907,0,-0.465839243,-0.799027921,0.799027921,0,-0.507216907,1,0,0
1874,8,195,38,80,67,1,1661.268,74,1349.66,LESS,534,564,1098,1,2,-13,-1.218630999,13,0.698430296,1.205502443,-0.700452937,147,80,67,0,-0.259285357,0,-0.507216907,-1.264420802,1.003726379,1.003726379,-0.507216907,0,1,0,1
1875,8,196,36,70,80,0,1511.403,54,1078.42,LESS,-796,1164,368,2,1,10,0.937408461,10,0.174607574,0.33379233,-0.779406366,150,70,80,1,-0.199450275,-0.390166852,0,-0.465839243,-0.708890206,0.708890206,0,-0.390166852,1,0,0
1876,8,197,45,110,122,0,1570.601,64,714.519,LESS,-670,1038,368,2,1,12,1.124890153,12,0.523822722,0.769647387,-0.748219063,232,110,122,1,1.436041979,1.170500555,1.638700776,-0.465839243,-0.546642319,0.546642319,1.638700776,1.170500555,1,0,0
1877,8,198,42,110,115,0,1476.527,64,1559.568,LESS,-1330,1744,414,2,1,5,0.46870423,5,-0.698430296,0.769647387,-0.797780101,225,110,115,1,1.296426786,1.170500555,1.36558398,-0.465839243,-1.396512203,1.396512203,1.36558398,1.170500555,1,0,0
1878,8,199,41,110,112,0,1724.697,54,846.373,LESS,-798,1344,546,2,1,2,0.187481692,2,-1.222253018,0.33379233,-0.667036615,222,110,112,1,1.236591704,1.170500555,1.248533925,-0.465839243,-0.711465569,0.711465569,1.248533925,1.170500555,1,0,0
1879,8,200,53,110,103,0,1499.084,64,1907.718,LESS,-134,1110,976,2,2,-7,-0.656185922,7,-0.349215148,0.769647387,-0.785896389,213,110,103,0,1.057086457,1.170500555,0.897383758,-0.465839243,0.143555042,0.143555042,0.897383758,1.170500555,1,0,1
1880,8,201,3,50,53,1,3558.772,74,1706.762,MORE,30,1380,1410,2,2,3,0.281222538,3,-1.047645444,1.205502443,0.299209746,103,50,53,0,-1.136866566,-1.170500555,-1.053450499,-0.465839243,0.354734831,0.354734831,-1.053450499,-1.170500555,1,0,0
1881,8,202,20,50,40,0,2050.16,14,723.459,MORE,-922,1672,750,2,1,-10,-0.937408461,10,0.174607574,-1.409627894,-0.495572831,90,50,40,1,-1.396151924,-1.170500555,-1.560667406,-0.465839243,-0.871138093,0.871138093,-1.560667406,-1.170500555,0,0,0
1882,8,203,25,80,88,1,2111.391,14,1002.812,MORE,-666,1624,958,3,1,8,0.749926769,8,-0.174607574,-1.409627894,-0.463314482,168,80,88,0,0.15956022,0,0.312133481,0.332742316,-0.541491592,0.541491592,0.312133481,0,0,1,0
1883,8,204,42,115,110,1,1777.964,54,1572.891,MORE,1188,640,1828,3,2,-5,-0.46870423,5,-0.698430296,0.33379233,-0.638973943,225,115,110,1,1.296426786,1.36558398,1.170500555,0.332742316,1.845870173,1.845870173,1.170500555,1.36558398,0,1,1
1884,8,205,53,103,110,1,2248.647,44,1592.511,MORE,400,1052,1452,3,2,7,0.656185922,7,-0.349215148,-0.102062726,-0.391003857,213,103,110,0,1.057086457,0.897383758,1.170500555,0.332742316,0.831177039,0.831177039,1.170500555,0.897383758,0,1,1
1885,8,206,26,90,80,0,1563.127,54,1570.025,MORE,-1292,1750,458,2,1,-10,-0.937408461,10,0.174607574,0.33379233,-0.752156593,170,90,80,1,0.199450275,0.390166852,0,-0.465839243,-1.3475803,1.3475803,0,0.390166852,0,0,0
1886,8,207,35,80,72,1,2271.978,54,872.152,MORE,188,1000,1188,3,2,-8,-0.749926769,8,-0.174607574,0.33379233,-0.378712378,152,80,72,1,-0.15956022,0,-0.312133481,0.332742316,0.558188531,0.558188531,-0.312133481,0,0,1,1
1887,8,208,28,93,80,1,2260.891,54,1080.651,MORE,430,882,1312,3,2,-13,-1.218630999,13,0.698430296,0.33379233,-0.384553346,173,93,80,1,0.259285357,0.507216907,0,0.332742316,0.869807488,0.869807488,0,0.507216907,0,1,1
1888,8,209,26,80,90,1,1509.538,54,966.046,MORE,440,450,890,1,2,10,0.937408461,10,0.174607574,0.33379233,-0.780388904,170,80,90,0,0.199450275,0,0.390166852,-1.264420802,0.882684305,0.882684305,0.390166852,0,0,0,1
1889,8,210,25,88,80,1,4128.836,44,1230.883,MORE,1082,1368,2450,5,2,-8,-0.749926769,8,-0.174607574,-0.102062726,0.599536758,168,88,80,1,0.15956022,0.312133481,0,1.929905435,1.709375919,1.709375919,0,0.312133481,0,1,1
1890,8,211,36,80,70,1,1242.251,44,1182.846,MORE,580,406,986,1,2,-10,-0.937408461,10,0.174607574,-0.102062726,-0.921203806,150,80,70,1,-0.199450275,0,-0.390166852,-1.264420802,1.062959735,1.062959735,-0.390166852,0,0,0,1
1891,8,212,28,80,93,1,2094.95,64,611.255,MORE,444,796,1240,3,2,13,1.218630999,13,0.698430296,0.769647387,-0.4719761,173,80,93,0,0.259285357,0,0.507216907,0.332742316,0.887835031,0.887835031,0.507216907,0,1,1,1
1892,8,213,21,82,80,1,2392.54,44,1166.873,MORE,214,1142,1356,3,1,-2,-0.187481692,2,-1.222253018,-0.102062726,-0.315196658,162,82,80,1,0.039890055,0.07803337,0,0.332742316,0.591668253,0.591668253,0,0.07803337,0,1,1
1893,8,214,19,50,41,0,2566.652,54,1612.864,MORE,-1200,1936,736,2,2,-9,-0.843667615,9,0,0.33379233,-0.223469174,91,50,41,1,-1.376206896,-1.170500555,-1.521650721,-0.465839243,-1.229113589,1.229113589,-1.521650721,-1.170500555,1,0,0
1894,8,215,56,96,110,1,1587.263,54,1218.851,MORE,360,540,900,1,2,14,1.312371845,14,0.87303787,0.33379233,-0.739441016,206,96,110,0,0.917471264,0.624266962,1.170500555,-1.264420802,0.779669773,0.779669773,1.170500555,0.624266962,1,0,1
1895,8,216,23,80,85,1,1428.436,64,1168.519,MORE,648,442,1090,1,2,5,0.46870423,5,-0.698430296,0.769647387,-0.823115899,165,80,85,0,0.099725137,0,0.195083426,-1.264420802,1.150522086,1.150522086,0.195083426,0,1,0,1
1896,8,217,10,60,50,1,2804.189,44,1610.182,MORE,-94,1688,1594,3,1,-10,-0.937408461,10,0.174607574,-0.102062726,-0.098327475,110,60,50,1,-0.997251374,-0.780333703,-1.170500555,0.332742316,0.195062307,0.195062307,-1.170500555,-0.780333703,0,1,0
1897,8,218,19,41,50,0,2272.403,54,1164.256,MORE,-716,1478,762,2,1,9,0.843667615,9,0,0.33379233,-0.378488475,91,41,50,0,-1.376206896,-1.521650721,-1.170500555,-0.465839243,-0.605875674,0.605875674,-1.170500555,-1.521650721,1,0,0
1898,8,219,56,110,96,0,2089.807,54,1679.729,MORE,-1246,1752,506,2,1,-14,-1.312371845,14,0.87303787,0.33379233,-0.474685588,206,110,96,1,0.917471264,1.170500555,0.624266962,-0.465839243,-1.288346945,1.288346945,0.624266962,1.170500555,1,0,0
1899,8,220,35,72,80,1,2406.058,54,1189.687,MORE,430,944,1374,3,2,8,0.749926769,8,-0.174607574,0.33379233,-0.308074966,152,72,80,0,-0.15956022,-0.312133481,0,0.332742316,0.869807488,0.869807488,0,-0.312133481,1,1,1
1900,8,221,11,49,50,1,1395.817,54,1127.096,MORE,292,508,800,1,2,1,0.093740846,1,-1.396860592,0.33379233,-0.840300578,99,49,50,0,-1.216646676,-1.20951724,-1.170500555,-1.264420802,0.692107422,0.692107422,-1.170500555,-1.20951724,1,0,1
1901,8,222,17,43,50,1,1477.77,54,1360.416,MORE,1010,516,1526,1,2,7,0.656185922,7,-0.349215148,0.33379233,-0.797125251,93,43,50,0,-1.336316841,-1.443617351,-1.170500555,-1.264420802,1.616662841,1.616662841,-1.170500555,-1.443617351,1,0,1
1902,8,223,1,51,50,1,1956.009,54,757.116,MORE,432,726,1158,3,2,-1,-0.093740846,1,-1.396860592,0.33379233,-0.545174435,101,51,50,1,-1.176756621,-1.131483869,-1.170500555,0.332742316,0.872382851,0.872382851,-1.170500555,-1.131483869,1,1,1
1903,8,224,41,112,110,1,2400.082,64,1573.641,MORE,596,852,1448,3,2,-2,-0.187481692,2,-1.222253018,0.769647387,-0.311223304,222,112,110,1,1.236591704,1.248533925,1.170500555,0.332742316,1.083562641,1.083562641,1.170500555,1.248533925,1,1,1
1904,8,225,20,40,50,1,1644.349,64,1748.119,MORE,58,1188,1246,2,1,10,0.937408461,10,0.174607574,0.769647387,-0.709366379,90,40,50,0,-1.396151924,-1.560667406,-1.170500555,-0.465839243,0.390789917,0.390789917,-1.170500555,-1.560667406,1,0,0
1905,8,226,1,50,51,0,2142.379,74,1406.91,MORE,-780,1366,586,2,1,1,0.093740846,1,-1.396860592,1.205502443,-0.446989064,101,50,51,0,-1.176756621,-1.170500555,-1.131483869,-0.465839243,-0.688287299,0.688287299,-1.131483869,-1.170500555,1,0,0
1906,8,227,23,85,80,1,2177.221,14,860.839,MORE,-146,1360,1214,3,1,-5,-0.46870423,5,-0.698430296,-1.409627894,-0.428633241,165,85,80,1,0.099725137,0.195083426,0,0.332742316,0.128102862,0.128102862,0,0.195083426,0,1,0
1907,8,228,11,50,49,0,1539.542,74,1258.364,MORE,-458,1024,566,2,1,-1,-0.093740846,1,-1.396860592,1.205502443,-0.764581887,99,50,49,1,-1.216646676,-1.170500555,-1.20951724,-0.465839243,-0.27365381,0.27365381,-1.20951724,-1.170500555,1,0,0
1908,8,229,17,50,43,1,1636.221,4,782.897,MORE,-222,1084,862,1,1,-7,-0.656185922,7,-0.349215148,-1.84548295,-0.713648456,93,50,43,1,-1.336316841,-1.170500555,-1.443617351,-1.264420802,0.030239057,0.030239057,-1.443617351,-1.170500555,0,0,0
1909,8,230,21,80,82,1,1258.661,74,1741.504,MORE,206,674,880,1,1,2,0.187481692,2,-1.222253018,1.205502443,-0.91255852,162,80,82,0,0.039890055,0,0.07803337,-1.264420802,0.5813668,0.5813668,0.07803337,0,1,0,1
1910,8,231,10,50,60,1,1221.12,84,1636.692,MORE,-98,822,724,1,2,10,0.937408461,10,0.174607574,1.641357499,-0.932336258,110,50,60,0,-0.997251374,-1.170500555,-0.780333703,-1.264420802,0.189911581,0.189911581,-0.780333703,-1.170500555,1,0,0
1911,8,232,3,53,50,1,1365.15,20,1378.545,MORE,-576,1466,890,1,1,-3,-0.281222538,3,-1.047645444,-1.14811486,-0.856456884,103,53,50,1,-1.136866566,-1.053450499,-1.170500555,-1.264420802,-0.425600244,0.425600244,-1.170500555,-1.053450499,0,0,0
1912,8,233,45,122,110,0,1922.175,64,813.374,MORE,-750,1396,646,2,1,-12,-1.124890153,12,0.523822722,0.769647387,-0.562999212,232,122,110,1,1.436041979,1.638700776,1.170500555,-0.465839243,-0.64965685,0.64965685,1.170500555,1.638700776,1,1,0
1913,8,234,38,67,80,1,1437.994,54,1597.136,MORE,206,866,1072,2,1,13,1.218630999,13,0.698430296,0.33379233,-0.818080454,147,67,80,0,-0.259285357,-0.507216907,0,-0.465839243,0.5813668,0.5813668,0,-0.507216907,0,0,1
1914,8,235,38,80,67,0,2292.136,64,1105.003,MORE,-1358,1826,468,2,1,-13,-1.218630999,13,0.698430296,0.769647387,-0.368092532,147,80,67,1,-0.259285357,0,-0.507216907,-0.465839243,-1.432567289,1.432567289,-0.507216907,0,1,0,0
1915,8,236,36,70,80,1,2162.836,64,665.895,MORE,410,846,1256,3,2,10,0.937408461,10,0.174607574,0.769647387,-0.436211695,150,70,80,0,-0.199450275,-0.390166852,0,0.332742316,0.844053855,0.844053855,0,-0.390166852,1,1,1
1916,8,237,45,110,122,1,1459.06,74,1282.882,MORE,660,582,1242,2,2,12,1.124890153,12,0.523822722,1.205502443,-0.806982246,232,110,122,0,1.436041979,1.170500555,1.638700776,-0.465839243,1.165974266,1.165974266,1.638700776,1.170500555,1,0,1
1917,8,238,42,110,115,0,2033.541,64,1883.873,MORE,-994,1472,478,2,1,5,0.46870423,5,-0.698430296,0.769647387,-0.504328224,225,110,115,0,1.296426786,1.170500555,1.36558398,-0.465839243,-0.963851171,0.963851171,1.36558398,1.170500555,1,0,0
1918,8,239,41,110,112,1,2197.817,64,1175.085,MORE,326,814,1140,3,2,2,0.187481692,2,-1.222253018,0.769647387,-0.417782643,222,110,112,0,1.236591704,1.170500555,1.248533925,0.332742316,0.735888597,0.735888597,1.248533925,1.170500555,1,1,1
1919,8,240,53,110,103,0,3077.082,64,1341.093,MORE,-552,1690,1138,4,1,-7,-0.656185922,7,-0.349215148,0.769647387,0.045440838,213,110,103,1,1.057086457,1.170500555,0.897383758,1.131323875,-0.394695885,0.394695885,0.897383758,1.170500555,1,1,0
1920,9,1,49,110,131,1,1737.66,60,1361.161,MORE,252,686,938,1,2,21,1.968557767,21,2.095290887,0.263719925,-0.037291479,241,110,131,0,1.615547226,1.170500555,1.989850943,-0.483207941,0.768634406,0.768634406,1.989850943,1.170500555,0,0,1
1921,9,2,13,47,50,1,1700.417,30,1439.522,MORE,94,428,522,1,2,3,0.281222538,3,-1.047645444,-0.827534936,-0.103403154,97,47,50,0,-1.256536731,-1.28755061,-1.170500555,-0.483207941,0.325797847,0.325797847,-1.170500555,-1.28755061,0,1,1
1922,9,3,16,50,44,0,1476.671,30,1334.914,MORE,-22,424,402,1,2,-6,-0.562445076,6,-0.523822722,-0.827534936,-0.50058445,94,50,44,1,-1.316371814,-1.170500555,-1.404600665,-0.483207941,0.000677334,0.000677334,-1.404600665,-1.170500555,0,1,0
1923,9,4,7,57,50,1,1643.327,70,1003.951,MORE,80,404,484,1,2,-7,-0.656185922,7,-0.349215148,0.627471545,-0.204746106,107,57,50,1,-1.057086457,-0.897383758,-1.170500555,-0.483207941,0.286559164,0.286559164,-1.170500555,-0.897383758,1,1,1
1924,9,5,18,42,50,1,1397.676,50,1210.4,MORE,-4,382,378,1,2,8,0.749926769,8,-0.174607574,-0.100031696,-0.640811924,92,42,50,0,-1.356261869,-1.482634036,-1.170500555,-0.483207941,0.051127069,0.051127069,-1.170500555,-1.482634036,0,1,0
1925,9,6,51,108,110,0,2087.122,10,857.758,MORE,-414,1072,658,2,1,2,0.187481692,2,-1.222253018,-1.555038176,0.583053778,218,108,110,0,1.156811594,1.092467184,1.170500555,1.300944457,-1.098005775,1.098005775,1.170500555,1.092467184,0,1,0
1926,9,7,31,78,80,1,1959.917,70,873.334,MORE,-162,1122,960,2,2,2,0.187481692,2,-1.222253018,0.627471545,0.357246628,158,78,80,0,-0.039890055,-0.07803337,0,1.300944457,-0.391709491,0.391709491,0,-0.07803337,1,1,0
1927,9,8,58,110,92,0,1866.011,80,1118.559,MORE,618,582,1200,1,2,-18,-1.687335229,18,1.571468165,0.991223165,0.190549987,202,110,92,1,0.837691154,1.170500555,0.468200222,-0.483207941,1.794445677,1.794445677,0.468200222,1.170500555,1,1,1
1928,9,9,12,50,48,1,2345.818,30,670.529,MORE,216,608,824,1,2,-2,-0.187481692,2,-1.222253018,-0.827534936,1.042276345,98,50,48,1,-1.236591704,-1.170500555,-1.248533925,-0.483207941,0.667734937,0.667734937,-1.248533925,-1.170500555,0,1,1
1929,9,10,54,110,101,0,3013.529,60,1471.275,MORE,2,1080,1082,2,2,-9,-0.843667615,9,0,0.263719925,2.2275593,211,110,101,1,1.017196402,1.170500555,0.819350388,1.300944457,0.067943647,0.067943647,0.819350388,1.170500555,0,1,0
1930,9,11,14,46,50,1,1952.562,80,1371.634,MORE,208,888,1096,2,2,4,0.374963384,4,-0.87303787,0.991223165,0.344190446,96,46,50,0,-1.276481759,-1.326567295,-1.170500555,1.300944457,0.645312833,0.645312833,-1.170500555,-1.326567295,1,1,1
1931,9,12,22,80,83,0,2152.213,0,1187.2,MORE,-1096,1568,472,2,1,3,0.281222538,3,-1.047645444,-1.918789796,0.698599655,163,80,83,0,0.059835082,0,0.117050055,1.300944457,-3.009490166,3.009490166,0.117050055,0,0,1,0
1932,9,13,6,50,56,0,2567.785,50,1172.744,MORE,22,752,774,2,1,6,0.562445076,6,-0.523822722,-0.100031696,1.43629966,106,50,56,0,-1.077031484,-1.170500555,-0.936400444,1.300944457,0.123998908,0.123998908,-0.936400444,-1.170500555,0,1,1
1933,9,14,13,50,47,1,2959.43,70,1362.374,MORE,-302,1052,750,1,1,-3,-0.281222538,3,-1.047645444,0.627471545,2.131525802,97,50,47,1,-1.256536731,-1.170500555,-1.28755061,-0.483207941,-0.784096316,0.784096316,-1.28755061,-1.170500555,1,1,0
1934,9,15,46,110,124,1,2399.982,60,1583.975,MORE,-308,976,668,1,1,14,1.312371845,14,0.87303787,0.263719925,1.138425227,234,110,124,0,1.475932034,1.170500555,1.716734147,-0.483207941,-0.800912894,0.800912894,1.716734147,1.170500555,0,1,0
1935,9,16,27,91,80,0,2534.684,80,1199.852,MORE,-390,1034,644,2,1,-11,-1.031149307,11,0.349215148,0.991223165,1.377540629,171,91,80,1,0.219395302,0.429183537,0,1.300944457,-1.030739463,1.030739463,0,0.429183537,1,1,0
1936,9,17,40,64,80,1,2663.548,70,1061.817,MORE,-610,1164,554,1,1,16,1.499853537,16,1.222253018,0.627471545,1.606292743,144,64,80,0,-0.31912044,-0.624266962,0,-0.483207941,-1.64734733,1.64734733,0,-0.624266962,1,1,0
1937,9,18,22,83,80,0,2875.654,30,1082.231,MORE,192,698,890,1,2,-3,-0.281222538,3,-1.047645444,-0.827534936,1.982811366,163,83,80,1,0.059835082,0.117050055,0,-0.483207941,0.600468624,0.600468624,0,0.117050055,0,1,1
1938,9,19,54,101,110,0,2027.183,60,2019.26,MORE,-96,848,752,1,1,9,0.843667615,9,0,0.263719925,0.476653442,211,101,110,0,1.017196402,0.819350388,1.170500555,-0.483207941,-0.20672713,0.20672713,1.170500555,0.819350388,1,1,0
1939,9,20,6,56,50,1,2750.827,20,1589.905,MORE,106,730,836,1,2,-6,-0.562445076,6,-0.523822722,-1.191286556,1.761225507,106,56,50,1,-1.077031484,-0.936400444,-1.170500555,-0.483207941,0.359431003,0.359431003,-1.170500555,-0.936400444,0,1,1
1940,9,21,18,50,42,1,2205.375,60,956.601,MORE,242,490,732,1,2,-8,-0.749926769,8,-0.174607574,0.263719925,0.792969843,92,50,42,1,-1.356261869,-1.170500555,-1.482634036,-0.483207941,0.740606776,0.740606776,-1.482634036,-1.170500555,1,1,1
1941,9,22,43,110,117,1,1977.979,40,1540.266,MORE,84,516,600,1,2,7,0.656185922,7,-0.349215148,-0.463783316,0.389309273,227,110,117,0,1.336316841,1.170500555,1.443617351,-0.483207941,0.297770216,0.297770216,1.443617351,1.170500555,0,1,1
1942,9,23,32,77,80,0,1980.279,40,1372.989,MORE,-172,782,610,2,1,3,0.281222538,3,-1.047645444,-0.463783316,0.393392103,157,77,80,0,-0.059835082,-0.117050055,0,1.300944457,-0.419737121,0.419737121,0,-0.117050055,0,1,0
1943,9,24,27,80,91,1,1653.077,60,1366.677,MORE,-78,518,440,1,2,11,1.031149307,11,0.349215148,0.263719925,-0.187438456,171,80,91,0,0.219395302,0,0.429183537,-0.483207941,-0.156277396,0.156277396,0.429183537,0,1,1,0
1944,9,25,16,44,50,1,1485.164,70,1226.889,MORE,-104,536,432,1,2,6,0.562445076,6,-0.523822722,0.627471545,-0.485508154,94,44,50,0,-1.316371814,-1.404600665,-1.170500555,-0.483207941,-0.229149234,0.229149234,-1.170500555,-1.404600665,1,1,0
1945,9,26,7,50,57,1,1783.653,90,1353.81,MORE,1064,404,1468,1,2,7,0.656185922,7,-0.349215148,1.354974785,0.044352704,107,50,57,0,-1.057086457,-1.170500555,-0.897383758,-0.483207941,3.044477991,3.044477991,-0.897383758,-1.170500555,1,1,1
1946,9,27,14,50,46,0,1855.097,20,1493.444,MORE,-398,936,538,1,2,-4,-0.374963384,4,-0.87303787,-1.191286556,0.171176069,96,50,46,1,-1.276481759,-1.170500555,-1.326567295,-0.483207941,-1.053161567,1.053161567,-1.326567295,-1.170500555,0,0,0
1947,9,28,51,110,108,1,2431.437,0,2411.338,MORE,-1412,2158,746,1,2,-2,-0.187481692,2,-1.222253018,-1.918789796,1.194262371,218,110,108,1,1.156811594,1.170500555,1.092467184,-0.483207941,-3.895163285,3.895163285,1.092467184,1.170500555,0,1,0
1948,9,29,50,133,110,1,2048.157,50,638.129,MORE,76,594,670,1,2,-23,-2.15603946,23,2.444506035,-0.100031696,0.513885305,243,133,110,1,1.655437281,2.067884313,1.170500555,-0.483207941,0.275348112,0.275348112,1.170500555,2.067884313,0,0,1
1949,9,30,49,131,110,0,1933.937,70,477.39,MORE,54,548,602,1,2,-21,-1.968557767,21,2.095290887,0.627471545,0.311128395,241,131,110,1,1.615547226,1.989850943,1.170500555,-0.483207941,0.213687325,0.213687325,1.170500555,1.989850943,1,0,1
1950,9,31,47,126,110,0,1995.005,60,232.809,MORE,-770,1350,580,2,1,-16,-1.499853537,16,1.222253018,0.263719925,0.419532869,236,126,110,1,1.515822089,1.794767517,1.170500555,1.300944457,-2.095789416,2.095789416,1.170500555,1.794767517,1,1,0
1951,9,32,50,110,133,1,1805.838,70,1206.58,MORE,-62,596,534,1,2,23,2.15603946,23,2.444506035,0.627471545,0.083734267,243,110,133,0,1.655437281,1.170500555,2.067884313,-0.483207941,-0.111433187,0.111433187,2.067884313,1.170500555,1,0,0
1952,9,33,47,110,126,1,1846.312,80,1165.942,MORE,144,526,670,1,2,16,1.499853537,16,1.222253018,0.991223165,0.155581431,236,110,126,0,1.515822089,1.170500555,1.794767517,-0.483207941,0.465935998,0.465935998,1.794767517,1.170500555,1,1,1
1953,9,34,12,48,50,1,1751.653,60,948.746,MORE,46,462,508,1,2,2,0.187481692,2,-1.222253018,0.263719925,-0.012451893,98,48,50,0,-1.236591704,-1.248533925,-1.170500555,-0.483207941,0.191265221,0.191265221,-1.170500555,-1.248533925,1,1,1
1954,9,35,32,80,77,0,2292.031,20,1429.007,MORE,-188,676,488,1,1,-3,-0.281222538,3,-1.047645444,-1.191286556,0.946796693,157,80,77,1,-0.059835082,0,-0.117050055,-0.483207941,-0.464581329,0.464581329,-0.117050055,0,0,1,0
1955,9,36,43,117,110,0,2356.063,40,1291.98,MORE,-278,822,544,1,2,-7,-0.656185922,7,-0.349215148,-0.463783316,1.060462692,227,117,110,1,1.336316841,1.443617351,1.170500555,-0.483207941,-0.716830003,0.716830003,1.170500555,1.443617351,0,1,0
1956,9,37,40,80,64,0,1909.306,60,764.354,MORE,-316,814,498,2,1,-16,-1.499853537,16,1.222253018,0.263719925,0.267404832,144,80,64,1,-0.31912044,0,-0.624266962,1.300944457,-0.823334998,0.823334998,-0.624266962,0,1,1,0
1957,9,38,31,80,78,1,1744.836,70,1114.145,MORE,-136,746,610,2,1,-2,-0.187481692,2,-1.222253018,0.627471545,-0.024553048,158,80,78,1,-0.039890055,0,-0.07803337,1.300944457,-0.318837652,0.318837652,-0.07803337,0,1,1,0
1958,9,39,46,124,110,0,2723.051,40,1201.036,MORE,-568,1200,632,2,1,-14,-1.312371845,14,0.87303787,-0.463783316,1.711919117,234,124,110,1,1.475932034,1.716734147,1.170500555,1.300944457,-1.529631283,1.529631283,1.170500555,1.716734147,0,1,0
1959,9,40,58,92,110,1,2331.944,70,1459.428,MORE,-278,932,654,2,1,18,1.687335229,18,1.571468165,0.627471545,1.017648002,202,92,110,0,0.837691154,0.468200222,1.170500555,1.300944457,-0.716830003,0.716830003,1.170500555,0.468200222,1,1,0
1960,9,41,49,110,131,0,1934.475,50,1106.1,LESS,-342,884,542,3,1,21,1.968557767,21,2.095290887,-0.100031696,0.312083423,241,110,131,1,1.615547226,1.170500555,1.989850943,3.085096855,-0.896206837,0.896206837,1.989850943,1.170500555,0,1,0
1961,9,42,13,47,50,0,1540.831,60,1521.152,LESS,-360,908,548,1,1,3,0.281222538,3,-1.047645444,0.263719925,-0.386691232,97,47,50,1,-1.256536731,-1.28755061,-1.170500555,-0.483207941,-0.946656572,0.946656572,-1.170500555,-1.28755061,0,1,0
1962,9,43,16,50,44,1,1175.848,80,498.8,LESS,6,416,422,1,2,-6,-0.562445076,6,-0.523822722,0.991223165,-1.034588494,94,50,44,0,-1.316371814,-1.170500555,-1.404600665,-0.483207941,0.079154699,0.079154699,-1.404600665,-1.170500555,1,1,0
1963,9,44,7,57,50,1,1182.059,50,700.044,LESS,-54,434,380,1,2,-7,-0.656185922,7,-0.349215148,-0.100031696,-1.023563076,107,57,50,0,-1.057086457,-0.897383758,-1.170500555,-0.483207941,-0.089011083,0.089011083,-1.170500555,-0.897383758,0,1,0
1964,9,45,18,42,50,1,1396.51,80,1137.744,LESS,60,438,498,1,2,8,0.749926769,8,-0.174607574,0.991223165,-0.642881741,92,42,50,1,-1.356261869,-1.482634036,-1.170500555,-0.483207941,0.230503903,0.230503903,-1.170500555,-1.482634036,1,1,1
1965,9,46,51,108,110,1,1930.006,20,1261.313,LESS,-346,762,416,1,2,2,0.187481692,2,-1.222253018,-1.191286556,0.304150306,218,108,110,1,1.156811594,1.092467184,1.170500555,-0.483207941,-0.907417889,0.907417889,1.170500555,1.092467184,0,1,0
1966,9,47,31,78,80,1,1308.294,20,1022.559,LESS,-50,402,352,1,2,2,0.187481692,2,-1.222253018,-1.191286556,-0.799477815,158,78,80,1,-0.039890055,-0.07803337,0,-0.483207941,-0.077800031,0.077800031,0,-0.07803337,0,0,0
1967,9,48,58,110,92,1,1036.766,80,732.857,LESS,-148,464,316,1,2,-18,-1.687335229,18,1.571468165,0.991223165,-1.281479025,202,110,92,0,0.837691154,1.170500555,0.468200222,-0.483207941,-0.352470808,0.352470808,0.468200222,1.170500555,1,0,0
1968,9,49,12,50,48,0,1449.936,0,1954.664,LESS,-352,766,414,1,1,-2,-0.187481692,2,-1.222253018,-1.918789796,-0.548042916,98,50,48,0,-1.236591704,-1.170500555,-1.248533925,-0.483207941,-0.924234467,0.924234467,-1.248533925,-1.170500555,0,0,0
1969,9,50,54,110,101,1,1058.787,50,1170.882,LESS,172,386,558,1,2,-9,-0.843667615,9,0,-0.100031696,-1.242388587,211,110,101,0,1.017196402,1.170500555,0.819350388,-0.483207941,0.544413363,0.544413363,0.819350388,1.170500555,0,1,1
1970,9,51,14,46,50,0,1717.17,30,1005.505,LESS,-344,728,384,2,1,4,0.374963384,4,-0.87303787,-0.827534936,-0.073664172,96,46,50,1,-1.276481759,-1.326567295,-1.170500555,1.300944457,-0.901812363,0.901812363,-1.170500555,-1.326567295,0,1,0
1971,9,52,22,80,83,1,1076.954,70,828.628,LESS,-76,524,448,1,2,3,0.281222538,3,-1.047645444,0.627471545,-1.210139552,163,80,83,1,0.059835082,0,0.117050055,-0.483207941,-0.15067187,0.15067187,0.117050055,0,1,0,0
1972,9,53,6,50,56,0,1352.932,70,997.221,LESS,-4,370,366,1,2,6,0.562445076,6,-0.523822722,0.627471545,-0.720238952,106,50,56,1,-1.077031484,-1.170500555,-0.936400444,-0.483207941,0.051127069,0.051127069,-0.936400444,-1.170500555,1,0,0
1973,9,54,13,50,47,1,1215.279,30,1568.061,LESS,52,362,414,1,2,-3,-0.281222538,3,-1.047645444,-0.827534936,-0.964592804,97,50,47,0,-1.256536731,-1.170500555,-1.28755061,-0.483207941,0.208081799,0.208081799,-1.28755061,-1.170500555,0,0,1
1974,9,55,46,110,124,1,1333.758,70,1570.896,LESS,-32,344,312,1,2,14,1.312371845,14,0.87303787,0.627471545,-0.754275557,234,110,124,1,1.475932034,1.170500555,1.716734147,-0.483207941,-0.027350296,0.027350296,1.716734147,1.170500555,1,0,0
1975,9,56,27,91,80,1,1361.499,70,1626.493,LESS,-318,530,212,1,2,-11,-1.031149307,11,0.349215148,0.627471545,-0.705031296,171,91,80,0,0.219395302,0.429183537,0,-0.483207941,-0.828940524,0.828940524,0,0.429183537,1,0,0
1976,9,57,40,64,80,0,1991.731,80,1447.46,LESS,-44,808,764,2,1,16,1.499853537,16,1.222253018,0.991223165,0.413721049,144,64,80,1,-0.31912044,-0.624266962,0,1.300944457,-0.060983452,0.060983452,0,-0.624266962,1,1,0
1977,9,58,22,83,80,1,1165.253,70,1404.915,LESS,26,414,440,1,2,-3,-0.281222538,3,-1.047645444,0.627471545,-1.053396141,163,83,80,0,0.059835082,0.117050055,0,-0.483207941,0.13520996,0.13520996,0,0.117050055,1,0,1
1978,9,59,54,101,110,1,1295.232,30,1194.45,LESS,-94,528,434,2,1,9,0.843667615,9,0,-0.827534936,-0.822664742,211,101,110,1,1.017196402,0.819350388,1.170500555,1.300944457,-0.201121604,0.201121604,1.170500555,0.819350388,0,1,0
1979,9,60,6,56,50,0,1256.585,20,1519.933,LESS,-58,380,322,1,2,-6,-0.562445076,6,-0.523822722,-1.191286556,-0.891268719,106,56,50,0,-1.077031484,-0.936400444,-1.170500555,-0.483207941,-0.100222135,0.100222135,-1.170500555,-0.936400444,0,0,0
1980,9,61,18,50,42,1,1705.955,30,1189.575,LESS,-380,870,490,1,1,-8,-0.749926769,8,-0.174607574,-0.827534936,-0.093572409,92,50,42,0,-1.356261869,-1.170500555,-1.482634036,-0.483207941,-1.002711832,1.002711832,-1.482634036,-1.170500555,0,0,0
1981,9,62,43,110,117,0,1967.892,0,574.493,LESS,-1070,1544,474,2,1,7,0.656185922,7,-0.349215148,-1.918789796,0.371403399,227,110,117,1,1.336316841,1.170500555,1.443617351,1.300944457,-2.936618327,2.936618327,1.443617351,1.170500555,0,1,0
1982,9,63,32,77,80,0,1166.65,60,1180.07,LESS,472,274,746,1,2,3,0.281222538,3,-1.047645444,0.263719925,-1.050916265,157,77,80,1,-0.059835082,-0.117050055,0,-0.483207941,1.385242274,1.385242274,0,-0.117050055,1,1,1
1983,9,64,27,80,91,0,1645.865,80,1350.473,LESS,248,582,830,2,2,11,1.031149307,11,0.349215148,0.991223165,-0.200240792,171,80,91,1,0.219395302,0,0.429183537,1.300944457,0.757423354,0.757423354,0.429183537,0,1,1,1
1984,9,65,16,44,50,0,1589.229,80,1240.221,LESS,718,590,1308,2,2,6,0.562445076,6,-0.523822722,0.991223165,-0.300777829,94,44,50,1,-1.316371814,-1.404600665,-1.170500555,1.300944457,2.074721981,2.074721981,-1.170500555,-1.404600665,1,1,1
1985,9,66,7,50,57,1,2286.502,100,1620.645,LESS,162,482,644,1,2,7,0.656185922,7,-0.349215148,1.718726405,0.936981923,107,50,57,1,-1.057086457,-1.170500555,-0.897383758,-0.483207941,0.516385733,0.516385733,-0.897383758,-1.170500555,1,1,1
1986,9,67,14,50,46,1,1508.455,20,2165.993,LESS,12,404,416,1,2,-4,-0.374963384,4,-0.87303787,-1.191286556,-0.444163283,96,50,46,0,-1.276481759,-1.170500555,-1.326567295,-0.483207941,0.095971278,0.095971278,-1.326567295,-1.170500555,0,1,1
1987,9,68,51,110,108,1,1655.83,80,1143.956,LESS,2,464,466,1,2,-2,-0.187481692,2,-1.222253018,0.991223165,-0.182551485,218,110,108,0,1.156811594,1.170500555,1.092467184,-0.483207941,0.067943647,0.067943647,1.092467184,1.170500555,1,1,0
1988,9,69,50,133,110,1,1218.214,80,1786.25,LESS,204,500,704,1,2,-23,-2.15603946,23,2.444506035,0.991223165,-0.959382757,243,133,110,0,1.655437281,2.067884313,1.170500555,-0.483207941,0.63410178,0.63410178,1.170500555,2.067884313,1,1,1
1989,9,70,49,131,110,1,1249.66,30,1637.3,LESS,-122,544,422,1,1,-21,-1.968557767,21,2.095290887,-0.827534936,-0.903561589,241,131,110,0,1.615547226,1.989850943,1.170500555,-0.483207941,-0.279598969,0.279598969,1.170500555,1.989850943,0,1,0
1990,9,71,47,126,110,1,2072.901,70,1154.409,LESS,142,336,478,1,2,-16,-1.499853537,16,1.222253018,0.627471545,0.55780946,236,126,110,0,1.515822089,1.794767517,1.170500555,-0.483207941,0.460330472,0.460330472,1.170500555,1.794767517,1,1,1
1991,9,72,50,110,133,1,2098.476,10,1825.774,LESS,-1506,1994,488,2,1,23,2.15603946,23,2.444506035,-1.555038176,0.60320876,243,110,133,1,1.655437281,1.170500555,2.067884313,1.300944457,-4.15862301,4.15862301,2.067884313,1.170500555,0,1,0
1992,9,73,47,110,126,0,2318.618,30,1647.507,LESS,-432,892,460,2,1,16,1.499853537,16,1.222253018,-0.827534936,0.993992437,236,110,126,1,1.515822089,1.170500555,1.794767517,1.300944457,-1.14845551,1.14845551,1.794767517,1.170500555,0,1,0
1993,9,74,12,48,50,0,1977.603,60,1082.459,LESS,144,420,564,1,2,2,0.187481692,2,-1.222253018,0.263719925,0.388641819,98,48,50,1,-1.236591704,-1.248533925,-1.170500555,-0.483207941,0.465935998,0.465935998,-1.170500555,-1.248533925,1,1,1
1994,9,75,32,80,77,0,2210.398,60,1388.313,LESS,-486,1014,528,2,1,-3,-0.281222538,3,-1.047645444,0.263719925,0.801886389,157,80,77,0,-0.059835082,0,-0.117050055,1.300944457,-1.299804714,1.299804714,-0.117050055,0,1,1,0
1995,9,76,43,117,110,1,2364.363,10,2329.384,LESS,-676,1648,972,1,1,-7,-0.656185922,7,-0.349215148,-1.555038176,1.075196384,227,117,110,0,1.336316841,1.443617351,1.170500555,-0.483207941,-1.832329691,1.832329691,1.170500555,1.443617351,0,1,0
1996,9,77,40,80,64,1,2040.86,60,1167.177,LESS,-206,744,538,1,1,-16,-1.499853537,16,1.222253018,0.263719925,0.500932082,144,80,64,0,-0.31912044,0,-0.624266962,-0.483207941,-0.515031064,0.515031064,-0.624266962,0,0,1,0
1997,9,78,31,80,78,1,1994.293,40,1173.153,LESS,-478,864,386,2,1,-2,-0.187481692,2,-1.222253018,-0.463783316,0.418268967,158,80,78,0,-0.039890055,0,-0.07803337,1.300944457,-1.27738261,1.27738261,-0.07803337,0,0,1,0
1998,9,79,46,124,110,1,1529.798,70,1274.992,LESS,-200,590,390,2,1,-14,-1.312371845,14,0.87303787,0.627471545,-0.406276392,234,124,110,0,1.475932034,1.716734147,1.170500555,1.300944457,-0.498214486,0.498214486,1.170500555,1.716734147,1,1,0
1999,9,80,58,92,110,0,2425.836,30,1585.763,LESS,2216,970,3186,2,2,18,1.687335229,18,1.571468165,-0.827534936,1.184319791,202,92,110,1,0.837691154,0.468200222,1.170500555,1.300944457,6.273261008,6.273261008,1.170500555,0.468200222,0,1,1
2000,9,81,48,128,110,0,1749.954,60,749.114,MORE,116,264,380,1,1,-18,-1.687335229,18,1.571468165,0.263719925,-0.015467862,238,128,110,1,1.555712144,1.872800887,1.170500555,-0.483207941,0.387458633,0.387458633,1.170500555,1.872800887,1,1,1
2001,9,82,8,50,58,1,1325.432,70,477.407,MORE,-24,374,350,1,2,8,0.749926769,8,-0.174607574,0.627471545,-0.769055403,108,50,58,0,-1.037141429,-1.170500555,-0.858367073,-0.483207941,-0.004928192,0.004928192,-0.858367073,-1.170500555,1,1,0
2002,9,83,4,54,50,0,1223.842,20,635.457,MORE,124,268,392,1,2,-4,-0.374963384,4,-0.87303787,-1.191286556,-0.949392248,104,54,50,1,-1.116921539,-1.014433814,-1.170500555,-0.483207941,0.409880738,0.409880738,-1.170500555,-1.014433814,0,1,1
2003,9,84,37,80,69,0,1031.857,70,800.603,MORE,36,322,358,1,2,-11,-1.031149307,11,0.349215148,0.627471545,-1.290193206,149,80,69,1,-0.219395302,0,-0.429183537,-0.483207941,0.16323759,0.16323759,-0.429183537,0,1,1,1
2004,9,85,52,105,110,0,1167.827,20,878.687,MORE,110,300,410,1,2,5,0.46870423,5,-0.698430296,-1.191286556,-1.048826921,215,105,110,0,1.096976512,0.975417129,1.170500555,-0.483207941,0.370642055,0.370642055,1.170500555,0.975417129,0,1,1
2005,9,86,5,55,50,1,1270.056,70,779.289,MORE,74,304,378,1,2,-5,-0.46870423,5,-0.698430296,0.627471545,-0.867355759,105,55,50,1,-1.096976512,-0.975417129,-1.170500555,-0.483207941,0.269742586,0.269742586,-1.170500555,-0.975417129,1,1,1
2006,9,87,30,96,80,0,1048.826,70,1060.065,MORE,66,434,500,1,2,-16,-1.499853537,16,1.222253018,0.627471545,-1.260070793,176,96,80,1,0.31912044,0.624266962,0,-0.483207941,0.247320482,0.247320482,0,0.624266962,1,1,1
2007,9,88,33,80,75,0,1234.482,60,1000.89,MORE,-120,378,258,1,2,-5,-0.46870423,5,-0.698430296,0.263719925,-0.93050472,155,80,75,1,-0.099725137,0,-0.195083426,-0.483207941,-0.273993443,0.273993443,-0.195083426,0,1,1,0
2008,9,89,48,110,128,1,1125.772,80,919.902,MORE,-116,382,266,1,2,18,1.687335229,18,1.571468165,0.991223165,-1.123480588,238,110,128,0,1.555712144,1.170500555,1.872800887,-0.483207941,-0.262782391,0.262782391,1.872800887,1.170500555,1,1,0
2009,9,90,9,59,50,1,1120.901,30,1321.293,MORE,-152,520,368,1,1,-9,-0.843667615,9,0,-0.827534936,-1.132127313,109,59,50,1,-1.017196402,-0.819350388,-1.170500555,-0.483207941,-0.36368186,0.36368186,-1.170500555,-0.819350388,0,1,0
2010,9,91,44,110,119,1,1388.587,0,678.881,MORE,-510,758,248,1,1,9,0.843667615,9,0,-1.918789796,-0.656946205,229,110,119,0,1.376206896,1.170500555,1.521650721,-0.483207941,-1.367071027,1.367071027,1.521650721,1.170500555,0,0,0
2011,9,92,2,52,50,1,1211.419,60,853.887,MORE,92,294,386,0,2,-2,-0.187481692,2,-1.222253018,0.263719925,-0.971444858,102,52,50,1,-1.156811594,-1.092467184,-1.170500555,-2.267360339,0.32019232,0.32019232,-1.170500555,-1.092467184,1,0,1
2012,9,93,8,58,50,1,1755.945,30,1129.32,MORE,-12,414,402,1,2,-8,-0.749926769,8,-0.174607574,-0.827534936,-0.004832977,108,58,50,1,-1.037141429,-0.858367073,-1.170500555,-0.483207941,0.028704965,0.028704965,-1.170500555,-0.858367073,0,0,0
2013,9,94,44,119,110,1,1567.646,90,1366.919,MORE,142,858,1000,1,2,-9,-0.843667615,9,0,1.354974785,-0.339090754,229,119,110,1,1.376206896,1.521650721,1.170500555,-0.483207941,0.460330472,0.460330472,1.170500555,1.521650721,1,0,1
2014,9,95,34,74,80,0,1723.37,0,940.376,MORE,-46,446,400,1,2,6,0.562445076,6,-0.523822722,-1.918789796,-0.062658282,154,74,80,0,-0.119670165,-0.234100111,0,-0.483207941,-0.066588978,0.066588978,0,-0.234100111,0,0,0
2015,9,96,24,86,80,0,1767.759,60,1046.874,MORE,66,452,518,0,2,-6,-0.562445076,6,-0.523822722,0.263719925,0.016138571,166,86,80,1,0.119670165,0.234100111,0,-2.267360339,0.247320482,0.247320482,0,0.234100111,0,0,1
2016,9,97,39,66,80,1,1512.466,60,1802.502,MORE,126,370,496,1,2,14,1.312371845,14,0.87303787,0.263719925,-0.437043182,146,66,80,0,-0.279230385,-0.546233592,0,-0.483207941,0.415486264,0.415486264,0,-0.546233592,1,0,1
2017,9,98,9,50,59,1,1487.663,50,937.339,MORE,52,396,448,1,2,9,0.843667615,9,0,-0.100031696,-0.48107207,109,50,59,0,-1.017196402,-1.170500555,-0.819350388,-0.483207941,0.208081799,0.208081799,-0.819350388,-1.170500555,0,0,1
2018,9,99,57,94,110,1,1124.705,60,991.578,MORE,94,354,448,1,2,16,1.499853537,16,1.222253018,0.263719925,-1.125374666,204,94,110,0,0.877581209,0.546233592,1.170500555,-0.483207941,0.325797847,0.325797847,1.170500555,0.546233592,0,0,1
2019,9,100,60,110,87,0,1128.118,80,1527.308,MORE,180,364,544,1,2,-23,-2.15603946,23,2.444506035,0.991223165,-1.119316101,197,110,87,1,0.737966017,1.170500555,0.273116796,-0.483207941,0.566835468,0.566835468,0.273116796,1.170500555,1,0,1
2020,9,101,33,75,80,0,1062.346,30,812.387,MORE,-88,402,314,1,1,5,0.46870423,5,-0.698430296,-0.827534936,-1.23607085,155,75,80,0,-0.099725137,-0.195083426,0,-0.483207941,-0.184305026,0.184305026,0,-0.195083426,0,0,0
2021,9,102,15,50,45,0,1247.627,100,1249.066,MORE,790,426,1216,1,2,-5,-0.46870423,5,-0.698430296,1.718726405,-0.907170456,95,50,45,1,-1.296426786,-1.170500555,-1.36558398,-0.483207941,2.276520919,2.276520919,-1.36558398,-1.170500555,1,0,1
2022,9,103,59,89,110,0,1209.127,20,1023.109,MORE,-20,390,370,1,2,21,1.968557767,21,2.095290887,-1.191286556,-0.975513488,199,89,110,0,0.777856072,0.351150166,1.170500555,-0.483207941,0.00628286,0.00628286,1.170500555,0.351150166,0,0,0
2023,9,104,29,80,94,0,2503.048,60,705.681,MORE,-244,950,706,2,1,14,1.312371845,14,0.87303787,0.263719925,1.321382184,174,80,94,0,0.279230385,0,0.546233592,1.300944457,-0.621536059,0.621536059,0.546233592,0,0,1,0
2024,9,105,55,110,98,0,2142.45,70,1510.238,MORE,-64,684,620,0,2,-12,-1.124890153,12,0.523822722,0.627471545,0.681268927,208,110,98,1,0.957361319,1.170500555,0.702300333,-2.267360339,-0.117038713,0.117038713,0.702300333,1.170500555,1,0,0
2025,9,106,29,94,80,0,3268.297,10,1446.036,MORE,-538,1330,792,1,1,-14,-1.312371845,14,0.87303787,-1.555038176,2.679809102,174,94,80,1,0.279230385,0.546233592,0,-0.483207941,-1.445548392,1.445548392,0,0.546233592,0,0,0
2026,9,107,57,110,94,0,1632.447,20,1420.326,MORE,-172,626,454,1,2,-16,-1.499853537,16,1.222253018,-1.191286556,-0.224059669,204,110,94,1,0.877581209,1.170500555,0.546233592,-0.483207941,-0.419737121,0.419737121,0.546233592,1.170500555,0,0,0
2027,9,108,39,80,66,0,1724.622,100,2095.199,MORE,448,648,1096,2,2,-14,-1.312371845,14,0.87303787,1.718726405,-0.060435802,146,80,66,1,-0.279230385,0,-0.546233592,1.300944457,1.317975961,1.317975961,-0.546233592,0,1,1,1
2028,9,109,4,50,54,1,1463.996,60,1357.527,MORE,148,374,522,1,2,4,0.374963384,4,-0.87303787,0.263719925,-0.523084396,104,50,54,0,-1.116921539,-1.170500555,-1.014433814,-0.483207941,0.47714705,0.47714705,-1.014433814,-1.170500555,0,0,1
2029,9,110,55,98,110,0,1469.633,80,839.83,MORE,-16,416,400,1,2,12,1.124890153,12,0.523822722,0.991223165,-0.513077911,208,98,110,0,0.957361319,0.702300333,1.170500555,-0.483207941,0.017493913,0.017493913,1.170500555,0.702300333,1,0,0
2030,9,111,2,50,52,1,1770.168,0,1451.894,MORE,-314,746,432,1,1,2,0.187481692,2,-1.222253018,-1.918789796,0.020414892,102,50,52,0,-1.156811594,-1.170500555,-1.092467184,-0.483207941,-0.817729472,0.817729472,-1.092467184,-1.170500555,0,0,0
2031,9,112,59,110,89,0,1734.978,90,1439.47,MORE,50,652,702,1,2,-21,-1.968557767,21,2.095290887,1.354974785,-0.042052414,199,110,89,1,0.777856072,1.170500555,0.351150166,-0.483207941,0.202476273,0.202476273,0.351150166,1.170500555,1,0,1
2032,9,113,60,87,110,1,1830.813,70,1045.378,MORE,266,280,546,1,2,23,2.15603946,23,2.444506035,0.627471545,0.12806848,197,87,110,0,0.737966017,0.273116796,1.170500555,-0.483207941,0.807873089,0.807873089,1.170500555,0.273116796,1,0,1
2033,9,114,52,110,105,0,1773.786,70,1510.846,MORE,-166,658,492,2,2,-5,-0.46870423,5,-0.698430296,0.627471545,0.026837362,215,110,105,1,1.096976512,1.170500555,0.975417129,1.300944457,-0.402920543,0.402920543,0.975417129,1.170500555,1,1,0
2034,9,115,30,80,96,1,1453.213,70,1548.391,MORE,-130,598,468,1,2,16,1.499853537,16,1.222253018,0.627471545,-0.54222577,176,80,96,0,0.31912044,0,0.624266962,-0.483207941,-0.302021073,0.302021073,0.624266962,0,1,0,0
2035,9,116,24,80,86,0,1650.519,80,1110.384,MORE,154,972,1126,2,1,6,0.562445076,6,-0.523822722,0.991223165,-0.191979273,166,80,86,0,0.119670165,0,0.234100111,1.300944457,0.493963629,0.493963629,0.234100111,0,1,1,1
2036,9,117,5,50,55,1,1518.317,60,1182.168,MORE,732,528,1260,2,1,5,0.46870423,5,-0.698430296,0.263719925,-0.426656816,105,50,55,0,-1.096976512,-1.170500555,-0.975417129,1.300944457,2.113960663,2.113960663,-0.975417129,-1.170500555,0,1,1
2037,9,118,34,80,74,0,1905.45,70,1780.57,MORE,-220,630,410,2,1,-6,-0.562445076,6,-0.523822722,0.627471545,0.260559878,154,80,74,1,-0.119670165,0,-0.234100111,1.300944457,-0.554269747,0.554269747,-0.234100111,0,1,1,0
2038,9,119,15,45,50,0,1860.143,30,960.872,MORE,-112,576,464,2,1,5,0.46870423,5,-0.698430296,-0.827534936,0.180133443,95,45,50,0,-1.296426786,-1.36558398,-1.170500555,1.300944457,-0.251571339,0.251571339,-1.170500555,-1.36558398,0,1,0
2039,9,120,37,69,80,0,1720.63,40,912.29,MORE,-102,660,558,2,1,11,1.031149307,11,0.349215148,-0.463783316,-0.067522175,149,69,80,0,-0.219395302,-0.429183537,0,1.300944457,-0.223543708,0.223543708,0,-0.429183537,0,1,0
2040,9,121,48,128,110,0,1300.872,60,1333.149,LESS,450,274,724,1,2,-18,-1.687335229,18,1.571468165,0.263719925,-0.812652932,238,128,110,0,1.555712144,1.872800887,1.170500555,-0.483207941,1.323581487,1.323581487,1.170500555,1.872800887,0,1,1
2041,9,122,8,50,58,0,1054.751,60,1074.273,LESS,-64,356,292,1,2,8,0.749926769,8,-0.174607574,0.263719925,-1.249553067,108,50,58,1,-1.037141429,-1.170500555,-0.858367073,-0.483207941,-0.117038713,0.117038713,-0.858367073,-1.170500555,1,1,0
2042,9,123,4,54,50,0,1106.469,70,1389.364,LESS,-260,598,338,2,1,-4,-0.374963384,4,-0.87303787,0.627471545,-1.157746186,104,54,50,0,-1.116921539,-1.014433814,-1.170500555,1.300944457,-0.666380268,0.666380268,-1.170500555,-1.014433814,1,1,0
2043,9,124,37,80,69,1,1347.055,70,1087.779,LESS,18,340,358,1,2,-11,-1.031149307,11,0.349215148,0.627471545,-0.730671471,149,80,69,0,-0.219395302,0,-0.429183537,-0.483207941,0.112787856,0.112787856,-0.429183537,0,1,0,1
2044,9,125,52,105,110,1,2228.3,30,1946.494,LESS,-1626,2102,476,2,1,5,0.46870423,5,-0.698430296,-0.827534936,0.833665011,215,105,110,1,1.096976512,0.975417129,1.170500555,1.300944457,-4.494954574,4.494954574,1.170500555,0.975417129,0,1,0
2045,9,126,5,55,50,0,2428.003,60,1331.165,LESS,208,444,652,1,2,-5,-0.46870423,5,-0.698430296,0.263719925,1.188166528,105,55,50,0,-1.096976512,-0.975417129,-1.170500555,-0.483207941,0.645312833,0.645312833,-1.170500555,-0.975417129,1,0,1
2046,9,127,30,96,80,1,1249.481,0,712.663,LESS,38,318,356,1,2,-16,-1.499853537,16,1.222253018,-1.918789796,-0.90387934,176,96,80,0,0.31912044,0.624266962,0,-0.483207941,0.168843117,0.168843117,0,0.624266962,0,0,1
2047,9,128,33,80,75,1,1192.81,80,1271.143,LESS,42,374,416,1,2,-5,-0.46870423,5,-0.698430296,0.991223165,-1.004478507,155,80,75,0,-0.099725137,0,-0.195083426,-0.483207941,0.180054169,0.180054169,-0.195083426,0,1,0,1
2048,9,129,48,110,128,0,1595.585,60,1647.628,LESS,-88,556,468,1,2,18,1.687335229,18,1.571468165,0.263719925,-0.289495015,238,110,128,1,1.555712144,1.170500555,1.872800887,-0.483207941,-0.184305026,0.184305026,1.872800887,1.170500555,1,0,0
2049,9,130,9,59,50,0,2120.993,80,1181.07,LESS,-132,536,404,1,2,-9,-0.843667615,9,0,0.991223165,0.64317967,109,59,50,0,-1.017196402,-0.819350388,-1.170500555,-0.483207941,-0.307626599,0.307626599,-1.170500555,-0.819350388,1,0,0
2050,9,131,44,110,119,1,1511.851,20,1682.61,LESS,36,368,404,1,2,9,0.843667615,9,0,-1.191286556,-0.438134895,229,110,119,1,1.376206896,1.170500555,1.521650721,-0.483207941,0.16323759,0.16323759,1.521650721,1.170500555,0,0,1
2051,9,132,2,52,50,0,1884.494,70,922.566,LESS,140,440,580,1,2,-2,-0.187481692,2,-1.222253018,0.627471545,0.223359967,102,52,50,0,-1.156811594,-1.092467184,-1.170500555,-0.483207941,0.454724946,0.454724946,-1.170500555,-1.092467184,1,0,1
2052,9,133,8,58,50,1,2066.95,80,808.148,LESS,606,508,1114,1,2,-8,-0.749926769,8,-0.174607574,0.991223165,0.54724558,108,58,50,0,-1.037141429,-0.858367073,-1.170500555,-0.483207941,1.760812521,1.760812521,-1.170500555,-0.858367073,1,0,1
2053,9,134,44,119,110,1,2003.251,10,1528.899,LESS,-168,548,380,2,1,-9,-0.843667615,9,0,-1.555038176,0.434170704,229,119,110,0,1.376206896,1.521650721,1.170500555,1.300944457,-0.408526069,0.408526069,1.170500555,1.521650721,0,1,0
2054,9,135,34,74,80,1,1867.288,70,1153.801,LESS,-68,464,396,1,2,6,0.562445076,6,-0.523822722,0.627471545,0.192816845,154,74,80,1,-0.119670165,-0.234100111,0,-0.483207941,-0.128249765,0.128249765,0,-0.234100111,1,0,0
2055,9,136,24,86,80,1,2675.363,90,1190.998,LESS,498,504,1002,1,2,-6,-0.562445076,6,-0.523822722,1.354974785,1.627266066,166,86,80,0,0.119670165,0.234100111,0,-0.483207941,1.458114113,1.458114113,0,0.234100111,1,0,1
2056,9,137,39,66,80,0,1946.074,40,1048.038,LESS,94,400,494,1,2,14,1.312371845,14,0.87303787,-0.463783316,0.332673314,146,66,80,1,-0.279230385,-0.546233592,0,-0.483207941,0.325797847,0.325797847,0,-0.546233592,0,0,1
2057,9,138,9,50,59,1,1418.258,80,1131.337,LESS,8,360,368,1,2,9,0.843667615,9,0,0.991223165,-0.604275917,109,50,59,1,-1.017196402,-1.170500555,-0.819350388,-0.483207941,0.084760225,0.084760225,-0.819350388,-1.170500555,1,0,1
2058,9,139,57,94,110,1,1381.159,60,1173.658,LESS,54,234,288,1,2,16,1.499853537,16,1.222253018,0.263719925,-0.670131972,204,94,110,1,0.877581209,0.546233592,1.170500555,-0.483207941,0.213687325,0.213687325,1.170500555,0.546233592,1,0,1
2059,9,140,60,110,87,1,3053.123,10,992.004,LESS,-352,600,248,1,1,-23,-2.15603946,23,2.444506035,-1.555038176,2.297844338,197,110,87,0,0.737966017,1.170500555,0.273116796,-0.483207941,-0.924234467,0.924234467,0.273116796,1.170500555,0,0,0
2060,9,141,33,75,80,0,1265.693,100,2169.741,LESS,152,158,310,0,1,5,0.46870423,5,-0.698430296,1.718726405,-0.875100711,155,75,80,1,-0.099725137,-0.195083426,0,-2.267360339,0.488358103,0.488358103,0,-0.195083426,1,0,1
2061,9,142,15,50,45,1,1815.269,80,1120.603,LESS,-134,530,396,1,2,-5,-0.46870423,5,-0.698430296,0.991223165,0.100475646,95,50,45,0,-1.296426786,-1.170500555,-1.36558398,-0.483207941,-0.313232126,0.313232126,-1.36558398,-1.170500555,1,0,0
2062,9,143,59,89,110,0,1339.931,0,1344.058,LESS,-154,364,210,1,2,21,1.968557767,21,2.095290887,-1.918789796,-0.743317595,199,89,110,1,0.777856072,0.351150166,1.170500555,-0.483207941,-0.369287386,0.369287386,1.170500555,0.351150166,0,0,0
2063,9,144,29,80,94,0,1271.036,30,1097.959,LESS,78,298,376,1,2,14,1.312371845,14,0.87303787,-0.827534936,-0.865616118,174,80,94,1,0.279230385,0,0.546233592,-0.483207941,0.280953638,0.280953638,0.546233592,0,0,0,1
2064,9,145,55,110,98,1,1844.011,20,1904.943,LESS,28,410,438,1,2,-12,-1.124890153,12,0.523822722,-1.191286556,0.151496826,208,110,98,0,0.957361319,1.170500555,0.702300333,-0.483207941,0.140815486,0.140815486,0.702300333,1.170500555,0,0,1
2065,9,146,29,94,80,1,1857.445,80,1564.474,LESS,-176,552,376,1,2,-14,-1.312371845,14,0.87303787,0.991223165,0.175344106,174,94,80,0,0.279230385,0.546233592,0,-0.483207941,-0.430948173,0.430948173,0,0.546233592,1,0,0
2066,9,147,57,110,94,1,1799.812,40,963.996,LESS,22,456,478,1,2,-16,-1.499853537,16,1.222253018,-0.463783316,0.073037251,204,110,94,0,0.877581209,1.170500555,0.546233592,-0.483207941,0.123998908,0.123998908,0.546233592,1.170500555,0,0,1
2067,9,148,39,80,66,1,1272.332,90,1073.313,LESS,402,338,740,1,2,-14,-1.312371845,14,0.87303787,1.354974785,-0.863315532,146,80,66,0,-0.279230385,0,-0.546233592,-0.483207941,1.189048861,1.189048861,-0.546233592,0,1,0,1
2068,9,149,4,50,54,1,1205.468,30,863.425,LESS,-74,370,296,1,1,4,0.374963384,4,-0.87303787,-0.827534936,-0.982008738,104,50,54,1,-1.116921539,-1.170500555,-1.014433814,-0.483207941,-0.145066343,0.145066343,-1.014433814,-1.170500555,0,0,0
2069,9,150,55,98,110,1,1390.371,20,1262.095,LESS,68,318,386,1,2,12,1.124890153,12,0.523822722,-1.191286556,-0.653779348,208,98,110,1,0.957361319,0.702300333,1.170500555,-0.483207941,0.252926008,0.252926008,1.170500555,0.702300333,0,0,1
2070,9,151,2,50,52,1,1908.069,60,570.001,LESS,-80,498,418,1,1,2,0.187481692,2,-1.222253018,0.263719925,0.265208979,102,50,52,1,-1.156811594,-1.170500555,-1.092467184,-0.483207941,-0.161882922,0.161882922,-1.092467184,-1.170500555,0,0,0
2071,9,152,59,110,89,0,1424.142,0,1527.69,LESS,-30,386,356,1,1,-21,-1.968557767,21,2.095290887,-1.918789796,-0.593830971,199,110,89,0,0.777856072,1.170500555,0.351150166,-0.483207941,-0.02174477,0.02174477,0.351150166,1.170500555,0,0,0
2072,9,153,60,87,110,0,1372.099,30,1174.37,LESS,-144,510,366,1,1,23,2.15603946,23,2.444506035,-0.827534936,-0.686214773,197,87,110,1,0.737966017,0.273116796,1.170500555,-0.483207941,-0.341259756,0.341259756,1.170500555,0.273116796,0,0,0
2073,9,154,52,110,105,1,2102.561,40,1264.619,LESS,-554,926,372,1,2,-5,-0.46870423,5,-0.698430296,-0.463783316,0.610460221,215,110,105,0,1.096976512,1.170500555,0.975417129,-0.483207941,-1.4903926,1.4903926,0.975417129,1.170500555,0,0,0
2074,9,155,30,80,96,0,4213.558,80,1287.324,LESS,618,928,1546,2,1,16,1.499853537,16,1.222253018,0.991223165,4.357783182,176,80,96,1,0.31912044,0,0.624266962,1.300944457,1.794445677,1.794445677,0.624266962,0,1,1,1
2075,9,156,24,80,86,0,1842.573,70,1315.883,LESS,58,446,504,1,2,6,0.562445076,6,-0.523822722,0.627471545,0.148944169,166,80,86,1,0.119670165,0,0.234100111,-0.483207941,0.224898377,0.224898377,0.234100111,0,1,0,1
2076,9,157,5,50,55,0,1551.521,80,1483.931,LESS,96,400,496,1,2,5,0.46870423,5,-0.698430296,0.991223165,-0.367714946,105,50,55,1,-1.096976512,-1.170500555,-0.975417129,-0.483207941,0.331403373,0.331403373,-0.975417129,-1.170500555,1,0,1
2077,9,158,34,80,74,1,1512.883,0,971.547,LESS,10,392,402,1,2,-6,-0.562445076,6,-0.523822722,-1.918789796,-0.436302947,154,80,74,0,-0.119670165,0,-0.234100111,-0.483207941,0.090365752,0.090365752,-0.234100111,0,0,0,1
2078,9,159,15,45,50,1,1877.203,30,2355.961,LESS,170,368,538,1,2,5,0.46870423,5,-0.698430296,-0.827534936,0.210417394,95,45,50,1,-1.296426786,-1.36558398,-1.170500555,-0.483207941,0.538807837,0.538807837,-1.170500555,-1.36558398,0,0,1
2079,9,160,37,69,80,0,2026.825,90,1252.561,LESS,816,1024,1840,2,2,11,1.031149307,11,0.349215148,1.354974785,0.476017941,149,69,80,1,-0.219395302,-0.429183537,0,1.300944457,2.349392758,2.349392758,0,-0.429183537,1,1,1
2080,9,161,3,50,53,1,1672.766,50,1766.74,MORE,-18,364,346,1,2,3,0.281222538,3,-1.047645444,-0.100031696,-0.152487652,103,50,53,0,-1.136866566,-1.170500555,-1.053450499,-0.483207941,0.011888387,0.011888387,-1.053450499,-1.170500555,0,0,0
2081,9,162,20,50,40,0,1211.748,80,1578.153,MORE,-20,276,256,1,2,-10,-0.937408461,10,0.174607574,0.991223165,-0.970860836,90,50,40,1,-1.396151924,-1.170500555,-1.560667406,-0.483207941,0.00628286,0.00628286,-1.560667406,-1.170500555,1,0,0
2082,9,163,25,80,88,1,1422.886,100,2605.97,MORE,120,270,390,1,2,8,0.749926769,8,-0.174607574,1.718726405,-0.596060552,168,80,88,0,0.15956022,0,0.312133481,-0.483207941,0.398669685,0.398669685,0.312133481,0,1,0,1
2083,9,164,42,115,110,0,1275.274,40,642.808,MORE,132,264,396,1,2,-5,-0.46870423,5,-0.698430296,-0.463783316,-0.858093059,225,115,110,1,1.296426786,1.36558398,1.170500555,-0.483207941,0.432302842,0.432302842,1.170500555,1.36558398,0,0,1
2084,9,165,53,103,110,0,1023.782,30,928.094,MORE,132,204,336,1,2,7,0.656185922,7,-0.349215148,-0.827534936,-1.304527491,213,103,110,0,1.057086457,0.897383758,1.170500555,-0.483207941,0.432302842,0.432302842,1.170500555,0.897383758,0,0,1
2085,9,166,26,90,80,0,1566.843,90,732.011,MORE,200,290,490,1,2,-10,-0.937408461,10,0.174607574,1.354974785,-0.340516195,170,90,80,1,0.199450275,0.390166852,0,-0.483207941,0.622890728,0.622890728,0,0.390166852,1,0,1
2086,9,167,35,80,72,0,1352.63,70,1106.364,MORE,92,272,364,1,2,-8,-0.749926769,8,-0.174607574,0.627471545,-0.720775046,152,80,72,1,-0.15956022,0,-0.312133481,-0.483207941,0.32019232,0.32019232,-0.312133481,0,1,0,1
2087,9,168,28,93,80,0,1244.595,90,1652.14,MORE,38,370,408,1,2,-13,-1.218630999,13,0.698430296,1.354974785,-0.912552692,173,93,80,1,0.259285357,0.507216907,0,-0.483207941,0.168843117,0.168843117,0,0.507216907,1,0,1
2088,9,169,26,80,90,1,1387.496,10,680.272,MORE,-2,344,342,1,2,10,0.937408461,10,0.174607574,-1.555038176,-0.658882886,170,80,90,0,0.199450275,0,0.390166852,-0.483207941,0.056732595,0.056732595,0.390166852,0,0,0,0
2089,9,170,25,88,80,0,1483.815,20,1191.05,MORE,166,282,448,1,2,-8,-0.749926769,8,-0.174607574,-1.191286556,-0.487902823,168,88,80,1,0.15956022,0.312133481,0,-0.483207941,0.527596785,0.527596785,0,0.312133481,0,0,1
2090,9,171,36,80,70,0,1461.872,20,1282.214,MORE,-84,432,348,1,1,-10,-0.937408461,10,0.174607574,-1.191286556,-0.526854801,150,80,70,1,-0.199450275,0,-0.390166852,-0.483207941,-0.173093974,0.173093974,-0.390166852,0,0,0,0
2091,9,172,28,80,93,1,1572.616,80,1139.168,MORE,170,322,492,1,2,13,1.218630999,13,0.698430296,0.991223165,-0.33026829,173,80,93,0,0.259285357,0,0.507216907,-0.483207941,0.538807837,0.538807837,0.507216907,0,1,0,1
2092,9,173,21,82,80,1,2036.769,0,1620.819,MORE,-28,446,418,2,1,-2,-0.187481692,2,-1.222253018,-1.918789796,0.493669969,162,82,80,1,0.039890055,0.07803337,0,1.300944457,-0.016139244,0.016139244,0,0.07803337,0,1,0
2093,9,174,19,50,41,1,1693.051,30,1058.282,MORE,34,378,412,1,2,-9,-0.843667615,9,0,-0.827534936,-0.116478863,91,50,41,1,-1.376206896,-1.170500555,-1.521650721,-0.483207941,0.157632064,0.157632064,-1.521650721,-1.170500555,0,0,1
2094,9,175,56,96,110,0,1715.57,40,1092.608,MORE,68,412,480,1,2,14,1.312371845,14,0.87303787,-0.463783316,-0.076504402,206,96,110,0,0.917471264,0.624266962,1.170500555,-0.483207941,0.252926008,0.252926008,1.170500555,0.624266962,0,0,1
2095,9,176,23,80,85,1,1660.916,40,934.628,MORE,22,444,466,1,2,5,0.46870423,5,-0.698430296,-0.463783316,-0.173523104,165,80,85,0,0.099725137,0,0.195083426,-0.483207941,0.123998908,0.123998908,0.195083426,0,0,0,1
2096,9,177,10,60,50,0,1437.479,80,1122.221,MORE,36,448,484,1,2,-10,-0.937408461,10,0.174607574,0.991223165,-0.57015588,110,60,50,1,-0.997251374,-0.780333703,-1.170500555,-0.483207941,0.16323759,0.16323759,-1.170500555,-0.780333703,1,0,1
2097,9,178,19,41,50,1,1768.642,70,1242.411,MORE,44,390,434,1,2,9,0.843667615,9,0,0.627471545,0.017706023,91,41,50,0,-1.376206896,-1.521650721,-1.170500555,-0.483207941,0.185659695,0.185659695,-1.170500555,-1.521650721,1,0,1
2098,9,179,56,110,96,0,1623.335,100,752.497,MORE,-34,426,392,1,2,-14,-1.312371845,14,0.87303787,1.718726405,-0.240234779,206,110,96,1,0.917471264,1.170500555,0.624266962,-0.483207941,-0.032955822,0.032955822,0.624266962,1.170500555,1,0,0
2099,9,180,35,72,80,0,1826.331,80,1008.876,MORE,-322,722,400,2,1,8,0.749926769,8,-0.174607574,0.991223165,0.120112286,152,72,80,0,-0.15956022,-0.312133481,0,1.300944457,-0.840151576,0.840151576,0,-0.312133481,1,1,0
2100,9,181,11,49,50,1,1082.646,30,1262.683,MORE,34,264,298,1,2,1,0.093740846,1,-1.396860592,-0.827534936,-1.200035434,99,49,50,0,-1.216646676,-1.20951724,-1.170500555,-0.483207941,0.157632064,0.157632064,-1.170500555,-1.20951724,0,0,1
2101,9,182,17,43,50,1,1115.761,70,173.438,MORE,86,246,332,1,2,7,0.656185922,7,-0.349215148,0.627471545,-1.141251551,93,43,50,0,-1.336316841,-1.443617351,-1.170500555,-0.483207941,0.303375742,0.303375742,-1.170500555,-1.443617351,1,0,1
2102,9,183,1,51,50,0,1659.308,80,488.063,MORE,104,268,372,1,2,-1,-0.093740846,1,-1.396860592,0.991223165,-0.176377535,101,51,50,1,-1.176756621,-1.131483869,-1.170500555,-0.483207941,0.353825477,0.353825477,-1.170500555,-1.131483869,1,0,1
2103,9,184,41,112,110,0,1612.594,30,1170.436,MORE,50,350,400,0,2,-2,-0.187481692,2,-1.222253018,-0.827534936,-0.259301597,222,112,110,1,1.236591704,1.248533925,1.170500555,-2.267360339,0.202476273,0.202476273,1.170500555,1.248533925,0,0,1
2104,9,185,20,40,50,1,2141.188,90,1020.769,MORE,46,358,404,0,1,10,0.937408461,10,0.174607574,1.354974785,0.679028696,90,40,50,0,-1.396151924,-1.560667406,-1.170500555,-2.267360339,0.191265221,0.191265221,-1.170500555,-1.560667406,1,0,1
2105,9,186,1,50,51,1,1843.804,50,1350.387,MORE,-76,552,476,1,2,1,0.093740846,1,-1.396860592,-0.100031696,0.151129371,101,50,51,0,-1.176756621,-1.170500555,-1.131483869,-0.483207941,-0.15067187,0.15067187,-1.131483869,-1.170500555,0,0,0
2106,9,187,23,85,80,0,3760.222,30,1124.61,MORE,-364,1374,1010,3,1,-5,-0.46870423,5,-0.698430296,-0.827534936,3.553046651,165,85,80,1,0.099725137,0.195083426,0,3.085096855,-0.957867624,0.957867624,0,0.195083426,0,1,0
2107,9,188,11,50,49,1,1652.673,60,981.64,MORE,136,386,522,1,2,-1,-0.093740846,1,-1.396860592,0.263719925,-0.188155614,99,50,49,1,-1.216646676,-1.170500555,-1.20951724,-0.483207941,0.443513894,0.443513894,-1.20951724,-1.170500555,0,0,1
2108,9,189,17,50,43,0,1279.538,70,1552.603,MORE,-34,392,358,1,2,-7,-0.656185922,7,-0.349215148,0.627471545,-0.850523847,93,50,43,1,-1.336316841,-1.170500555,-1.443617351,-0.483207941,-0.032955822,0.032955822,-1.443617351,-1.170500555,1,0,0
2109,9,190,21,80,82,1,1342.923,90,854.334,MORE,10,356,366,1,2,2,0.187481692,2,-1.222253018,1.354974785,-0.738006365,162,80,82,0,0.039890055,0,0.07803337,-0.483207941,0.090365752,0.090365752,0.07803337,0,1,0,0
2110,9,191,10,50,60,0,1662.773,70,1237.957,MORE,-280,648,368,2,1,10,0.937408461,10,0.174607574,0.627471545,-0.170226663,110,50,60,0,-0.997251374,-1.170500555,-0.780333703,1.300944457,-0.722435529,0.722435529,-0.780333703,-1.170500555,1,1,0
2111,9,192,3,53,50,0,2508.084,50,933.99,MORE,36,546,582,1,1,-3,-0.281222538,3,-1.047645444,-0.100031696,1.330321808,103,53,50,1,-1.136866566,-1.053450499,-1.170500555,-0.483207941,0.16323759,0.16323759,-1.170500555,-1.053450499,0,0,1
2112,9,193,45,122,110,0,3754.656,80,1087.499,MORE,-168,620,452,2,1,-12,-1.124890153,12,0.523822722,0.991223165,3.543166202,232,122,110,1,1.436041979,1.638700776,1.170500555,1.300944457,-0.408526069,0.408526069,1.170500555,1.638700776,1,1,0
2113,9,194,38,67,80,1,1307.697,10,671.171,MORE,-12,394,382,1,2,13,1.218630999,13,0.698430296,-1.555038176,-0.800537576,147,67,80,0,-0.259285357,-0.507216907,0,-0.483207941,0.028704965,0.028704965,0,-0.507216907,0,0,0
2114,9,195,38,80,67,0,1206.212,100,972.882,MORE,16,356,372,1,2,-13,-1.218630999,13,0.698430296,1.718726405,-0.980688031,147,80,67,1,-0.259285357,0,-0.507216907,-0.483207941,0.10718233,0.10718233,-0.507216907,0,1,0,0
2115,9,196,36,70,80,1,1185.462,30,771.083,MORE,186,156,342,1,2,10,0.937408461,10,0.174607574,-0.827534936,-1.017522262,150,70,80,0,-0.199450275,-0.390166852,0,-0.483207941,0.583652046,0.583652046,0,-0.390166852,0,0,1
2116,9,197,45,110,122,0,1392.939,50,1143.355,MORE,58,246,304,1,2,12,1.124890153,12,0.523822722,-0.100031696,-0.649220779,232,110,122,0,1.436041979,1.170500555,1.638700776,-0.483207941,0.224898377,0.224898377,1.638700776,1.170500555,0,0,1
2117,9,198,42,110,115,0,1522.491,90,1214.62,MORE,64,334,398,1,2,5,0.46870423,5,-0.698430296,1.354974785,-0.419247367,225,110,115,0,1.296426786,1.170500555,1.36558398,-0.483207941,0.241714955,0.241714955,1.36558398,1.170500555,1,0,1
2118,9,199,41,110,112,0,3121.925,40,1085.312,MORE,158,632,790,2,2,2,0.187481692,2,-1.222253018,-0.463783316,2.419977773,222,110,112,0,1.236591704,1.170500555,1.248533925,1.300944457,0.505174681,0.505174681,1.248533925,1.170500555,0,1,1
2119,9,200,53,110,103,0,1837.339,60,1272.476,MORE,-274,652,378,2,1,-7,-0.656185922,7,-0.349215148,0.263719925,0.139653067,213,110,103,1,1.057086457,1.170500555,0.897383758,1.300944457,-0.705618951,0.705618951,0.897383758,1.170500555,0,1,0
2120,9,201,3,50,53,0,2098.816,80,795.174,LESS,-146,654,508,2,1,3,0.281222538,3,-1.047645444,0.991223165,0.603812308,103,50,53,1,-1.136866566,-1.170500555,-1.053450499,1.300944457,-0.346865282,0.346865282,-1.053450499,-1.170500555,1,1,0
2121,9,202,20,50,40,1,3274.327,60,1322.926,LESS,88,872,960,2,2,-10,-0.937408461,10,0.174607574,0.263719925,2.690513218,90,50,40,0,-1.396151924,-1.170500555,-1.560667406,1.300944457,0.308981268,0.308981268,-1.560667406,-1.170500555,0,1,1
2122,9,203,25,80,88,1,1462.63,30,938.889,LESS,98,332,430,1,2,8,0.749926769,8,-0.174607574,-0.827534936,-0.525509242,168,80,88,1,0.15956022,0,0.312133481,-0.483207941,0.337008899,0.337008899,0.312133481,0,0,0,1
2123,9,204,42,115,110,1,1108.256,10,1128.342,LESS,-20,336,316,1,2,-5,-0.46870423,5,-0.698430296,-1.555038176,-1.154574005,225,115,110,0,1.296426786,1.36558398,1.170500555,-0.483207941,0.00628286,0.00628286,1.170500555,1.36558398,0,0,0
2124,9,205,53,103,110,0,1124.838,70,868.208,LESS,122,274,396,1,2,7,0.656185922,7,-0.349215148,0.627471545,-1.125138572,213,103,110,1,1.057086457,0.897383758,1.170500555,-0.483207941,0.404275211,0.404275211,1.170500555,0.897383758,1,0,1
2125,9,206,26,90,80,1,1977.762,30,881.238,LESS,-132,536,404,2,1,-10,-0.937408461,10,0.174607574,-0.827534936,0.388924067,170,90,80,0,0.199450275,0.390166852,0,1.300944457,-0.307626599,0.307626599,0,0.390166852,0,1,0
2126,9,207,35,80,72,1,2128.403,60,1391.614,LESS,772,358,1130,0,2,-8,-0.749926769,8,-0.174607574,0.263719925,0.656333484,152,80,72,0,-0.15956022,0,-0.312133481,-2.267360339,2.226071184,2.226071184,-0.312133481,0,1,0,1
2127,9,208,28,93,80,1,1435.476,80,937.069,LESS,2,498,500,1,2,-13,-1.218630999,13,0.698430296,0.991223165,-0.573711493,173,93,80,0,0.259285357,0.507216907,0,-0.483207941,0.067943647,0.067943647,0,0.507216907,1,0,0
2128,9,209,26,80,90,0,1761.884,0,1137.508,LESS,100,366,466,1,2,10,0.937408461,10,0.174607574,-1.918789796,0.005709602,170,80,90,1,0.199450275,0,0.390166852,-0.483207941,0.342614425,0.342614425,0.390166852,0,0,0,1
2129,9,210,25,88,80,1,1466.222,80,1356.469,LESS,222,350,572,1,2,-8,-0.749926769,8,-0.174607574,0.991223165,-0.519132926,168,88,80,0,0.15956022,0.312133481,0,-0.483207941,0.684551515,0.684551515,0,0.312133481,1,0,1
2130,9,211,36,80,70,1,1354.152,90,1003.913,LESS,82,406,488,1,2,-10,-0.937408461,10,0.174607574,1.354974785,-0.718073277,150,80,70,0,-0.199450275,0,-0.390166852,-0.483207941,0.29216469,0.29216469,-0.390166852,0,1,0,1
2131,9,212,28,80,93,0,1400.34,100,740.168,LESS,76,316,392,1,2,13,1.218630999,13,0.698430296,1.718726405,-0.636082941,173,80,93,1,0.259285357,0,0.507216907,-0.483207941,0.275348112,0.275348112,0.507216907,0,1,0,1
2132,9,213,21,82,80,1,1141.456,40,912.881,LESS,18,432,450,1,2,-2,-0.187481692,2,-1.222253018,-0.463783316,-1.095639235,162,82,80,0,0.039890055,0.07803337,0,-0.483207941,0.112787856,0.112787856,0,0.07803337,0,0,1
2133,9,214,19,50,41,0,1343.439,0,1791.023,LESS,68,330,398,1,2,-9,-0.843667615,9,0,-1.918789796,-0.737090391,91,50,41,0,-1.376206896,-1.170500555,-1.521650721,-0.483207941,0.252926008,0.252926008,-1.521650721,-1.170500555,0,1,1
2134,9,215,56,96,110,0,1688.372,60,1477.602,LESS,-128,484,356,2,1,14,1.312371845,14,0.87303787,0.263719925,-0.12478476,206,96,110,1,0.917471264,0.624266962,1.170500555,1.300944457,-0.296415547,0.296415547,1.170500555,0.624266962,1,1,0
2135,9,216,23,80,85,1,1452.339,20,1317.038,LESS,-178,576,398,1,1,5,0.46870423,5,-0.698430296,-1.191286556,-0.543777245,165,80,85,1,0.099725137,0,0.195083426,-0.483207941,-0.436553699,0.436553699,0.195083426,0,0,0,0
2136,9,217,10,60,50,1,1166.344,40,773.039,LESS,148,250,398,1,2,-10,-0.937408461,10,0.174607574,-0.463783316,-1.051459459,110,60,50,0,-0.997251374,-0.780333703,-1.170500555,-0.483207941,0.47714705,0.47714705,-1.170500555,-0.780333703,0,0,1
2137,9,218,19,41,50,0,1931.579,50,836.459,LESS,146,362,508,1,2,9,0.843667615,9,0,-0.100031696,0.306942607,91,41,50,1,-1.376206896,-1.521650721,-1.170500555,-0.483207941,0.471541524,0.471541524,-1.170500555,-1.521650721,0,0,1
2138,9,219,56,110,96,0,4314.135,30,849.405,LESS,-612,1084,472,1,1,-14,-1.312371845,14,0.87303787,-0.827534936,4.536321807,206,110,96,0,0.917471264,1.170500555,0.624266962,-0.483207941,-1.652952856,1.652952856,0.624266962,1.170500555,0,0,0
2139,9,220,35,72,80,0,1508.253,0,986.796,LESS,-418,834,416,2,1,8,0.749926769,8,-0.174607574,-1.918789796,-0.444521862,152,72,80,1,-0.15956022,-0.312133481,0,1.300944457,-1.109216828,1.109216828,0,-0.312133481,0,1,0
2140,9,221,11,49,50,0,1795.056,80,1020.084,LESS,-190,722,532,2,2,1,0.093740846,1,-1.396860592,0.991223165,0.064594667,99,49,50,1,-1.216646676,-1.20951724,-1.170500555,1.300944457,-0.470186856,0.470186856,-1.170500555,-1.20951724,1,1,0
2141,9,222,17,43,50,0,1577.658,70,1195.592,LESS,136,704,840,2,1,7,0.656185922,7,-0.349215148,0.627471545,-0.321318016,93,43,50,1,-1.336316841,-1.443617351,-1.170500555,1.300944457,0.443513894,0.443513894,-1.170500555,-1.443617351,1,1,1
2142,9,223,1,51,50,1,1424.673,100,1004.843,LESS,672,418,1090,1,2,-1,-0.093740846,1,-1.396860592,1.718726405,-0.59288837,101,51,50,0,-1.176756621,-1.131483869,-1.170500555,-0.483207941,1.945794881,1.945794881,-1.170500555,-1.131483869,1,1,1
2143,9,224,41,112,110,0,3135.489,20,994.972,LESS,-348,1298,950,4,1,-2,-0.187481692,2,-1.222253018,-1.191286556,2.444055822,222,112,110,0,1.236591704,1.248533925,1.170500555,4.869249253,-0.913023415,0.913023415,1.170500555,1.248533925,0,1,0
2144,9,225,20,40,50,0,1865.355,60,1406.608,LESS,-316,738,422,2,1,10,0.937408461,10,0.174607574,0.263719925,0.189385492,90,40,50,1,-1.396151924,-1.560667406,-1.170500555,1.300944457,-0.823334998,0.823334998,-1.170500555,-1.560667406,1,1,0
2145,9,226,1,50,51,0,1991.438,70,789.462,LESS,-186,634,448,2,1,1,0.093740846,1,-1.396860592,0.627471545,0.413200932,101,50,51,1,-1.176756621,-1.170500555,-1.131483869,1.300944457,-0.458975803,0.458975803,-1.131483869,-1.170500555,1,1,0
2146,9,227,23,85,80,1,2118.678,80,643.434,LESS,320,484,804,2,2,-5,-0.46870423,5,-0.698430296,0.991223165,0.639070212,165,85,80,0,0.099725137,0.195083426,0,1.300944457,0.959222292,0.959222292,0,0.195083426,1,1,1
2147,9,228,11,50,49,0,1691.866,30,832.968,LESS,-188,676,488,2,1,-1,-0.093740846,1,-1.396860592,-0.827534936,-0.118582408,99,50,49,0,-1.216646676,-1.170500555,-1.20951724,1.300944457,-0.464581329,0.464581329,-1.20951724,-1.170500555,0,1,0
2148,9,229,17,50,43,1,2304.968,60,1120.606,LESS,-232,904,672,3,2,-7,-0.656185922,7,-0.349215148,0.263719925,0.969761726,93,50,43,0,-1.336316841,-1.170500555,-1.443617351,3.085096855,-0.587902903,0.587902903,-1.443617351,-1.170500555,1,1,0
2149,9,230,21,80,82,1,1434.476,20,743.083,LESS,426,332,758,3,2,2,0.187481692,2,-1.222253018,-1.191286556,-0.575486637,162,80,82,1,0.039890055,0,0.07803337,3.085096855,1.256315174,1.256315174,0.07803337,0,0,1,1
2150,9,231,10,50,60,0,1629.369,50,750.243,LESS,-88,476,388,2,1,10,0.937408461,10,0.174607574,-0.100031696,-0.229523562,110,50,60,1,-0.997251374,-1.170500555,-0.780333703,1.300944457,-0.184305026,0.184305026,-0.780333703,-1.170500555,0,1,0
2151,9,232,3,53,50,1,1102.14,80,606.972,LESS,304,134,438,1,2,-3,-0.281222538,3,-1.047645444,0.991223165,-1.165430783,103,53,50,0,-1.136866566,-1.053450499,-1.170500555,-0.483207941,0.914378084,0.914378084,-1.170500555,-1.053450499,1,1,1
2152,9,233,45,122,110,1,1199.066,90,1183.045,LESS,256,68,324,1,2,-12,-1.124890153,12,0.523822722,1.354974785,-0.993373208,232,122,110,0,1.436041979,1.638700776,1.170500555,-0.483207941,0.779845458,0.779845458,1.170500555,1.638700776,1,1,1
2153,9,234,38,67,80,1,1727.324,20,765.622,LESS,188,254,442,2,1,13,1.218630999,13,0.698430296,-1.191286556,-0.055639364,147,67,80,1,-0.259285357,-0.507216907,0,1.300944457,0.589257572,0.589257572,0,-0.507216907,0,1,1
2154,9,235,38,80,67,1,1306.924,40,1052.019,LESS,34,414,448,1,2,-13,-1.218630999,13,0.698430296,-0.463783316,-0.801909762,147,80,67,0,-0.259285357,0,-0.507216907,-0.483207941,0.157632064,0.157632064,-0.507216907,0,0,0,1
2155,9,236,36,70,80,1,1751.975,80,708.913,LESS,-368,760,392,2,2,10,0.937408461,10,0.174607574,0.991223165,-0.011880297,150,70,80,1,-0.199450275,-0.390166852,0,1.300944457,-0.969078676,0.969078676,0,-0.390166852,1,1,0
2156,9,237,45,110,122,1,1602.222,0,750.923,LESS,-336,686,350,1,1,12,1.124890153,12,0.523822722,-1.918789796,-0.277713387,232,110,122,1,1.436041979,1.170500555,1.638700776,-0.483207941,-0.879390259,0.879390259,1.638700776,1.170500555,0,0,0
2157,9,238,42,110,115,1,3075.759,60,1014.196,LESS,414,806,1220,2,2,5,0.46870423,5,-0.698430296,0.263719925,2.33802649,225,110,115,1,1.296426786,1.170500555,1.36558398,1.300944457,1.222682018,1.222682018,1.36558398,1.170500555,1,1,1
2158,9,239,41,110,112,1,2489.889,60,1122.941,LESS,78,792,870,2,2,2,0.187481692,2,-1.222253018,0.263719925,1.298023069,222,110,112,1,1.236591704,1.170500555,1.248533925,1.300944457,0.280953638,0.280953638,1.248533925,1.170500555,1,1,1
2159,9,240,53,110,103,1,3025.539,10,861.719,LESS,156,834,990,2,1,-7,-0.656185922,7,-0.349215148,-1.555038176,2.248878775,213,110,103,0,1.057086457,1.170500555,0.897383758,1.300944457,0.499569155,0.499569155,0.897383758,1.170500555,0,1,1
2160,10,1,49,110,131,0,3736.991,34,2038.201,LESS,-404,1780,1376,3,1,21,1.968557767,21,2.095290887,-1.007736362,0.732438141,241,110,131,1,1.615547226,1.170500555,1.989850943,-0.116230188,-0.833138307,0.833138307,1.989850943,1.170500555,0,1,0
2161,10,2,13,47,50,0,1653.211,100,1759.474,LESS,1052,862,1914,2,2,3,0.281222538,3,-1.047645444,1.256454273,-0.672183121,97,47,50,1,-1.256536731,-1.28755061,-1.170500555,-0.736124524,0.966215517,0.966215517,-1.170500555,-1.28755061,1,0,1
2162,10,3,16,50,44,1,8416.123,24,941.431,LESS,504,3198,3702,6,2,-6,-0.562445076,6,-0.523822722,-1.35079555,3.886517887,94,50,44,0,-1.316371814,-1.170500555,-1.404600665,1.743452821,0.288986193,0.288986193,-1.404600665,-1.170500555,0,1,1
2163,10,4,7,57,50,1,2071.994,64,1083.678,LESS,66,1000,1066,3,2,-7,-0.656185922,7,-0.349215148,0.021441199,-0.389892521,107,57,50,0,-1.057086457,-0.897383758,-1.170500555,-0.116230188,-0.252302938,0.252302938,-1.170500555,-0.897383758,0,1,0
2164,10,5,18,42,50,0,1730.19,74,1409.571,LESS,-434,1062,628,2,1,8,0.749926769,8,-0.174607574,0.364500386,-0.620293603,92,42,50,1,-1.356261869,-1.482634036,-1.170500555,-0.736124524,-0.870212905,0.870212905,-1.170500555,-1.482634036,1,0,0
2165,10,6,51,108,110,1,2771.217,44,1342.941,LESS,706,1002,1708,3,2,2,0.187481692,2,-1.222253018,-0.664677175,0.081435302,218,108,110,1,1.156811594,1.092467184,1.170500555,-0.116230188,0.53862182,0.53862182,1.170500555,1.092467184,0,1,1
2166,10,7,31,78,80,1,2459.204,24,958.607,LESS,52,1254,1306,3,1,2,0.187481692,2,-1.222253018,-1.35079555,-0.12888445,158,78,80,1,-0.039890055,-0.07803337,0,-0.116230188,-0.269604417,0.269604417,0,-0.07803337,0,1,0
2167,10,8,58,110,92,1,2078.841,64,1213.024,LESS,324,732,1056,3,2,-18,-1.687335229,18,1.571468165,0.021441199,-0.385277139,202,110,92,0,0.837691154,1.170500555,0.468200222,-0.116230188,0.066538605,0.066538605,0.468200222,1.170500555,0,1,1
2168,10,9,12,50,48,1,2362.94,74,1452.685,LESS,286,898,1184,3,2,-2,-0.187481692,2,-1.222253018,0.364500386,-0.193773479,98,50,48,0,-1.236591704,-1.170500555,-1.248533925,-0.116230188,0.019577447,0.019577447,-1.248533925,-1.170500555,0,1,0
2169,10,10,54,110,101,1,2434.135,54,1784.13,LESS,652,934,1586,3,2,-9,-0.843667615,9,0,-0.321617988,-0.145782803,211,110,101,0,1.017196402,1.170500555,0.819350388,-0.116230188,0.471887543,0.471887543,0.819350388,1.170500555,0,1,1
2170,10,11,14,46,50,1,1757.168,0,6617.686,LESS,-1256,2300,1044,3,1,4,0.374963384,4,-0.87303787,-2.174137599,-0.602108443,96,46,50,1,-1.276481759,-1.326567295,-1.170500555,-0.116230188,-1.886056891,1.886056891,-1.170500555,-1.326567295,0,1,0
2171,10,12,22,80,83,1,5145.206,34,2001.978,LESS,708,1930,2638,6,2,3,0.281222538,3,-1.047645444,-1.007736362,1.681678814,163,80,83,1,0.059835082,0,0.117050055,1.743452821,0.54109346,0.54109346,0.117050055,0,0,1,1
2172,10,13,6,50,56,0,1340.961,84,1253.654,LESS,-116,822,706,2,2,6,0.562445076,6,-0.523822722,0.707559574,-0.882662629,106,50,56,1,-1.077031484,-1.170500555,-0.936400444,-0.736124524,-0.477222166,0.477222166,-0.936400444,-1.170500555,1,0,0
2173,10,14,13,50,47,0,3698.658,34,1062.811,LESS,-738,2166,1428,3,1,-3,-0.281222538,3,-1.047645444,-1.007736362,0.706598874,97,50,47,0,-1.256536731,-1.170500555,-1.28755061,-0.116230188,-1.245902165,1.245902165,-1.28755061,-1.170500555,0,1,0
2174,10,15,46,110,124,0,1507.605,14,2028.516,LESS,-954,1548,594,2,1,14,1.312371845,14,0.87303787,-1.693854737,-0.770332294,234,110,124,1,1.475932034,1.170500555,1.716734147,-0.736124524,-1.512839271,1.512839271,1.716734147,1.170500555,0,0,0
2175,10,16,27,91,80,1,1235.475,64,940.556,LESS,382,394,776,1,2,-11,-1.031149307,11,0.349215148,0.021441199,-0.953767965,171,91,80,0,0.219395302,0.429183537,0,-1.356018861,0.138216161,0.138216161,0,0.429183537,0,0,1
2176,10,17,40,64,80,0,1457.088,94,1782.824,LESS,32,818,850,2,2,16,1.499853537,16,1.222253018,1.050618761,-0.804384474,144,64,80,1,-0.31912044,-0.624266962,0,-0.736124524,-0.294320816,0.294320816,0,-0.624266962,1,0,0
2177,10,18,22,83,80,1,2494.292,34,1580.766,LESS,626,928,1554,3,2,-3,-0.281222538,3,-1.047645444,-1.007736362,-0.105232553,163,83,80,0,0.059835082,0.117050055,0,-0.116230188,0.439756225,0.439756225,0,0.117050055,0,0,1
2178,10,19,54,101,110,0,2932.98,54,2755.164,LESS,-298,1722,1424,4,2,9,0.843667615,9,0,-0.321617988,0.190475484,211,101,110,1,1.017196402,0.819350388,1.170500555,0.503664148,-0.702141394,0.702141394,1.170500555,0.819350388,0,1,0
2179,10,20,6,56,50,1,2451.452,100,1345.263,LESS,1118,922,2040,3,2,-6,-0.562445076,6,-0.523822722,1.256454273,-0.134109869,106,56,50,0,-1.077031484,-0.936400444,-1.170500555,-0.116230188,1.047779633,1.047779633,-1.170500555,-0.936400444,1,1,1
2180,10,21,18,50,42,1,5389.64,54,1471.966,LESS,838,2216,3054,5,2,-8,-0.749926769,8,-0.174607574,-0.321617988,1.846445341,92,50,42,0,-1.356261869,-1.170500555,-1.482634036,1.123558485,0.701750051,0.701750051,-1.482634036,-1.170500555,0,1,1
2181,10,22,43,110,117,0,2740.613,34,1207.445,LESS,-992,1946,954,2,1,7,0.656185922,7,-0.349215148,-1.007736362,0.060805951,227,110,117,1,1.336316841,1.170500555,1.443617351,-0.736124524,-1.559800429,1.559800429,1.443617351,1.170500555,0,0,0
2182,10,23,32,77,80,0,4739.92,34,1205.97,LESS,-1478,3000,1522,4,1,3,0.281222538,3,-1.047645444,-1.007736362,1.408486187,157,77,80,1,-0.059835082,-0.117050055,0,0.503664148,-2.160408917,2.160408917,0,-0.117050055,0,1,0
2183,10,24,27,80,91,0,2034.764,84,1354.076,LESS,-220,1412,1192,3,2,11,1.031149307,11,0.349215148,0.707559574,-0.414988285,171,80,91,1,0.219395302,0,0.429183537,-0.116230188,-0.605747439,0.605747439,0.429183537,0,1,0,0
2184,10,25,16,44,50,0,2222.526,100,1764.018,LESS,690,1288,1978,2,2,6,0.562445076,6,-0.523822722,1.256454273,-0.288422861,94,44,50,1,-1.316371814,-1.404600665,-1.170500555,-0.736124524,0.518848701,0.518848701,-1.170500555,-1.404600665,1,0,1
2185,10,26,7,50,57,0,1637.05,94,1629.701,LESS,328,1172,1500,3,2,7,0.656185922,7,-0.349215148,1.050618761,-0.683076826,107,50,57,1,-1.057086457,-1.170500555,-0.897383758,-0.116230188,0.071481885,0.071481885,-0.897383758,-1.170500555,1,0,1
2186,10,27,14,50,46,1,3165.539,100,1852.443,LESS,966,1356,2322,3,2,-4,-0.374963384,4,-0.87303787,1.256454273,0.347237386,96,50,46,0,-1.276481759,-1.170500555,-1.326567295,-0.116230188,0.859935003,0.859935003,-1.326567295,-1.170500555,1,0,1
2187,10,28,51,110,108,0,2209.962,84,1666.16,LESS,128,1758,1886,3,2,-2,-0.187481692,2,-1.222253018,0.707559574,-0.296891923,218,110,108,0,1.156811594,1.170500555,1.092467184,-0.116230188,-0.175682102,0.175682102,1.092467184,1.170500555,1,0,0
2188,10,29,50,133,110,1,1653.95,44,2038.42,LESS,-238,882,644,2,1,-23,-2.15603946,23,2.444506035,-0.664677175,-0.67168498,243,133,110,0,1.655437281,2.067884313,1.170500555,-0.736124524,-0.627992198,0.627992198,1.170500555,2.067884313,0,0,0
2189,10,30,49,131,110,1,1436.418,64,1637.687,LESS,590,388,978,1,2,-21,-1.968557767,21,2.095290887,0.021441199,-0.818317577,241,131,110,0,1.615547226,1.989850943,1.170500555,-1.356018861,0.395266707,0.395266707,1.170500555,1.989850943,0,0,1
2190,10,31,47,126,110,1,1456.691,74,1012.382,LESS,620,486,1106,1,2,-16,-1.499853537,16,1.222253018,0.364500386,-0.804652081,236,126,110,0,1.515822089,1.794767517,1.170500555,-1.356018861,0.432341306,0.432341306,1.170500555,1.794767517,1,0,1
2191,10,32,50,110,133,0,1329.32,64,1562.594,LESS,-112,800,688,2,2,23,2.15603946,23,2.444506035,0.021441199,-0.890509521,243,110,133,1,1.655437281,1.170500555,2.067884313,-0.736124524,-0.472278886,0.472278886,2.067884313,1.170500555,0,0,0
2192,10,33,47,110,126,0,1237.902,84,1824.671,LESS,94,832,926,2,2,16,1.499853537,16,1.222253018,0.707559574,-0.952131989,236,110,126,1,1.515822089,1.170500555,1.794767517,-0.736124524,-0.21769998,0.21769998,1.794767517,1.170500555,1,0,0
2193,10,34,12,48,50,0,4309.021,84,1565.826,LESS,810,1776,2586,4,2,2,0.187481692,2,-1.222253018,0.707559574,1.11802851,98,48,50,1,-1.236591704,-1.248533925,-1.170500555,0.503664148,0.667147093,0.667147093,-1.170500555,-1.248533925,1,1,1
2194,10,35,32,80,77,1,2360.907,34,1439.884,LESS,192,954,1146,3,2,-3,-0.281222538,3,-1.047645444,-1.007736362,-0.195143871,157,80,77,0,-0.059835082,0,-0.117050055,-0.116230188,-0.096589626,0.096589626,-0.117050055,0,0,0,0
2195,10,36,43,117,110,1,2633.718,14,2341.276,LESS,24,1340,1364,3,1,-7,-0.656185922,7,-0.349215148,-1.693854737,-0.011249155,227,117,110,0,1.336316841,1.443617351,1.170500555,-0.116230188,-0.304207375,0.304207375,1.170500555,1.443617351,0,1,0
2196,10,37,40,80,64,1,2069.533,84,2313.408,LESS,966,744,1710,3,2,-16,-1.499853537,16,1.222253018,0.707559574,-0.391551417,144,80,64,0,-0.31912044,0,-0.624266962,-0.116230188,0.859935003,0.859935003,-0.624266962,0,1,1,1
2197,10,38,31,80,78,0,1541.861,94,1189.588,LESS,64,1110,1174,2,2,-2,-0.187481692,2,-1.222253018,1.050618761,-0.747241226,158,80,78,0,-0.039890055,0,-0.07803337,-0.736124524,-0.254774578,0.254774578,-0.07803337,0,1,0,0
2198,10,39,46,124,110,1,2597.874,64,1545.612,LESS,522,1202,1724,3,2,-14,-1.312371845,14,0.87303787,0.021441199,-0.035410652,234,124,110,0,1.475932034,1.716734147,1.170500555,-0.116230188,0.311230952,0.311230952,1.170500555,1.716734147,0,1,1
2199,10,40,58,92,110,0,2669.501,24,1269.011,LESS,-920,1868,948,4,1,18,1.687335229,18,1.571468165,-1.35079555,0.012871224,202,92,110,1,0.837691154,0.468200222,1.170500555,0.503664148,-1.470821393,1.470821393,1.170500555,0.468200222,0,1,0
2200,10,41,49,110,131,1,2438.639,54,1205.482,MORE,224,1090,1314,3,2,21,1.968557767,21,2.095290887,-0.321617988,-0.142746775,241,110,131,0,1.615547226,1.170500555,1.989850943,-0.116230188,-0.057043388,0.057043388,1.989850943,1.170500555,0,1,0
2201,10,42,13,47,50,1,1326.879,14,1739.466,MORE,-562,1488,926,1,1,3,0.281222538,3,-1.047645444,-1.693854737,-0.892154934,97,47,50,0,-1.256536731,-1.28755061,-1.170500555,-1.356018861,-1.028397857,1.028397857,-1.170500555,-1.28755061,0,0,0
2202,10,43,16,50,44,0,2008.897,94,1260.429,MORE,-90,1502,1412,2,2,-6,-0.562445076,6,-0.523822722,1.050618761,-0.432424549,94,50,44,1,-1.316371814,-1.170500555,-1.404600665,-0.736124524,-0.445090848,0.445090848,-1.404600665,-1.170500555,1,0,0
2203,10,44,7,57,50,0,3251.427,54,3243.929,MORE,-586,1756,1170,4,1,-7,-0.656185922,7,-0.349215148,-0.321617988,0.405132226,107,57,50,1,-1.057086457,-0.897383758,-1.170500555,0.503664148,-1.058057535,1.058057535,-1.170500555,-0.897383758,0,1,0
2204,10,45,18,42,50,1,2833.729,84,2317.96,MORE,1602,1152,2754,3,2,8,0.749926769,8,-0.174607574,0.707559574,0.123572997,92,42,50,0,-1.356261869,-1.482634036,-1.170500555,-0.116230188,1.645916481,1.645916481,-1.170500555,-1.482634036,1,0,1
2205,10,46,51,108,110,0,1694.866,14,2947.836,MORE,-1772,2416,644,2,1,2,0.187481692,2,-1.222253018,-1.693854737,-0.644104582,218,108,110,0,1.156811594,1.092467184,1.170500555,-0.736124524,-2.523739977,2.523739977,1.170500555,1.092467184,0,0,0
2206,10,47,31,78,80,0,1296.653,84,2009.749,MORE,-220,1002,782,2,2,2,0.187481692,2,-1.222253018,0.707559574,-0.912529486,158,78,80,0,-0.039890055,-0.07803337,0,-0.736124524,-0.605747439,0.605747439,0,-0.07803337,1,0,0
2207,10,48,58,110,92,0,1529.774,100,1032.574,MORE,264,810,1074,2,2,-18,-1.687335229,18,1.571468165,1.256454273,-0.755388754,202,110,92,1,0.837691154,1.170500555,0.468200222,-0.736124524,-0.007610591,0.007610591,0.468200222,1.170500555,1,0,0
2208,10,49,12,50,48,1,1082.362,84,1525.106,MORE,1316,348,1664,1,2,-2,-0.187481692,2,-1.222253018,0.707559574,-1.056977409,98,50,48,1,-1.236591704,-1.170500555,-1.248533925,-1.356018861,1.29247198,1.29247198,-1.248533925,-1.170500555,1,0,1
2209,10,50,54,110,101,0,3108.467,34,2214.444,MORE,-526,1692,1166,4,1,-9,-0.843667615,9,0,-1.007736362,0.308766652,211,110,101,1,1.017196402,1.170500555,0.819350388,0.503664148,-0.983908339,0.983908339,0.819350388,1.170500555,0,1,0
2210,10,51,14,46,50,1,4797.563,14,1393.247,MORE,-872,3042,2170,5,1,4,0.374963384,4,-0.87303787,-1.693854737,1.447341816,96,46,50,0,-1.276481759,-1.326567295,-1.170500555,1.123558485,-1.411502036,1.411502036,-1.170500555,-1.326567295,0,1,0
2211,10,52,22,80,83,0,3431.024,74,1129.424,MORE,110,1792,1902,4,2,3,0.281222538,3,-1.047645444,0.364500386,0.526193838,163,80,83,0,0.059835082,0,0.117050055,0.503664148,-0.197926861,0.197926861,0.117050055,0,1,1,0
2212,10,53,6,50,56,1,1124.577,94,2447.918,MORE,1866,342,2208,1,2,6,0.562445076,6,-0.523822722,1.050618761,-1.028521389,106,50,56,0,-1.077031484,-1.170500555,-0.936400444,-1.356018861,1.972172944,1.972172944,-0.936400444,-1.170500555,1,0,1
2213,10,54,13,50,47,0,4441.454,14,1300.208,MORE,-1418,3164,1746,6,1,-3,-0.281222538,3,-1.047645444,-1.693854737,1.20729811,97,50,47,1,-1.256536731,-1.170500555,-1.28755061,1.743452821,-2.086259721,2.086259721,-1.28755061,-1.170500555,0,1,0
2214,10,55,46,110,124,1,4632.202,4,2030.28,MORE,-80,2430,2350,4,1,14,1.312371845,14,0.87303787,-2.036913924,1.335876318,234,110,124,0,1.475932034,1.170500555,1.716734147,0.503664148,-0.432732648,0.432732648,1.716734147,1.170500555,0,1,0
2215,10,56,27,91,80,0,1632.613,84,1330.665,MORE,-80,1338,1258,3,2,-11,-1.031149307,11,0.349215148,0.707559574,-0.686067691,171,91,80,1,0.219395302,0.429183537,0,-0.116230188,-0.432732648,0.432732648,0,0.429183537,1,0,0
2216,10,57,40,64,80,1,4819.272,24,1100.93,MORE,818,1736,2554,5,2,16,1.499853537,16,1.222253018,-1.35079555,1.461975282,144,64,80,0,-0.31912044,-0.624266962,0,1.123558485,0.677033652,0.677033652,0,-0.624266962,0,1,1
2217,10,58,22,83,80,0,3039.931,74,941.295,MORE,6,1514,1520,3,2,-3,-0.281222538,3,-1.047645444,0.364500386,0.262568338,163,83,80,1,0.059835082,0.117050055,0,-0.116230188,-0.326452134,0.326452134,0,0.117050055,1,0,0
2218,10,59,54,101,110,1,3590.044,94,777.368,MORE,922,1448,2370,5,2,9,0.843667615,9,0,1.050618761,0.633385035,211,101,110,0,1.017196402,0.819350388,1.170500555,1.123558485,0.805558926,0.805558926,1.170500555,0.819350388,1,1,1
2219,10,60,6,56,50,1,2701.356,64,1215.755,MORE,878,774,1652,3,2,-6,-0.562445076,6,-0.523822722,0.021441199,0.034343841,106,56,50,1,-1.077031484,-0.936400444,-1.170500555,-0.116230188,0.751182849,0.751182849,-1.170500555,-0.936400444,0,0,1
2220,10,61,18,50,42,0,1980.89,100,915.516,MORE,-284,1444,1160,3,2,-8,-0.749926769,8,-0.174607574,1.256454273,-0.45130333,92,50,42,1,-1.356261869,-1.170500555,-1.482634036,-0.116230188,-0.684839915,0.684839915,-1.482634036,-1.170500555,1,0,0
2221,10,62,43,110,117,1,4704.146,64,1413.996,MORE,880,1844,2724,3,2,7,0.656185922,7,-0.349215148,0.021441199,1.384371875,227,110,117,0,1.336316841,1.170500555,1.443617351,-0.116230188,0.753654488,0.753654488,1.443617351,1.170500555,1,1,1
2222,10,63,32,77,80,1,2282.415,100,585.636,MORE,584,972,1556,3,2,3,0.281222538,3,-1.047645444,1.256454273,-0.248053263,157,77,80,0,-0.059835082,-0.117050055,0,-0.116230188,0.387851788,0.387851788,0,-0.117050055,1,1,1
2223,10,64,27,80,91,1,2126.651,100,1042.765,MORE,1138,878,2016,3,2,11,1.031149307,11,0.349215148,1.256454273,-0.353049676,171,80,91,0,0.219395302,0,0.429183537,-0.116230188,1.072496031,1.072496031,0.429183537,0,1,1,1
2224,10,65,16,44,50,1,2219.879,24,1466.542,MORE,-662,1614,952,3,1,6,0.562445076,6,-0.523822722,-1.35079555,-0.290207134,94,44,50,0,-1.316371814,-1.404600665,-1.170500555,-0.116230188,-1.15197985,1.15197985,-1.170500555,-1.404600665,0,1,0
2225,10,66,7,50,57,1,1361.906,90,1979.051,MORE,1468,390,1858,1,2,7,0.656185922,7,-0.349215148,0.913395086,-0.868544155,107,50,57,0,-1.057086457,-1.170500555,-0.897383758,-1.356018861,1.48031661,1.48031661,-0.897383758,-1.170500555,1,0,1
2226,10,67,14,50,46,1,1211.06,14,968.429,MORE,-36,780,744,1,1,-4,-0.374963384,4,-0.87303787,-1.693854737,-0.970225474,96,50,46,1,-1.276481759,-1.170500555,-1.326567295,-1.356018861,-0.378356571,0.378356571,-1.326567295,-1.170500555,0,0,0
2227,10,68,51,110,108,0,5025.44,34,1583.941,MORE,-644,2572,1928,6,2,-2,-0.187481692,2,-1.222253018,-1.007736362,1.600947705,218,110,108,1,1.156811594,1.170500555,1.092467184,1.743452821,-1.129735091,1.129735091,1.092467184,1.170500555,0,1,0
2228,10,69,50,133,110,0,1668.819,80,1025.504,MORE,158,832,990,2,2,-23,-2.15603946,23,2.444506035,0.570335899,-0.661662179,243,133,110,1,1.655437281,2.067884313,1.170500555,-0.736124524,-0.138607504,0.138607504,1.170500555,2.067884313,1,0,0
2229,10,70,49,131,110,0,1902.992,54,4619.235,MORE,448,1140,1588,2,2,-21,-1.968557767,21,2.095290887,-0.321617988,-0.503812322,241,131,110,1,1.615547226,1.989850943,1.170500555,-0.736124524,0.219780277,0.219780277,1.170500555,1.989850943,0,0,1
2230,10,71,47,126,110,0,2614.701,24,2535.193,MORE,-450,1470,1020,3,1,-16,-1.499853537,16,1.222253018,-1.35079555,-0.024068014,236,126,110,1,1.515822089,1.794767517,1.170500555,-0.116230188,-0.889986024,0.889986024,1.170500555,1.794767517,0,1,0
2231,10,72,50,110,133,1,2018.169,84,1963.96,MORE,1914,778,2692,2,2,23,2.15603946,23,2.444506035,0.707559574,-0.426174537,243,110,133,0,1.655437281,1.170500555,2.067884313,-0.736124524,2.0314923,2.0314923,2.067884313,1.170500555,1,0,1
2232,10,73,47,110,126,1,3067.38,100,597.419,MORE,552,1252,1804,3,2,16,1.499853537,16,1.222253018,1.256454273,0.281070987,236,110,126,0,1.515822089,1.170500555,1.794767517,-0.116230188,0.34830555,0.34830555,1.794767517,1.170500555,1,1,1
2233,10,74,12,48,50,1,2779.135,64,2205.372,MORE,1018,1044,2062,2,2,2,0.187481692,2,-1.222253018,0.021441199,0.086772618,98,48,50,0,-1.236591704,-1.248533925,-1.170500555,-0.736124524,0.924197639,0.924197639,-1.170500555,-1.248533925,1,0,1
2234,10,75,32,80,77,1,2203.819,34,2011.567,MORE,-176,1426,1250,4,1,-3,-0.281222538,3,-1.047645444,-1.007736362,-0.301032758,157,80,77,1,-0.059835082,0,-0.117050055,0.503664148,-0.551371362,0.551371362,-0.117050055,0,0,1,0
2235,10,76,43,117,110,0,1712.826,94,975.243,MORE,-230,1124,894,2,2,-7,-0.656185922,7,-0.349215148,1.050618761,-0.631998218,227,117,110,1,1.336316841,1.443617351,1.170500555,-0.736124524,-0.618105639,0.618105639,1.170500555,1.443617351,1,0,0
2236,10,77,40,80,64,0,1686.734,14,1244.821,MORE,-1262,1810,548,2,1,-16,-1.499853537,16,1.222253018,-1.693854737,-0.649586149,144,80,64,1,-0.31912044,0,-0.624266962,-0.736124524,-1.893471811,1.893471811,-0.624266962,0,0,0,0
2237,10,78,31,80,78,0,1807.809,34,1380.053,MORE,-370,1168,798,2,2,-2,-0.187481692,2,-1.222253018,-1.007736362,-0.567972678,158,80,78,1,-0.039890055,0,-0.07803337,-0.736124524,-0.791120429,0.791120429,-0.07803337,0,0,0,0
2238,10,79,46,124,110,0,1473.981,44,2871.692,MORE,-864,1366,502,2,1,-14,-1.312371845,14,0.87303787,-0.664677175,-0.792997347,234,124,110,1,1.475932034,1.716734147,1.170500555,-0.736124524,-1.401615477,1.401615477,1.170500555,1.716734147,0,0,0
2239,10,80,58,92,110,1,2004.33,74,1405.061,MORE,804,1084,1888,3,1,18,1.687335229,18,1.571468165,0.364500386,-0.435503043,202,92,110,0,0.837691154,0.468200222,1.170500555,-0.116230188,0.659732173,0.659732173,1.170500555,0.468200222,1,1,1
2240,10,81,48,128,110,1,2336.691,84,1215.806,LESS,298,1120,1418,3,2,-18,-1.687335229,18,1.571468165,0.707559574,-0.211467239,238,128,110,0,1.555712144,1.872800887,1.170500555,-0.116230188,0.034407287,0.034407287,1.170500555,1.872800887,1,1,0
2241,10,82,8,50,58,0,2502.564,84,1732.685,LESS,160,1798,1958,5,2,8,0.749926769,8,-0.174607574,0.707559574,-0.099656615,108,50,58,1,-1.037141429,-1.170500555,-0.858367073,1.123558485,-0.136135864,0.136135864,-0.858367073,-1.170500555,1,1,0
2242,10,83,4,54,50,1,3873.099,94,1528.885,LESS,1152,1706,2858,4,2,-4,-0.374963384,4,-0.87303787,1.050618761,0.824184962,104,54,50,0,-1.116921539,-1.014433814,-1.170500555,0.503664148,1.089797511,1.089797511,-1.170500555,-1.014433814,1,1,1
2243,10,84,37,80,69,1,2825.664,64,1391.63,LESS,176,1196,1372,3,2,-11,-1.031149307,11,0.349215148,0.021441199,0.118136592,149,80,69,0,-0.219395302,0,-0.429183537,-0.116230188,-0.116362745,0.116362745,-0.429183537,0,0,1,0
2244,10,85,52,105,110,1,3008.745,54,1063.586,LESS,-18,1488,1470,3,2,5,0.46870423,5,-0.698430296,-0.321617988,0.241546676,215,105,110,1,1.096976512,0.975417129,1.170500555,-0.116230188,-0.356111813,0.356111813,1.170500555,0.975417129,0,1,0
2245,10,86,5,55,50,0,1636.23,94,1337.621,LESS,602,942,1544,3,2,-5,-0.46870423,5,-0.698430296,1.050618761,-0.683629566,105,55,50,0,-1.096976512,-0.975417129,-1.170500555,-0.116230188,0.410096547,0.410096547,-1.170500555,-0.975417129,1,1,1
2246,10,87,30,96,80,1,1155.548,4,2294.644,LESS,-1862,2438,576,1,1,-16,-1.499853537,16,1.222253018,-2.036913924,-1.007644653,176,96,80,0,0.31912044,0.624266962,0,-1.356018861,-2.634963771,2.634963771,0,0.624266962,0,0,0
2247,10,88,33,80,75,0,3214.475,74,1519.974,LESS,-528,1948,1420,4,2,-5,-0.46870423,5,-0.698430296,0.364500386,0.380223855,155,80,75,0,-0.099725137,0,-0.195083426,0.503664148,-0.986379979,0.986379979,-0.195083426,0,0,1,0
2248,10,89,48,110,128,0,3052.139,100,1041.023,LESS,642,1366,2008,3,2,18,1.687335229,18,1.571468165,1.256454273,0.27079743,238,110,128,1,1.555712144,1.170500555,1.872800887,-0.116230188,0.459529344,0.459529344,1.872800887,1.170500555,1,1,1
2249,10,90,9,59,50,1,2458.186,84,1035.818,LESS,986,946,1932,3,2,-9,-0.843667615,9,0,0.707559574,-0.129570657,109,59,50,0,-1.017196402,-0.819350388,-1.170500555,-0.116230188,0.884651401,0.884651401,-1.170500555,-0.819350388,1,1,1
2250,10,91,44,110,119,0,5171.365,74,975.916,LESS,36,2270,2306,7,2,9,0.843667615,9,0,0.364500386,1.699311907,229,110,119,1,1.376206896,1.170500555,1.521650721,2.363347157,-0.289377536,0.289377536,1.521650721,1.170500555,1,1,0
2251,10,92,2,52,50,0,3510.092,54,1122.637,LESS,-304,1806,1502,3,1,-2,-0.187481692,2,-1.222253018,-0.321617988,0.579491496,102,52,50,0,-1.156811594,-1.092467184,-1.170500555,-0.116230188,-0.709556314,0.709556314,-1.170500555,-1.092467184,0,1,0
2252,10,93,8,58,50,1,3211.647,64,956.654,LESS,1020,1142,2162,3,2,-8,-0.749926769,8,-0.174607574,0.021441199,0.378317575,108,58,50,0,-1.037141429,-0.858367073,-1.170500555,-0.116230188,0.926669279,0.926669279,-1.170500555,-0.858367073,0,1,1
2253,10,94,44,119,110,1,1058.044,100,761.786,LESS,938,398,1336,1,2,-9,-0.843667615,9,0,1.256454273,-1.073369533,229,119,110,0,1.376206896,1.521650721,1.170500555,-1.356018861,0.825332045,0.825332045,1.170500555,1.521650721,1,0,1
2254,10,95,34,74,80,0,5221.032,14,1234.061,LESS,-1744,3612,1868,5,1,6,0.562445076,6,-0.523822722,-1.693854737,1.732791125,154,74,80,1,-0.119670165,-0.234100111,0,1.123558485,-2.489137019,2.489137019,0,-0.234100111,0,1,0
2255,10,96,24,86,80,1,3255.794,54,1777.875,LESS,436,1398,1834,5,2,-6,-0.562445076,6,-0.523822722,-0.321617988,0.408075906,166,86,80,0,0.119670165,0.234100111,0,1.123558485,0.204950438,0.204950438,0,0.234100111,0,1,1
2256,10,97,39,66,80,0,1430.463,84,3518.32,LESS,314,682,996,2,2,14,1.312371845,14,0.87303787,0.707559574,-0.822331686,146,66,80,1,-0.279230385,-0.546233592,0,-0.736124524,0.054180406,0.054180406,0,-0.546233592,1,0,1
2257,10,98,9,50,59,0,1610.642,94,1679.757,LESS,266,1064,1330,2,2,9,0.843667615,9,0,1.050618761,-0.700877764,109,50,59,1,-1.017196402,-1.170500555,-0.819350388,-0.736124524,-0.005138951,0.005138951,-0.819350388,-1.170500555,1,0,0
2258,10,99,57,94,110,1,2074.197,24,1065.451,LESS,108,968,1076,3,1,16,1.499853537,16,1.222253018,-1.35079555,-0.388407537,204,94,110,1,0.877581209,0.546233592,1.170500555,-0.116230188,-0.200398501,0.200398501,1.170500555,0.546233592,0,1,0
2259,10,100,60,110,87,1,1262.237,14,1140.017,LESS,306,664,970,1,1,-23,-2.15603946,23,2.444506035,-1.693854737,-0.935728406,197,110,87,0,0.737966017,1.170500555,0.273116796,-1.356018861,0.044293846,0.044293846,0.273116796,1.170500555,0,0,1
2260,10,101,33,75,80,0,2945.857,84,776.884,LESS,-96,1704,1608,4,2,5,0.46870423,5,-0.698430296,0.707559574,0.199155531,155,75,80,1,-0.099725137,-0.195083426,0,0.503664148,-0.452505767,0.452505767,0,-0.195083426,1,1,0
2261,10,102,15,50,45,1,7351.654,14,1809.164,LESS,-1090,4356,3266,6,1,-5,-0.46870423,5,-0.698430296,-1.693854737,3.168987346,95,50,45,0,-1.296426786,-1.170500555,-1.36558398,1.743452821,-1.680910782,1.680910782,-1.36558398,-1.170500555,0,1,0
2262,10,103,59,89,110,0,2482.427,90,1059.954,LESS,336,1390,1726,5,2,21,1.968557767,21,2.095290887,0.913395086,-0.113230437,199,89,110,1,0.777856072,0.351150166,1.170500555,1.123558485,0.081368444,0.081368444,1.170500555,0.351150166,1,1,1
2263,10,104,29,80,94,0,1291.324,84,948.081,LESS,76,930,1006,2,2,14,1.312371845,14,0.87303787,0.707559574,-0.916121624,174,80,94,1,0.279230385,0,0.546233592,-0.736124524,-0.239944739,0.239944739,0.546233592,0,1,0,0
2264,10,105,55,110,98,1,2356.395,84,1485.303,LESS,1202,1096,2298,3,2,-12,-1.124890153,12,0.523822722,0.707559574,-0.198185291,208,110,98,0,0.957361319,1.170500555,0.702300333,-0.116230188,1.151588507,1.151588507,0.702300333,1.170500555,1,1,1
2265,10,106,29,94,80,0,1330.587,94,693.719,LESS,52,874,926,2,2,-14,-1.312371845,14,0.87303787,1.050618761,-0.889655469,174,94,80,0,0.279230385,0.546233592,0,-0.736124524,-0.269604417,0.269604417,0,0.546233592,1,0,0
2266,10,107,57,110,94,1,2264.505,64,1311.782,LESS,778,906,1684,3,2,-16,-1.499853537,16,1.222253018,0.021441199,-0.260125922,204,110,94,0,0.877581209,1.170500555,0.546233592,-0.116230188,0.627600855,0.627600855,0.546233592,1.170500555,0,1,1
2267,10,108,39,80,66,1,2100.158,94,1132.706,LESS,1096,762,1858,2,2,-14,-1.312371845,14,0.87303787,1.050618761,-0.37090791,146,80,66,0,-0.279230385,0,-0.546233592,-0.736124524,1.020591594,1.020591594,-0.546233592,0,1,0,1
2268,10,109,4,50,54,0,1496.276,100,1606.333,LESS,922,768,1690,2,2,4,0.374963384,4,-0.87303787,1.256454273,-0.777968875,104,50,54,1,-1.116921539,-1.170500555,-1.014433814,-0.736124524,0.805558926,0.805558926,-1.014433814,-1.170500555,1,0,1
2269,10,110,55,98,110,0,3162.217,64,2090.402,LESS,-160,1986,1826,5,2,12,1.124890153,12,0.523822722,0.021441199,0.344998113,208,98,110,1,0.957361319,0.702300333,1.170500555,1.123558485,-0.531598243,0.531598243,1.170500555,0.702300333,0,1,0
2270,10,111,2,50,52,0,1574.379,100,532.181,LESS,340,732,1072,3,2,2,0.187481692,2,-1.222253018,1.256454273,-0.725321698,102,50,52,1,-1.156811594,-1.170500555,-1.092467184,-0.116230188,0.086311724,0.086311724,-1.092467184,-1.170500555,1,0,1
2271,10,112,59,110,89,1,2115.252,54,1479.948,LESS,444,860,1304,3,2,-21,-1.968557767,21,2.095290887,-0.321617988,-0.360733442,199,110,89,0,0.777856072,1.170500555,0.351150166,-0.116230188,0.214836997,0.214836997,0.351150166,1.170500555,0,0,1
2272,10,113,60,87,110,0,2816.294,74,906.701,LESS,-242,1714,1472,5,2,23,2.15603946,23,2.444506035,0.364500386,0.111820522,197,87,110,1,0.737966017,0.273116796,1.170500555,1.123558485,-0.632935478,0.632935478,1.170500555,0.273116796,0,1,0
2273,10,114,52,110,105,1,2438.37,64,858.345,LESS,644,958,1602,3,2,-5,-0.46870423,5,-0.698430296,0.021441199,-0.142928101,215,110,105,0,1.096976512,1.170500555,0.975417129,-0.116230188,0.462000984,0.462000984,0.975417129,1.170500555,0,0,1
2274,10,115,30,80,96,0,1997.502,54,1287.442,LESS,-666,1272,606,2,1,16,1.499853537,16,1.222253018,-0.321617988,-0.440105618,176,80,96,1,0.31912044,0,0.624266962,-0.736124524,-1.15692313,1.15692313,0.624266962,0,0,0,0
2275,10,116,24,80,86,0,1385.691,54,1616.044,LESS,0,952,952,2,2,6,0.562445076,6,-0.523822722,-0.321617988,-0.852511313,166,80,86,1,0.119670165,0,0.234100111,-0.736124524,-0.333867054,0.333867054,0.234100111,0,0,0,0
2276,10,117,5,50,55,1,5441.257,54,1074.966,LESS,1144,1968,3112,5,2,5,0.46870423,5,-0.698430296,-0.321617988,1.881239002,105,50,55,1,-1.096976512,-1.170500555,-0.975417129,1.123558485,1.079910951,1.079910951,-0.975417129,-1.170500555,0,1,1
2277,10,118,34,80,74,1,3678.106,34,1437.701,LESS,574,1368,1942,4,2,-6,-0.562445076,6,-0.523822722,-1.007736362,0.692745312,154,80,74,0,-0.119670165,0,-0.234100111,0.503664148,0.375493589,0.375493589,-0.234100111,0,0,1,1
2278,10,119,15,45,50,0,2843.507,94,646.596,LESS,-256,1424,1168,4,2,5,0.46870423,5,-0.698430296,1.050618761,0.130164089,95,45,50,1,-1.296426786,-1.36558398,-1.170500555,0.503664148,-0.650236957,0.650236957,-1.170500555,-1.36558398,1,1,0
2279,10,120,37,69,80,0,1709.499,34,1636.519,LESS,-544,954,410,2,1,11,1.031149307,11,0.349215148,-1.007736362,-0.634240861,149,69,80,1,-0.219395302,-0.429183537,0,-0.736124524,-1.006153098,1.006153098,0,-0.429183537,0,0,0
2280,10,121,48,128,110,0,1421.857,94,1409.834,MORE,472,954,1426,2,2,-18,-1.687335229,18,1.571468165,1.050618761,-0.828132764,238,128,110,1,1.555712144,1.872800887,1.170500555,-0.736124524,0.249439955,0.249439955,1.170500555,1.872800887,1,0,1
2281,10,122,8,50,58,1,2683.921,54,1082.511,MORE,946,972,1918,3,2,8,0.749926769,8,-0.174607574,-0.321617988,0.022591366,108,50,58,0,-1.037141429,-1.170500555,-0.858367073,-0.116230188,0.835218604,0.835218604,-0.858367073,-1.170500555,0,1,1
2282,10,123,4,54,50,0,2971.482,74,928.766,MORE,-484,1712,1228,4,1,-4,-0.374963384,4,-0.87303787,0.364500386,0.216428669,104,54,50,1,-1.116921539,-1.014433814,-1.170500555,0.503664148,-0.932003902,0.932003902,-1.170500555,-1.014433814,1,1,0
2283,10,124,37,80,69,0,3289.845,54,1167.331,MORE,-546,1836,1290,4,2,-11,-1.031149307,11,0.349215148,-0.321617988,0.431028789,149,80,69,1,-0.219395302,0,-0.429183537,0.503664148,-1.008624738,1.008624738,-0.429183537,0,0,1,0
2284,10,125,52,105,110,0,1787.366,94,641.468,MORE,-174,1228,1054,3,2,5,0.46870423,5,-0.698430296,1.050618761,-0.581752766,215,105,110,0,1.096976512,0.975417129,1.170500555,-0.116230188,-0.548899722,0.548899722,1.170500555,0.975417129,1,1,0
2285,10,126,5,55,50,0,1495.821,54,1987.698,MORE,-366,1010,644,2,2,-5,-0.46870423,5,-0.698430296,-0.321617988,-0.778275578,105,55,50,1,-1.096976512,-0.975417129,-1.170500555,-0.736124524,-0.78617715,0.78617715,-1.170500555,-0.975417129,0,0,0
2286,10,127,30,96,80,0,1312.34,90,901.484,MORE,124,906,1030,2,2,-16,-1.499853537,16,1.222253018,0.913395086,-0.901955292,176,96,80,1,0.31912044,0.624266962,0,-0.736124524,-0.180625382,0.180625382,0,0.624266962,1,0,0
2287,10,128,33,80,75,0,1617.595,100,834.292,MORE,54,1068,1122,3,2,-5,-0.46870423,5,-0.698430296,1.256454273,-0.696190929,155,80,75,1,-0.099725137,0,-0.195083426,-0.116230188,-0.267132777,0.267132777,-0.195083426,0,1,1,0
2288,10,129,48,110,128,1,2641.421,84,1598.861,MORE,1414,960,2374,2,2,18,1.687335229,18,1.571468165,0.707559574,-0.006056766,238,110,128,0,1.555712144,1.170500555,1.872800887,-0.736124524,1.413582333,1.413582333,1.872800887,1.170500555,1,0,1
2289,10,130,9,59,50,0,3239.75,74,980.167,MORE,114,1532,1646,3,2,-9,-0.843667615,9,0,0.364500386,0.397261068,109,59,50,1,-1.017196402,-0.819350388,-1.170500555,-0.116230188,-0.192983581,0.192983581,-1.170500555,-0.819350388,1,1,0
2290,10,131,44,110,119,1,4830.474,54,1283.543,MORE,1902,1246,3148,4,2,9,0.843667615,9,0,-0.321617988,1.469526255,229,110,119,0,1.376206896,1.170500555,1.521650721,0.503664148,2.016662461,2.016662461,1.521650721,1.170500555,0,1,1
2291,10,132,2,52,50,0,5707.631,14,2383.802,MORE,-170,3130,2960,8,1,-2,-0.187481692,2,-1.222253018,-1.693854737,2.060794706,102,52,50,1,-1.156811594,-1.092467184,-1.170500555,2.983241494,-0.543956443,0.543956443,-1.170500555,-1.092467184,0,1,0
2292,10,133,8,58,50,0,3165.677,54,1784.687,MORE,-188,1622,1434,4,2,-8,-0.749926769,8,-0.174607574,-0.321617988,0.347330408,108,58,50,1,-1.037141429,-0.858367073,-1.170500555,0.503664148,-0.566201201,0.566201201,-1.170500555,-0.858367073,0,1,0
2293,10,134,44,119,110,0,1835.798,84,1734.395,MORE,576,634,1210,2,2,-9,-0.843667615,9,0,0.707559574,-0.549106029,229,119,110,1,1.376206896,1.521650721,1.170500555,-0.736124524,0.377965228,0.377965228,1.170500555,1.521650721,1,0,1
2294,10,135,34,74,80,1,2513.012,24,1315.052,MORE,900,754,1654,3,2,6,0.562445076,6,-0.523822722,-1.35079555,-0.092613893,154,74,80,0,-0.119670165,-0.234100111,0,-0.116230188,0.778370887,0.778370887,0,-0.234100111,0,1,1
2295,10,136,24,86,80,0,1628.718,90,1466.498,MORE,664,790,1454,2,2,-6,-0.562445076,6,-0.523822722,0.913395086,-0.688693208,166,86,80,1,0.119670165,0.234100111,0,-0.736124524,0.486717383,0.486717383,0,0.234100111,1,0,1
2296,10,137,39,66,80,1,2175.323,34,1447.81,MORE,432,762,1194,3,2,14,1.312371845,14,0.87303787,-1.007736362,-0.320241162,146,66,80,0,-0.279230385,-0.546233592,0,-0.116230188,0.200007158,0.200007158,0,-0.546233592,0,1,0
2297,10,138,9,50,59,1,2798.844,44,1582.627,MORE,1074,800,1874,3,2,9,0.843667615,9,0,-0.664677175,0.100057936,109,50,59,0,-1.017196402,-1.170500555,-0.819350388,-0.116230188,0.993403556,0.993403556,-0.819350388,-1.170500555,0,1,1
2298,10,139,57,94,110,0,1538.526,94,774.79,MORE,-98,960,862,2,2,16,1.499853537,16,1.222253018,1.050618761,-0.749489261,204,94,110,0,0.877581209,0.546233592,1.170500555,-0.736124524,-0.454977407,0.454977407,1.170500555,0.546233592,1,0,0
2299,10,140,60,110,87,0,1389.557,94,1526.584,MORE,460,984,1444,2,2,-23,-2.15603946,23,2.444506035,1.050618761,-0.849905344,197,110,87,1,0.737966017,1.170500555,0.273116796,-0.736124524,0.234610116,0.234610116,0.273116796,1.170500555,1,0,1
2300,10,141,33,75,80,1,1704.155,100,1707.139,MORE,774,844,1618,3,2,5,0.46870423,5,-0.698430296,1.256454273,-0.637843111,155,75,80,0,-0.099725137,-0.195083426,0,-0.116230188,0.622657575,0.622657575,0,-0.195083426,1,1,1
2301,10,142,15,50,45,1,2217.502,84,1301.338,MORE,972,936,1908,3,2,-5,-0.46870423,5,-0.698430296,0.707559574,-0.291809408,95,50,45,1,-1.296426786,-1.170500555,-1.36558398,-0.116230188,0.867349922,0.867349922,-1.36558398,-1.170500555,1,1,1
2302,10,143,59,89,110,1,5787.017,54,1316.729,MORE,-16,2410,2394,6,2,21,1.968557767,21,2.095290887,-0.321617988,2.114306719,199,89,110,0,0.777856072,0.351150166,1.170500555,1.743452821,-0.353640173,0.353640173,1.170500555,0.351150166,0,1,0
2303,10,144,29,80,94,1,2518.364,64,1818.13,MORE,634,892,1526,3,2,14,1.312371845,14,0.87303787,0.021441199,-0.089006251,174,80,94,0,0.279230385,0,0.546233592,-0.116230188,0.449642785,0.449642785,0.546233592,0,0,1,1
2304,10,145,55,110,98,0,4822.179,84,2168.931,MORE,624,2406,3030,6,2,-12,-1.124890153,12,0.523822722,0.707559574,1.463934814,208,110,98,1,0.957361319,1.170500555,0.702300333,1.743452821,0.437284585,0.437284585,0.702300333,1.170500555,1,1,1
2305,10,146,29,94,80,0,2906.668,64,1214.182,MORE,-372,1412,1040,4,2,-14,-1.312371845,14,0.87303787,0.021441199,0.172739257,174,94,80,1,0.279230385,0.546233592,0,0.503664148,-0.793592069,0.793592069,0,0.546233592,0,1,0
2306,10,147,57,110,94,0,1577.21,94,1893.143,MORE,560,894,1454,2,2,-16,-1.499853537,16,1.222253018,1.050618761,-0.723413395,204,110,94,1,0.877581209,1.170500555,0.546233592,-0.736124524,0.358192109,0.358192109,0.546233592,1.170500555,1,0,1
2307,10,148,39,80,66,0,2177.234,100,1787.587,MORE,742,1380,2122,3,2,-14,-1.312371845,14,0.87303787,1.256454273,-0.318953007,146,80,66,1,-0.279230385,0,-0.546233592,-0.116230188,0.583111337,0.583111337,-0.546233592,0,1,0,1
2308,10,149,4,50,54,1,1134.675,94,2019.675,MORE,1506,544,2050,1,2,4,0.374963384,4,-0.87303787,1.050618761,-1.021714593,104,50,54,0,-1.116921539,-1.170500555,-1.014433814,-1.356018861,1.527277767,1.527277767,-1.014433814,-1.170500555,1,0,1
2309,10,150,55,98,110,1,2555.015,94,1664.933,MORE,1040,1156,2196,2,2,12,1.124890153,12,0.523822722,1.050618761,-0.064300776,208,98,110,0,0.957361319,0.702300333,1.170500555,-0.736124524,0.951385678,0.951385678,1.170500555,0.702300333,1,0,1
2310,10,151,2,50,52,1,3902.862,34,4143.533,MORE,-300,1962,1662,4,2,2,0.187481692,2,-1.222253018,-1.007736362,0.844247417,102,50,52,0,-1.156811594,-1.170500555,-1.092467184,0.503664148,-0.704613034,0.704613034,-1.092467184,-1.170500555,0,1,0
2311,10,152,59,110,89,0,2540.732,54,2014.644,MORE,346,788,1134,1,1,-21,-1.968557767,21,2.095290887,-0.321617988,-0.073928571,199,110,89,1,0.777856072,1.170500555,0.351150166,-1.356018861,0.093726644,0.093726644,0.351150166,1.170500555,0,0,0
2312,10,153,60,87,110,1,3994.772,44,1300.547,MORE,740,1480,2220,4,2,23,2.15603946,23,2.444506035,-0.664677175,0.906201529,197,87,110,0,0.737966017,0.273116796,1.170500555,0.503664148,0.580639698,0.580639698,1.170500555,0.273116796,0,1,1
2313,10,154,52,110,105,1,6138.929,14,1641.245,MORE,74,2756,2830,6,1,-5,-0.46870423,5,-0.698430296,-1.693854737,2.351521337,215,110,105,1,1.096976512,1.170500555,0.975417129,1.743452821,-0.242416379,0.242416379,0.975417129,1.170500555,0,1,0
2314,10,155,30,80,96,0,1443.82,34,1291.048,MORE,-398,908,510,2,1,16,1.499853537,16,1.222253018,-1.007736362,-0.813328084,176,80,96,0,0.31912044,0,0.624266962,-0.736124524,-0.825723388,0.825723388,0.624266962,0,0,0,0
2315,10,156,24,80,86,0,7491.703,14,1349.897,MORE,-1416,4262,2846,8,1,6,0.562445076,6,-0.523822722,-1.693854737,3.263390691,166,80,86,0,0.119670165,0,0.234100111,2.983241494,-2.083788081,2.083788081,0.234100111,0,0,1,0
2316,10,157,5,50,55,1,2171.036,64,1106.904,MORE,432,1058,1490,5,2,5,0.46870423,5,-0.698430296,0.021441199,-0.323130915,105,50,55,0,-1.096976512,-1.170500555,-0.975417129,1.123558485,0.200007158,0.200007158,-0.975417129,-1.170500555,1,1,0
2317,10,158,34,80,74,1,5706.277,44,2547.215,MORE,1124,2022,3146,7,2,-6,-0.562445076,6,-0.523822722,-0.664677175,2.05988201,154,80,74,1,-0.119670165,0,-0.234100111,2.363347157,1.055194552,1.055194552,-0.234100111,0,0,1,1
2318,10,159,15,45,50,1,3753.437,54,1507.582,MORE,450,1470,1920,5,2,5,0.46870423,5,-0.698430296,-0.321617988,0.743523956,95,45,50,0,-1.296426786,-1.36558398,-1.170500555,1.123558485,0.222251917,0.222251917,-1.170500555,-1.36558398,0,1,1
2319,10,160,37,69,80,1,1171.933,14,2141.878,MORE,-66,1422,1356,1,1,11,1.031149307,11,0.349215148,-1.693854737,-0.996599956,149,69,80,0,-0.219395302,-0.429183537,0,-1.356018861,-0.415431169,0.415431169,0,-0.429183537,0,0,0
2320,10,161,3,50,53,1,3448.474,24,1334.06,LESS,-168,1766,1598,4,1,3,0.281222538,3,-1.047645444,-1.35079555,0.537956424,103,50,53,1,-1.136866566,-1.170500555,-1.053450499,0.503664148,-0.541484803,0.541484803,-1.053450499,-1.170500555,0,1,0
2321,10,162,20,50,40,1,2001.147,84,1431.677,LESS,734,842,1576,3,2,-10,-0.937408461,10,0.174607574,0.707559574,-0.43764862,90,50,40,0,-1.396151924,-1.170500555,-1.560667406,-0.116230188,0.573224778,0.573224778,-1.560667406,-1.170500555,1,0,1
2322,10,163,25,80,88,0,2892.033,34,2003.171,LESS,-978,1942,964,4,1,8,0.749926769,8,-0.174607574,-1.007736362,0.162874189,168,80,88,1,0.15956022,0,0.312133481,0.503664148,-1.542498949,1.542498949,0.312133481,0,0,1,0
2323,10,164,42,115,110,1,1321.444,84,1275.982,LESS,636,678,1314,2,2,-5,-0.46870423,5,-0.698430296,0.707559574,-0.895818525,225,115,110,0,1.296426786,1.36558398,1.170500555,-0.736124524,0.452114424,0.452114424,1.170500555,1.36558398,1,0,1
2324,10,165,53,103,110,0,2314.263,74,1605.217,LESS,12,1380,1392,4,2,7,0.656185922,7,-0.349215148,0.364500386,-0.226585364,213,103,110,1,1.057086457,0.897383758,1.170500555,0.503664148,-0.319037215,0.319037215,1.170500555,0.897383758,0,1,0
2325,10,166,26,90,80,0,6228.2,14,2328.601,LESS,412,2792,3204,9,2,-10,-0.937408461,10,0.174607574,-1.693854737,2.411696569,170,90,80,0,0.199450275,0.390166852,0,3.60313583,0.175290759,0.175290759,0,0.390166852,0,1,1
2326,10,167,35,80,72,1,1066.489,74,1860.841,LESS,-2,1078,1076,2,2,-8,-0.749926769,8,-0.174607574,0.364500386,-1.067676981,152,80,72,0,-0.15956022,0,-0.312133481,-0.736124524,-0.336338694,0.336338694,-0.312133481,0,1,0,0
2327,10,168,28,93,80,1,1764.032,94,1535.49,LESS,1088,844,1932,3,2,-13,-1.218630999,13,0.698430296,1.050618761,-0.597481601,173,93,80,0,0.259285357,0.507216907,0,-0.116230188,1.010705035,1.010705035,0,0.507216907,1,0,1
2328,10,169,26,80,90,0,1403.79,74,1231.304,LESS,46,1100,1146,2,2,10,0.937408461,10,0.174607574,0.364500386,-0.840311253,170,80,90,1,0.199450275,0,0.390166852,-0.736124524,-0.277019337,0.277019337,0.390166852,0,1,0,0
2329,10,170,25,88,80,0,1236.143,84,1155.197,LESS,596,838,1434,3,2,-8,-0.749926769,8,-0.174607574,0.707559574,-0.953317684,168,88,80,0,0.15956022,0.312133481,0,-0.116230188,0.402681627,0.402681627,0,0.312133481,1,0,1
2330,10,171,36,80,70,1,1200.47,100,1152.018,LESS,1252,318,1570,1,2,-10,-0.937408461,10,0.174607574,1.256454273,-0.977363915,150,80,70,0,-0.199450275,0,-0.390166852,-1.356018861,1.213379504,1.213379504,-0.390166852,0,1,0,1
2331,10,172,28,80,93,0,1443.762,4,2466.642,LESS,-1440,2158,718,4,1,13,1.218630999,13,0.698430296,-2.036913924,-0.81336718,173,80,93,1,0.259285357,0,0.507216907,0.503664148,-2.113447759,2.113447759,0.507216907,0,0,1,0
2332,10,173,21,82,80,1,1816.375,74,1221.995,LESS,756,852,1608,3,2,-2,-0.187481692,2,-1.222253018,0.364500386,-0.562198562,162,82,80,0,0.039890055,0.07803337,0,-0.116230188,0.600412817,0.600412817,0,0.07803337,1,0,1
2333,10,174,19,50,41,1,2130.63,84,1219.383,LESS,1084,830,1914,2,2,-9,-0.843667615,9,0,0.707559574,-0.350367537,91,50,41,0,-1.376206896,-1.170500555,-1.521650721,-0.736124524,1.005761755,1.005761755,-1.521650721,-1.170500555,1,0,1
2334,10,175,56,96,110,0,6347.843,0,1574.224,LESS,-2180,4140,1960,6,1,14,1.312371845,14,0.87303787,-2.174137599,2.492344767,206,96,110,1,0.917471264,0.624266962,1.170500555,1.743452821,-3.02795451,3.02795451,1.170500555,0.624266962,0,1,0
2335,10,176,23,80,85,0,2640.37,74,789.606,LESS,100,1264,1364,4,2,5,0.46870423,5,-0.698430296,0.364500386,-0.006765217,165,80,85,1,0.099725137,0,0.195083426,0.503664148,-0.21028506,0.21028506,0.195083426,0,1,1,0
2336,10,177,10,60,50,1,2216.961,94,657.594,LESS,758,954,1712,3,2,-10,-0.937408461,10,0.174607574,1.050618761,-0.292174081,110,60,50,0,-0.997251374,-0.780333703,-1.170500555,-0.116230188,0.602884456,0.602884456,-1.170500555,-0.780333703,1,1,1
2337,10,178,19,41,50,0,1285.889,94,863.68,LESS,378,852,1230,3,2,9,0.843667615,9,0,1.050618761,-0.919785215,91,41,50,1,-1.376206896,-1.521650721,-1.170500555,-0.116230188,0.133272881,0.133272881,-1.170500555,-1.521650721,1,0,1
2338,10,179,56,110,96,1,1833.967,54,1916.476,LESS,146,780,926,3,2,-14,-1.312371845,14,0.87303787,-0.321617988,-0.550340258,206,110,96,0,0.917471264,1.170500555,0.624266962,-0.116230188,-0.153437343,0.153437343,0.624266962,1.170500555,0,0,0
2339,10,180,35,72,80,1,2042.111,74,1699.071,LESS,346,928,1274,3,2,8,0.749926769,8,-0.174607574,0.364500386,-0.410035865,152,72,80,1,-0.15956022,-0.312133481,0,-0.116230188,0.093726644,0.093726644,0,-0.312133481,1,0,1
2340,10,181,11,49,50,0,1562.155,90,1095.238,LESS,184,866,1050,2,2,1,0.093740846,1,-1.396860592,0.913395086,-0.733561574,99,49,50,1,-1.216646676,-1.20951724,-1.170500555,-0.736124524,-0.106476186,0.106476186,-1.170500555,-1.20951724,1,0,0
2341,10,182,17,43,50,0,1721.177,94,2030.981,LESS,1084,906,1990,3,2,7,0.656185922,7,-0.349215148,1.050618761,-0.626369029,93,43,50,1,-1.336316841,-1.443617351,-1.170500555,-0.116230188,1.005761755,1.005761755,-1.170500555,-1.443617351,1,0,1
2342,10,183,1,51,50,0,1232.152,80,1179.728,LESS,524,860,1384,2,2,-1,-0.093740846,1,-1.396860592,0.570335899,-0.956007912,101,51,50,0,-1.176756621,-1.131483869,-1.170500555,-0.736124524,0.313702592,0.313702592,-1.170500555,-1.131483869,1,0,1
2343,10,184,41,112,110,0,3342.02,44,1744.984,LESS,-620,2034,1414,5,2,-2,-0.187481692,2,-1.222253018,-0.664677175,0.466198584,222,112,110,0,1.236591704,1.248533925,1.170500555,1.123558485,-1.100075413,1.100075413,1.170500555,1.248533925,0,1,0
2344,10,185,20,40,50,0,1865.652,94,1729.593,LESS,272,1352,1624,3,2,10,0.937408461,10,0.174607574,1.050618761,-0.528982233,90,40,50,1,-1.396151924,-1.560667406,-1.170500555,-0.116230188,0.002275968,0.002275968,-1.170500555,-1.560667406,1,0,0
2345,10,186,1,50,51,0,4279.312,44,2042.34,LESS,-178,2004,1826,6,1,1,0.093740846,1,-1.396860592,-0.664677175,1.098002455,101,50,51,1,-1.176756621,-1.170500555,-1.131483869,1.743452821,-0.553843002,0.553843002,-1.131483869,-1.170500555,0,1,0
2346,10,187,23,85,80,1,2332.379,84,1361.607,LESS,1090,790,1880,2,2,-5,-0.46870423,5,-0.698430296,0.707559574,-0.214373845,165,85,80,0,0.099725137,0.195083426,0,-0.736124524,1.013176675,1.013176675,0,0.195083426,1,0,1
2347,10,188,11,50,49,0,2874.983,84,2193.465,LESS,324,1604,1928,4,2,-1,-0.093740846,1,-1.396860592,0.707559574,0.151381232,99,50,49,0,-1.216646676,-1.170500555,-1.20951724,0.503664148,0.066538605,0.066538605,-1.20951724,-1.170500555,1,1,1
2348,10,189,17,50,43,1,2588.425,64,1157.522,LESS,480,958,1438,3,2,-7,-0.656185922,7,-0.349215148,0.021441199,-0.041779974,93,50,43,0,-1.336316841,-1.170500555,-1.443617351,-0.116230188,0.259326515,0.259326515,-1.443617351,-1.170500555,0,0,1
2349,10,190,21,80,82,1,1532.4,84,1404.019,LESS,1104,644,1748,2,2,2,0.187481692,2,-1.222253018,0.707559574,-0.753618637,162,80,82,1,0.039890055,0,0.07803337,-0.736124524,1.030478154,1.030478154,0.07803337,0,1,0,1
2350,10,191,10,50,60,0,1241.75,100,1497.358,LESS,596,986,1582,3,2,10,0.937408461,10,0.174607574,1.256454273,-0.949538153,110,50,60,1,-0.997251374,-1.170500555,-0.780333703,-0.116230188,0.402681627,0.402681627,-0.780333703,-1.170500555,1,1,1
2351,10,192,3,53,50,0,4626.554,34,1565.711,LESS,-780,2526,1746,6,1,-3,-0.281222538,3,-1.047645444,-1.007736362,1.332069149,103,53,50,0,-1.136866566,-1.053450499,-1.170500555,1.743452821,-1.297806602,1.297806602,-1.170500555,-1.053450499,0,1,0
2352,10,193,45,122,110,1,1099.336,84,2137.125,LESS,1722,398,2120,1,2,-12,-1.124890153,12,0.523822722,0.707559574,-1.045535683,232,122,110,0,1.436041979,1.638700776,1.170500555,-1.356018861,1.794214873,1.794214873,1.170500555,1.638700776,1,0,1
2353,10,194,38,67,80,0,1693.148,54,3763.236,LESS,-548,1136,588,2,1,13,1.218630999,13,0.698430296,-0.321617988,-0.64526264,147,67,80,1,-0.259285357,-0.507216907,0,-0.736124524,-1.011096378,1.011096378,0,-0.507216907,0,0,0
2354,10,195,38,80,67,1,1188.2,94,2249.616,LESS,1884,276,2160,1,2,-13,-1.218630999,13,0.698430296,1.050618761,-0.985634799,147,80,67,0,-0.259285357,0,-0.507216907,-1.356018861,1.994417702,1.994417702,-0.507216907,0,1,0,1
2355,10,196,36,70,80,0,2188.882,100,1966.649,LESS,562,1340,1902,3,2,10,0.937408461,10,0.174607574,1.256454273,-0.311101396,150,70,80,1,-0.199450275,-0.390166852,0,-0.116230188,0.360663749,0.360663749,0,-0.390166852,1,1,1
2356,10,197,45,110,122,0,1153.027,64,3276.059,LESS,-914,1522,608,1,1,12,1.124890153,12,0.523822722,0.021441199,-1.009343993,232,110,122,1,1.436041979,1.170500555,1.638700776,-1.356018861,-1.463406474,1.463406474,1.638700776,1.170500555,0,0,0
2357,10,198,42,110,115,0,3372.397,14,2402.45,LESS,-478,2254,1776,5,1,5,0.46870423,5,-0.698430296,-1.693854737,0.48667492,225,110,115,1,1.296426786,1.170500555,1.36558398,1.123558485,-0.924588982,0.924588982,1.36558398,1.170500555,0,1,0
2358,10,199,41,110,112,1,2141.581,84,2520.01,LESS,3078,364,3442,1,2,2,0.187481692,2,-1.222253018,0.707559574,-0.342985756,222,110,112,1,1.236591704,1.170500555,1.248533925,-1.356018861,3.469986704,3.469986704,1.248533925,1.170500555,1,0,1
2359,10,200,53,110,103,1,1306.07,94,1680.204,LESS,1564,262,1826,1,2,-7,-0.656185922,7,-0.349215148,1.050618761,-0.906181734,213,110,103,0,1.057086457,1.170500555,0.897383758,-1.356018861,1.598955323,1.598955323,0.897383758,1.170500555,1,0,1
2360,10,201,3,50,53,1,1227.903,84,2300.477,MORE,1912,406,2318,1,2,3,0.281222538,3,-1.047645444,0.707559574,-0.958872051,103,50,53,0,-1.136866566,-1.170500555,-1.053450499,-1.356018861,2.029020661,2.029020661,-1.053450499,-1.170500555,1,0,1
2361,10,202,20,50,40,0,2017.013,100,1403.976,MORE,830,1006,1836,3,2,-10,-0.937408461,10,0.174607574,1.256454273,-0.426953766,90,50,40,1,-1.396151924,-1.170500555,-1.560667406,-0.116230188,0.691863492,0.691863492,-1.560667406,-1.170500555,1,0,1
2362,10,203,25,80,88,1,2611.379,74,1032.497,MORE,736,1232,1968,2,2,8,0.749926769,8,-0.174607574,0.364500386,-0.026307287,168,80,88,0,0.15956022,0,0.312133481,-0.736124524,0.575696418,0.575696418,0.312133481,0,1,0,1
2363,10,204,42,115,110,1,2512.763,4,2295.234,MORE,-1266,2178,912,3,1,-5,-0.46870423,5,-0.698430296,-2.036913924,-0.092781738,225,115,110,1,1.296426786,1.36558398,1.170500555,-0.116230188,-1.898415091,1.898415091,1.170500555,1.36558398,0,0,0
2364,10,205,53,103,110,1,1766.796,74,1186.948,MORE,800,534,1334,2,2,7,0.656185922,7,-0.349215148,0.364500386,-0.595618462,213,103,110,0,1.057086457,0.897383758,1.170500555,-0.736124524,0.654788894,0.654788894,1.170500555,0.897383758,1,0,1
2365,10,206,26,90,80,0,1995.841,94,1141.454,MORE,506,934,1440,1,2,-10,-0.937408461,10,0.174607574,1.050618761,-0.441225255,170,90,80,1,0.199450275,0.390166852,0,-1.356018861,0.291457833,0.291457833,0,0.390166852,1,0,1
2366,10,207,35,80,72,0,1143.188,100,2460.065,MORE,1006,788,1794,2,2,-8,-0.749926769,8,-0.174607574,1.256454273,-1.015976204,152,80,72,1,-0.15956022,0,-0.312133481,-0.736124524,0.9093678,0.9093678,-0.312133481,0,1,0,1
2367,10,208,28,93,80,1,1491.604,0,1756.204,MORE,-908,1344,436,1,1,-13,-1.218630999,13,0.698430296,-2.174137599,-0.781118147,173,93,80,1,0.259285357,0.507216907,0,-1.356018861,-1.455991554,1.455991554,0,0.507216907,0,0,0
2368,10,209,26,80,90,1,2656.389,34,1994.52,MORE,484,980,1464,3,2,10,0.937408461,10,0.174607574,-1.007736362,0.004032769,170,80,90,0,0.199450275,0,0.390166852,-0.116230188,0.264269794,0.264269794,0.390166852,0,0,0,1
2369,10,210,25,88,80,0,1688.155,100,732.942,MORE,-216,1020,804,2,2,-8,-0.749926769,8,-0.174607574,1.256454273,-0.64862829,168,88,80,1,0.15956022,0.312133481,0,-0.736124524,-0.60080416,0.60080416,0,0.312133481,1,0,0
2370,10,211,36,80,70,0,1190.659,94,2438.019,MORE,614,862,1476,1,2,-10,-0.937408461,10,0.174607574,1.050618761,-0.983977252,150,80,70,1,-0.199450275,0,-0.390166852,-1.356018861,0.424926386,0.424926386,-0.390166852,0,1,0,1
2371,10,212,28,80,93,1,2803.53,54,1154.808,MORE,514,982,1496,4,2,13,1.218630999,13,0.698430296,-0.321617988,0.103216645,173,80,93,0,0.259285357,0,0.507216907,0.503664148,0.301344392,0.301344392,0.507216907,0,0,1,1
2372,10,213,21,82,80,1,2437.721,44,2047.078,MORE,628,822,1450,4,2,-2,-0.187481692,2,-1.222253018,-0.664677175,-0.143365575,162,82,80,1,0.039890055,0.07803337,0,0.503664148,0.442227865,0.442227865,0,0.07803337,0,1,1
2373,10,214,19,50,41,0,3223.498,34,1151.242,MORE,-530,1656,1126,4,1,-9,-0.843667615,9,0,-1.007736362,0.386306022,91,50,41,1,-1.376206896,-1.170500555,-1.521650721,0.503664148,-0.988851619,0.988851619,-1.521650721,-1.170500555,0,1,0
2374,10,215,56,96,110,1,2559.688,94,2277.924,MORE,2312,1008,3320,4,2,14,1.312371845,14,0.87303787,1.050618761,-0.06115083,206,96,110,0,0.917471264,0.624266962,1.170500555,0.503664148,2.523348634,2.523348634,1.170500555,0.624266962,1,1,1
2375,10,216,23,80,85,1,3473.292,44,1301.227,MORE,482,1254,1736,5,2,5,0.46870423,5,-0.698430296,-0.664677175,0.554685584,165,80,85,0,0.099725137,0,0.195083426,1.123558485,0.261798155,0.261798155,0.195083426,0,0,1,1
2376,10,217,10,60,50,0,2095.43,34,1414.422,MORE,-332,1184,852,2,1,-10,-0.937408461,10,0.174607574,-1.007736362,-0.37409493,110,60,50,1,-0.997251374,-0.780333703,-1.170500555,-0.736124524,-0.744159272,0.744159272,-1.170500555,-0.780333703,0,0,0
2377,10,218,19,41,50,0,3955.994,14,1887.047,MORE,-656,2504,1848,6,1,9,0.843667615,9,0,-1.693854737,0.8800623,91,41,50,0,-1.376206896,-1.521650721,-1.170500555,1.743452821,-1.144564931,1.144564931,-1.170500555,-1.521650721,0,1,0
2378,10,219,56,110,96,1,3932.331,64,1389.207,MORE,514,1578,2092,6,2,-14,-1.312371845,14,0.87303787,0.021441199,0.864111694,206,110,96,1,0.917471264,1.170500555,0.624266962,1.743452821,0.301344392,0.301344392,0.624266962,1.170500555,0,1,1
2379,10,220,35,72,80,1,1386.995,94,831.197,MORE,974,474,1448,2,2,8,0.749926769,8,-0.174607574,1.050618761,-0.851632321,152,72,80,0,-0.15956022,-0.312133481,0,-0.736124524,0.869821562,0.869821562,0,-0.312133481,1,0,1
2380,10,221,11,49,50,0,2313.741,64,1118.255,MORE,-174,1082,908,3,2,1,0.093740846,1,-1.396860592,0.021441199,-0.22693723,99,49,50,0,-1.216646676,-1.20951724,-1.170500555,-0.116230188,-0.548899722,0.548899722,-1.170500555,-1.20951724,0,0,0
2381,10,222,17,43,50,1,3087.358,74,1363.184,MORE,1640,990,2630,4,2,7,0.656185922,7,-0.349215148,0.364500386,0.294537631,93,43,50,0,-1.336316841,-1.443617351,-1.170500555,0.503664148,1.692877638,1.692877638,-1.170500555,-1.443617351,1,1,1
2382,10,223,1,51,50,0,2405.645,84,1133.452,MORE,502,1298,1800,3,2,-1,-0.093740846,1,-1.396860592,0.707559574,-0.164987162,101,51,50,1,-1.176756621,-1.131483869,-1.170500555,-0.116230188,0.286514553,0.286514553,-1.170500555,-1.131483869,1,0,1
2383,10,224,41,112,110,1,5096.262,44,2452.001,MORE,1272,1390,2662,3,2,-2,-0.187481692,2,-1.222253018,-0.664677175,1.648686951,222,112,110,1,1.236591704,1.248533925,1.170500555,-0.116230188,1.238095903,1.238095903,1.170500555,1.248533925,0,0,1
2384,10,225,20,40,50,1,4183.426,74,1546.207,MORE,1364,1666,3030,5,2,10,0.937408461,10,0.174607574,0.364500386,1.033368226,90,40,50,0,-1.396151924,-1.560667406,-1.170500555,1.123558485,1.351791337,1.351791337,-1.170500555,-1.560667406,1,1,1
2385,10,226,1,50,51,0,1491.33,84,1121.541,MORE,-52,1124,1072,2,2,1,0.093740846,1,-1.396860592,0.707559574,-0.781302843,101,50,51,0,-1.176756621,-1.170500555,-1.131483869,-0.736124524,-0.39812969,0.39812969,-1.131483869,-1.170500555,1,0,0
2386,10,227,23,85,80,0,1781.244,100,1111.655,MORE,472,968,1440,3,2,-5,-0.46870423,5,-0.698430296,1.256454273,-0.585879445,165,85,80,1,0.099725137,0.195083426,0,-0.116230188,0.249439955,0.249439955,0,0.195083426,1,0,1
2387,10,228,11,50,49,1,11001.154,24,1440.886,MORE,2046,3538,5584,13,1,-1,-0.093740846,1,-1.396860592,-1.35079555,5.629019256,99,50,49,1,-1.216646676,-1.170500555,-1.20951724,6.082713176,2.194620532,2.194620532,-1.20951724,-1.170500555,0,1,1
2388,10,229,17,50,43,0,5732.735,4,2101.386,MORE,-2198,4046,1848,6,1,-7,-0.656185922,7,-0.349215148,-2.036913924,2.077716651,93,50,43,1,-1.336316841,-1.170500555,-1.443617351,1.743452821,-3.050199269,3.050199269,-1.443617351,-1.170500555,0,1,0
2389,10,230,21,80,82,0,4565.044,24,1769.465,MORE,-244,1948,1704,5,1,2,0.187481692,2,-1.222253018,-1.35079555,1.290606877,162,80,82,0,0.039890055,0,0.07803337,1.123558485,-0.635407118,0.635407118,0.07803337,0,0,1,0
2390,10,231,10,50,60,1,1287.406,70,1367.783,MORE,724,390,1114,2,2,10,0.937408461,10,0.174607574,0.227276712,-0.918762645,110,50,60,0,-0.997251374,-1.170500555,-0.780333703,-0.736124524,0.560866579,0.560866579,-0.780333703,-1.170500555,1,0,1
2391,10,232,3,53,50,0,1760.896,44,1505.808,MORE,-170,942,772,3,1,-3,-0.281222538,3,-1.047645444,-0.664677175,-0.599595496,103,53,50,1,-1.136866566,-1.053450499,-1.170500555,-0.116230188,-0.543956443,0.543956443,-1.170500555,-1.053450499,0,0,0
2392,10,233,45,122,110,0,6325.959,34,1908.706,MORE,-956,2894,1938,5,1,-12,-1.124890153,12,0.523822722,-1.007736362,2.477593339,232,122,110,1,1.436041979,1.638700776,1.170500555,1.123558485,-1.515310911,1.515310911,1.170500555,1.638700776,0,1,0
2393,10,234,38,67,80,1,3826.767,84,1903.734,MORE,1526,1336,2862,5,2,13,1.218630999,13,0.698430296,0.707559574,0.79295378,147,67,80,0,-0.259285357,-0.507216907,0,1.123558485,1.551994166,1.551994166,0,-0.507216907,1,1,1
2394,10,235,38,80,67,0,2005.404,94,1260.568,MORE,540,910,1450,3,2,-13,-1.218630999,13,0.698430296,1.050618761,-0.434779088,147,80,67,1,-0.259285357,0,-0.507216907,-0.116230188,0.333475711,0.333475711,-0.507216907,0,1,0,1
2395,10,236,36,70,80,1,1723.492,100,1569.247,MORE,1452,636,2088,3,2,10,0.937408461,10,0.174607574,1.256454273,-0.624808548,150,70,80,0,-0.199450275,-0.390166852,0,-0.116230188,1.460543491,1.460543491,0,-0.390166852,1,0,1
2396,10,237,45,110,122,1,3657.047,44,2029.524,MORE,416,1538,1954,5,2,12,1.124890153,12,0.523822722,-0.664677175,0.678549994,232,110,122,0,1.436041979,1.170500555,1.638700776,1.123558485,0.180234039,0.180234039,1.638700776,1.170500555,0,1,0
2397,10,238,42,110,115,0,8016.802,4,2193.68,MORE,-394,3490,3096,7,1,5,0.46870423,5,-0.698430296,-2.036913924,3.617346109,225,110,115,0,1.296426786,1.170500555,1.36558398,2.363347157,-0.820780108,0.820780108,1.36558398,1.170500555,0,1,0
2398,10,239,41,110,112,0,2172.586,54,909.094,MORE,-348,1126,778,3,1,2,0.187481692,2,-1.222253018,-0.321617988,-0.322086101,222,110,112,0,1.236591704,1.170500555,1.248533925,-0.116230188,-0.763932391,0.763932391,1.248533925,1.170500555,0,1,0
2399,10,240,53,110,103,0,1299.215,74,2356.527,MORE,1430,876,2306,2,2,-7,-0.656185922,7,-0.349215148,0.364500386,-0.910802509,213,110,103,1,1.057086457,1.170500555,0.897383758,-0.736124524,1.433355452,1.433355452,0.897383758,1.170500555,1,0,1
2400,11,1,49,110,131,1,8564.741,70,2387.662,MORE,1340,3240,4580,5,1,21,1.968557767,21,2.095290887,0.566157074,0.722055661,241,110,131,0,1.615547226,1.170500555,1.989850943,0.762628203,1.096539474,1.096539474,1.989850943,1.170500555,1,1,1
2401,11,2,13,47,50,0,13211.21,40,2683.764,MORE,-2832,6398,3566,7,1,3,0.281222538,3,-1.047645444,-0.535553989,1.842779655,97,47,50,0,-1.256536731,-1.28755061,-1.170500555,1.746664593,-2.162709033,2.162709033,-1.170500555,-1.28755061,0,1,0
2402,11,3,16,50,44,1,3541.179,80,1877.262,MORE,802,1226,2028,2,2,-6,-0.562445076,6,-0.523822722,0.933394096,-0.489622814,94,50,44,1,-1.316371814,-1.170500555,-1.404600665,-0.713426383,0.676243286,0.676243286,-1.404600665,-1.170500555,1,0,1
2403,11,4,7,57,50,0,3412.393,70,2596.234,MORE,-198,2010,1812,4,2,-7,-0.656185922,7,-0.349215148,0.566157074,-0.520685877,107,57,50,1,-1.057086457,-0.897383758,-1.170500555,0.270610007,-0.104976395,0.104976395,-1.170500555,-0.897383758,1,1,0
2404,11,5,18,42,50,1,4174.505,40,1060.438,MORE,-222,1856,1634,5,2,8,0.749926769,8,-0.174607574,-0.535553989,-0.336865173,92,42,50,0,-1.356261869,-1.482634036,-1.170500555,0.762628203,-0.123725667,0.123725667,-1.170500555,-1.482634036,0,1,0
2405,11,6,51,108,110,1,7675.66,30,1045.287,MORE,1314,2824,4138,7,1,2,0.187481692,2,-1.222253018,-0.90279101,0.507610152,218,108,110,0,1.156811594,1.092467184,1.170500555,1.746664593,1.076227763,1.076227763,1.170500555,1.092467184,0,1,1
2406,11,7,31,78,80,0,14244.499,60,4169.227,MORE,-952,6214,5262,9,2,2,0.187481692,2,-1.222253018,0.198920053,2.092008,158,78,80,0,-0.039890055,-0.07803337,0,2.730700983,-0.694016034,0.694016034,0,-0.07803337,0,1,0
2407,11,8,58,110,92,0,5214.058,70,2479.289,MORE,-1066,2144,1078,2,1,-18,-1.687335229,18,1.571468165,0.566157074,-0.086125957,202,110,92,1,0.837691154,1.170500555,0.468200222,-0.713426383,-0.783075077,0.783075077,0.468200222,1.170500555,1,0,0
2408,11,9,12,50,48,0,6897.868,30,2542.375,MORE,-1286,3580,2294,6,1,-2,-0.187481692,2,-1.222253018,-0.90279101,0.320007446,98,50,48,1,-1.236591704,-1.170500555,-1.248533925,1.254646398,-0.954943407,0.954943407,-1.248533925,-1.170500555,0,1,0
2409,11,10,54,110,101,0,1021.941,10,6089.425,MORE,-1738,2090,352,0,1,-9,-0.843667615,9,0,-1.637265053,-1.097260673,211,110,101,1,1.017196402,1.170500555,0.819350388,-1.697462773,-1.308054703,1.308054703,0.819350388,1.170500555,0,0,0
2410,11,11,14,46,50,0,13861.923,30,2470.007,MORE,1368,4980,6348,5,1,4,0.374963384,4,-0.87303787,-0.90279101,1.999731025,96,46,50,0,-1.276481759,-1.326567295,-1.170500555,0.762628203,1.118413625,1.118413625,-1.170500555,-1.326567295,0,1,1
2411,11,12,22,80,83,1,4414.546,90,5301.606,MORE,88,1826,1914,2,2,3,0.281222538,3,-1.047645444,1.300631117,-0.278967507,163,80,83,0,0.059835082,0,0.117050055,-0.713426383,0.118452434,0.118452434,0.117050055,0,1,0,1
2412,11,13,6,50,56,1,13654.764,20,3358.572,MORE,650,4636,5286,6,2,6,0.562445076,6,-0.523822722,-1.270028032,1.949764467,106,50,56,0,-1.077031484,-1.170500555,-0.936400444,1.254646398,0.557497895,0.557497895,-0.936400444,-1.170500555,0,1,1
2413,11,14,13,50,47,1,3961.79,80,2250.048,MORE,1202,1322,2524,3,2,-3,-0.281222538,3,-1.047645444,0.933394096,-0.388171832,97,50,47,1,-1.256536731,-1.170500555,-1.28755061,-0.221408188,0.988731158,0.988731158,-1.28755061,-1.170500555,1,1,1
2414,11,15,46,110,124,1,3624.73,80,1715.742,MORE,158,1376,1534,1,2,14,1.312371845,14,0.87303787,0.933394096,-0.46947039,234,110,124,0,1.475932034,1.170500555,1.716734147,-1.205444578,0.173137812,0.173137812,1.716734147,1.170500555,1,0,1
2415,11,16,27,91,80,0,18057.753,0,735.234,MORE,-4638,9252,4614,7,1,-11,-1.031149307,11,0.349215148,-2.004502074,3.011761312,171,91,80,1,0.219395302,0.429183537,0,1.746664593,-3.573591777,3.573591777,0,0.429183537,0,1,0
2416,11,17,40,64,80,1,2921.995,30,2893.517,MORE,868,852,1720,2,2,16,1.499853537,16,1.222253018,-0.90279101,-0.638969418,144,64,80,0,-0.31912044,-0.624266962,0,-0.713426383,0.727803785,0.727803785,0,-0.624266962,0,0,1
2417,11,18,22,83,80,0,9394.374,60,4310.239,MORE,1300,2278,3578,4,1,-3,-0.281222538,3,-1.047645444,0.198920053,0.922162368,163,83,80,1,0.059835082,0.117050055,0,0.270610007,1.065290687,1.065290687,0,0.117050055,0,1,1
2418,11,19,54,101,110,1,12000.368,80,1428.138,MORE,1604,3400,5004,4,2,9,0.843667615,9,0,0.933394096,1.550725693,211,101,110,0,1.017196402,0.819350388,1.170500555,0.270610007,1.30278147,1.30278147,1.170500555,0.819350388,1,1,1
2419,11,20,6,56,50,1,5792.883,60,1460.286,MORE,-548,2772,2224,3,2,-6,-0.562445076,6,-0.523822722,0.198920053,0.053486093,106,56,50,1,-1.077031484,-0.936400444,-1.170500555,-0.221408188,-0.378403283,0.378403283,-1.170500555,-0.936400444,0,1,0
2420,11,21,18,50,42,1,11095.371,60,4954.37,MORE,-366,2714,2348,2,2,-8,-0.749926769,8,-0.174607574,0.198920053,1.33244126,92,50,42,1,-1.356261869,-1.170500555,-1.482634036,-0.713426383,-0.236221301,0.236221301,-1.482634036,-1.170500555,0,0,0
2421,11,22,43,110,117,0,4784.801,70,2222.79,MORE,-1102,2512,1410,4,2,7,0.656185922,7,-0.349215148,0.566157074,-0.189662346,227,110,117,0,1.336316841,1.170500555,1.443617351,0.270610007,-0.811198986,0.811198986,1.443617351,1.170500555,1,1,0
2422,11,23,32,77,80,1,1362.363,10,6231.609,MORE,-2626,2942,316,2,1,3,0.281222538,3,-1.047645444,-1.637265053,-1.015151203,157,77,80,0,-0.059835082,-0.117050055,0,-0.713426383,-2.001777779,2.001777779,0,-0.117050055,0,0,0
2423,11,24,27,80,91,1,7178.638,80,1675.616,MORE,2120,1556,3676,3,2,11,1.031149307,11,0.349215148,0.933394096,0.387728909,171,80,91,0,0.219395302,0,0.429183537,-0.221408188,1.705890825,1.705890825,0.429183537,0,1,0,1
2424,11,25,16,44,50,0,6065.669,30,1694.489,MORE,-1232,1936,704,1,1,6,0.562445076,6,-0.523822722,-0.90279101,0.119281823,94,44,50,0,-1.316371814,-1.404600665,-1.170500555,-1.205444578,-0.912757544,0.912757544,-1.170500555,-1.404600665,0,0,0
2425,11,26,7,50,57,1,8251.75,50,2188.525,MORE,86,2334,2420,3,2,7,0.656185922,7,-0.349215148,-0.168316968,0.646562523,107,50,57,0,-1.057086457,-1.170500555,-0.897383758,-0.221408188,0.116889995,0.116889995,-0.897383758,-1.170500555,0,0,1
2426,11,27,14,50,46,1,2260.191,30,8295.867,MORE,218,778,996,1,2,-4,-0.374963384,4,-0.87303787,-0.90279101,-0.798595926,96,50,46,1,-1.276481759,-1.170500555,-1.326567295,-1.205444578,0.220010993,0.220010993,-1.326567295,-1.170500555,0,0,1
2427,11,28,51,110,108,1,5917.833,80,1584.888,MORE,74,1560,1634,1,2,-2,-0.187481692,2,-1.222253018,0.933394096,0.083623917,218,110,108,1,1.156811594,1.170500555,1.092467184,-1.205444578,0.107515359,0.107515359,1.092467184,1.170500555,1,0,1
2428,11,29,50,133,110,0,3524.994,100,2471.063,MORE,-618,1694,1076,2,2,-23,-2.15603946,23,2.444506035,1.667868138,-0.493526621,243,133,110,1,1.655437281,2.067884313,1.170500555,-0.713426383,-0.43308866,0.43308866,1.170500555,2.067884313,1,0,0
2429,11,30,49,131,110,0,16783.433,70,417.033,MORE,-448,4870,4422,6,1,-21,-1.968557767,21,2.095290887,0.566157074,2.704396515,241,131,110,1,1.615547226,1.989850943,1.170500555,1.254646398,-0.300281315,0.300281315,1.170500555,1.989850943,1,1,0
2430,11,31,47,126,110,1,10903.898,30,2268.281,MORE,2996,1868,4864,2,2,-16,-1.499853537,16,1.222253018,-0.90279101,1.28625815,236,126,110,1,1.515822089,1.794767517,1.170500555,-0.713426383,2.390239265,2.390239265,1.170500555,1.794767517,0,0,1
2431,11,32,50,110,133,1,3587.717,70,3748.262,MORE,1132,550,1682,0,2,23,2.15603946,23,2.444506035,0.566157074,-0.478397892,243,110,133,0,1.655437281,1.170500555,2.067884313,-1.697462773,0.934045781,0.934045781,2.067884313,1.170500555,1,0,1
2432,11,33,47,110,126,1,7358.152,70,2493.855,MORE,-108,1336,1228,1,2,16,1.499853537,16,1.222253018,0.566157074,0.431027518,236,110,126,0,1.515822089,1.170500555,1.794767517,-1.205444578,-0.034666623,0.034666623,1.794767517,1.170500555,1,0,0
2433,11,34,12,48,50,0,9287.089,10,7673.336,MORE,-1470,3370,1900,3,1,2,0.187481692,2,-1.222253018,-1.637265053,0.896285326,98,48,50,0,-1.236591704,-1.248533925,-1.170500555,-0.221408188,-1.098687828,1.098687828,-1.170500555,-1.248533925,0,1,0
2434,11,35,32,80,77,0,8693.901,50,4197.663,MORE,-904,1784,880,0,2,-3,-0.281222538,3,-1.047645444,-0.168316968,0.753208933,157,80,77,1,-0.059835082,0,-0.117050055,-1.697462773,-0.656517489,0.656517489,-0.117050055,0,0,0,0
2435,11,36,43,117,110,0,4052.565,60,5061.21,MORE,-558,1152,594,1,1,-7,-0.656185922,7,-0.349215148,0.198920053,-0.366276987,227,117,110,1,1.336316841,1.443617351,1.170500555,-1.205444578,-0.38621548,0.38621548,1.170500555,1.443617351,0,0,0
2436,11,37,40,80,64,0,6860.493,70,7891.607,MORE,-632,1790,1158,3,2,-16,-1.499853537,16,1.222253018,0.566157074,0.310992631,144,80,64,1,-0.31912044,0,-0.624266962,-0.221408188,-0.444025736,0.444025736,-0.624266962,0,1,1,0
2437,11,38,31,80,78,0,9173.561,40,1191.787,MORE,-164,1912,1748,1,1,-2,-0.187481692,2,-1.222253018,-0.535553989,0.868902478,158,80,78,1,-0.039890055,0,-0.07803337,-1.205444578,-0.078414925,0.078414925,-0.07803337,0,0,0,0
2438,11,39,46,124,110,0,15333.791,30,4962.628,MORE,-1660,4396,2736,5,2,-14,-1.312371845,14,0.87303787,-0.90279101,2.354744215,234,124,110,1,1.475932034,1.716734147,1.170500555,0.762628203,-1.247119568,1.247119568,1.170500555,1.716734147,0,1,0
2439,11,40,58,92,110,1,17237.613,80,4056.991,MORE,3712,2652,6364,3,2,18,1.687335229,18,1.571468165,0.933394096,2.813944308,202,92,110,0,0.837691154,0.468200222,1.170500555,-0.221408188,2.949592557,2.949592557,1.170500555,0.468200222,1,0,1
2440,11,41,49,110,131,0,7205.983,20,7028.549,LESS,-1280,3760,2480,4,2,21,1.968557767,21,2.095290887,-1.270028032,0.394324497,241,110,131,1,1.615547226,1.170500555,1.989850943,0.270610007,-0.950256089,0.950256089,1.989850943,1.170500555,0,1,0
2441,11,42,13,47,50,0,19998.593,90,4289.138,LESS,1518,3478,4996,2,2,3,0.281222538,3,-1.047645444,1.300631117,3.479890112,97,47,50,1,-1.256536731,-1.28755061,-1.170500555,-0.713426383,1.235596577,1.235596577,-1.170500555,-1.28755061,1,0,1
2442,11,43,16,50,44,1,7137.775,80,1310.405,LESS,1296,1612,2908,3,2,-6,-0.562445076,6,-0.523822722,0.933394096,0.377872791,94,50,44,0,-1.316371814,-1.170500555,-1.404600665,-0.221408188,1.062165808,1.062165808,-1.404600665,-1.170500555,1,1,1
2443,11,44,7,57,50,0,25257.305,50,2096.043,LESS,2406,4490,6896,8,1,-7,-0.656185922,7,-0.349215148,-0.168316968,4.748286548,107,57,50,0,-1.057086457,-0.897383758,-1.170500555,2.238682788,1.929319654,1.929319654,-1.170500555,-0.897383758,0,1,1
2444,11,45,18,42,50,0,3362.208,80,1615.389,LESS,256,1792,2048,3,2,8,0.749926769,8,-0.174607574,0.933394096,-0.532790452,92,42,50,1,-1.356261869,-1.482634036,-1.170500555,-0.221408188,0.24969734,0.24969734,-1.170500555,-1.482634036,1,1,1
2445,11,46,51,108,110,0,7017.678,30,2633.782,LESS,-1510,3626,2116,3,2,2,0.187481692,2,-1.222253018,-0.90279101,0.348905506,218,108,110,1,1.156811594,1.092467184,1.170500555,-0.221408188,-1.129936616,1.129936616,1.170500555,1.092467184,0,0,0
2446,11,47,31,78,80,1,6164.984,70,1772.123,LESS,1512,1572,3084,3,2,2,0.187481692,2,-1.222253018,0.566157074,0.143236508,158,78,80,1,-0.039890055,-0.07803337,0,-0.221408188,1.230909259,1.230909259,0,-0.07803337,1,0,1
2447,11,48,58,110,92,1,5119.36,80,2456.075,LESS,826,1936,2762,5,2,-18,-1.687335229,18,1.571468165,0.933394096,-0.108967027,202,110,92,0,0.837691154,1.170500555,0.468200222,0.762628203,0.694992558,0.694992558,0.468200222,1.170500555,1,1,1
2448,11,49,12,50,48,0,2237.529,30,3666.12,LESS,-1438,2284,846,3,1,-2,-0.187481692,2,-1.222253018,-0.90279101,-0.804061979,98,50,48,0,-1.236591704,-1.170500555,-1.248533925,-0.221408188,-1.073688799,1.073688799,-1.248533925,-1.170500555,0,0,0
2449,11,50,54,110,101,0,6762.067,10,4217.248,LESS,-640,3588,2948,6,1,-9,-0.843667615,9,0,-1.637265053,0.287252371,211,110,101,0,1.017196402,1.170500555,0.819350388,1.254646398,-0.450275493,0.450275493,0.819350388,1.170500555,0,1,0
2450,11,51,14,46,50,0,2311.99,80,953.66,LESS,-860,1570,710,3,2,4,0.374963384,4,-0.87303787,0.933394096,-0.786102056,96,46,50,1,-1.276481759,-1.326567295,-1.170500555,-0.221408188,-0.622143823,0.622143823,-1.170500555,-1.326567295,1,0,0
2451,11,52,22,80,83,0,5385.946,10,3190.429,LESS,-2438,4514,2076,6,1,3,0.281222538,3,-1.047645444,-1.637265053,-0.044666732,163,80,83,1,0.059835082,0,0.117050055,1.254646398,-1.854908479,1.854908479,0.117050055,0,0,1,0
2452,11,53,6,50,56,0,5013.436,40,1821.039,LESS,-260,2262,2002,6,2,6,0.562445076,6,-0.523822722,-0.535553989,-0.134515797,106,50,56,1,-1.077031484,-1.170500555,-0.936400444,1.254646398,-0.153412015,0.153412015,-0.936400444,-1.170500555,0,1,0
2453,11,54,13,50,47,1,10141.241,20,2560.759,LESS,-2374,4310,1936,5,1,-3,-0.281222538,3,-1.047645444,-1.270028032,1.102305992,97,50,47,0,-1.256536731,-1.170500555,-1.28755061,0.762628203,-1.80491042,1.80491042,-1.28755061,-1.170500555,0,1,0
2454,11,55,46,110,124,0,1752.273,60,2010.709,LESS,-442,1160,718,2,2,14,1.312371845,14,0.87303787,0.198920053,-0.921105275,234,110,124,1,1.475932034,1.170500555,1.716734147,-0.713426383,-0.295593997,0.295593997,1.716734147,1.170500555,1,0,0
2455,11,56,27,91,80,1,2370.396,80,1052.986,LESS,906,918,1824,3,2,-11,-1.031149307,11,0.349215148,0.933394096,-0.772014583,171,91,80,0,0.219395302,0.429183537,0,-0.221408188,0.757490133,0.757490133,0,0.429183537,1,1,1
2456,11,57,40,64,80,0,2708.692,40,3833.568,LESS,-984,1842,858,2,2,16,1.499853537,16,1.222253018,-0.535553989,-0.690417903,144,64,80,1,-0.31912044,-0.624266962,0,-0.713426383,-0.719015064,0.719015064,0,-0.624266962,0,0,0
2457,11,58,22,83,80,1,10099.824,30,2769.094,LESS,236,4014,4250,9,2,-3,-0.281222538,3,-1.047645444,-0.90279101,1.092316251,163,83,80,0,0.059835082,0.117050055,0,2.730700983,0.234072947,0.234072947,0,0.117050055,0,1,1
2458,11,59,54,101,110,0,4645.418,40,6505.392,LESS,-3380,4930,1550,6,1,9,0.843667615,9,0,-0.535553989,-0.223281396,211,101,110,1,1.017196402,0.819350388,1.170500555,1.254646398,-2.590817418,2.590817418,1.170500555,0.819350388,0,1,0
2459,11,60,6,56,50,1,12998.986,40,1729.837,LESS,-266,5390,5124,10,2,-6,-0.562445076,6,-0.523822722,-0.535553989,1.791591424,106,56,50,0,-1.077031484,-0.936400444,-1.170500555,3.222719178,-0.158099333,0.158099333,-1.170500555,-0.936400444,0,1,0
2460,11,61,18,50,42,0,5211.954,70,824.18,LESS,-720,2442,1722,5,1,-8,-0.749926769,8,-0.174607574,0.566157074,-0.08663344,92,50,42,0,-1.356261869,-1.170500555,-1.482634036,0.762628203,-0.512773068,0.512773068,-1.482634036,-1.170500555,1,1,0
2461,11,62,43,110,117,0,3743.349,90,1168.166,LESS,-246,1950,1704,4,2,7,0.656185922,7,-0.349215148,1.300631117,-0.440859598,227,110,117,1,1.336316841,1.170500555,1.443617351,0.270610007,-0.142474939,0.142474939,1.443617351,1.170500555,1,1,0
2462,11,63,32,77,80,0,3109.717,70,2846.162,LESS,-996,2034,1038,4,1,3,0.281222538,3,-1.047645444,0.566157074,-0.593691046,157,77,80,1,-0.059835082,-0.117050055,0,0.270610007,-0.7283897,0.7283897,0,-0.117050055,1,1,0
2463,11,64,27,80,91,0,3173.591,100,1610.114,LESS,874,1542,2416,2,2,11,1.031149307,11,0.349215148,1.667868138,-0.578284697,171,80,91,1,0.219395302,0,0.429183537,-0.713426383,0.732491103,0.732491103,0.429183537,0,1,0,1
2464,11,65,16,44,50,0,1860.656,90,4834.995,LESS,1342,1358,2700,2,2,6,0.562445076,6,-0.523822722,1.300631117,-0.894963396,94,44,50,1,-1.316371814,-1.404600665,-1.170500555,-0.713426383,1.098101914,1.098101914,-1.170500555,-1.404600665,1,0,1
2465,11,66,7,50,57,0,2084.243,100,1197.066,LESS,158,1108,1266,2,2,7,0.656185922,7,-0.349215148,1.667868138,-0.84103442,107,50,57,1,-1.057086457,-1.170500555,-0.897383758,-0.713426383,0.173137812,0.173137812,-0.897383758,-1.170500555,1,0,1
2466,11,67,14,50,46,1,3787.501,10,3670.758,LESS,-798,2720,1922,5,1,-4,-0.374963384,4,-0.87303787,-1.637265053,-0.430210177,96,50,46,0,-1.276481759,-1.170500555,-1.326567295,0.762628203,-0.573708203,0.573708203,-1.326567295,-1.170500555,0,1,0
2467,11,68,51,110,108,0,6420.634,70,2398.31,LESS,1010,2872,3882,8,2,-2,-0.187481692,2,-1.222253018,0.566157074,0.20489905,218,110,108,0,1.156811594,1.170500555,1.092467184,2.238682788,0.83873698,0.83873698,1.092467184,1.170500555,1,1,1
2468,11,69,50,133,110,1,4208.008,60,2758.338,LESS,488,1684,2172,5,2,-23,-2.15603946,23,2.444506035,0.198920053,-0.32878428,243,133,110,0,1.655437281,2.067884313,1.170500555,0.762628203,0.430940306,0.430940306,1.170500555,2.067884313,1,1,1
2469,11,70,49,131,110,1,2605.177,80,3670.807,LESS,2780,1130,3910,3,2,-21,-1.968557767,21,2.095290887,0.933394096,-0.715385624,241,131,110,0,1.615547226,1.989850943,1.170500555,-0.221408188,2.221495814,2.221495814,1.170500555,1.989850943,1,0,1
2470,11,71,47,126,110,1,2968.402,90,2777.917,LESS,2424,936,3360,3,2,-16,-1.499853537,16,1.222253018,1.300631117,-0.627776093,236,126,110,0,1.515822089,1.794767517,1.170500555,-0.221408188,1.943381608,1.943381608,1.170500555,1.794767517,1,0,1
2471,11,72,50,110,133,0,1895.45,80,2906.006,LESS,1100,958,2058,2,2,23,2.15603946,23,2.444506035,0.933394096,-0.886571116,243,110,133,1,1.655437281,1.170500555,2.067884313,-0.713426383,0.909046751,0.909046751,2.067884313,1.170500555,1,0,1
2472,11,73,47,110,126,0,1802.158,70,2110.862,LESS,-188,858,670,3,2,16,1.499853537,16,1.222253018,0.566157074,-0.909073059,236,110,126,1,1.515822089,1.170500555,1.794767517,-0.221408188,-0.097164198,0.097164198,1.794767517,1.170500555,1,1,1
2473,11,74,12,48,50,0,1937.962,40,1721.939,LESS,-266,1018,752,3,2,2,0.187481692,2,-1.222253018,-0.535553989,-0.876317261,98,48,50,1,-1.236591704,-1.248533925,-1.170500555,-0.221408188,-0.158099333,0.158099333,-1.170500555,-1.248533925,0,1,0
2474,11,75,32,80,77,0,5061.215,60,3055.299,LESS,130,2418,2548,5,2,-3,-0.281222538,3,-1.047645444,0.198920053,-0.122991547,157,80,77,0,-0.059835082,0,-0.117050055,0.762628203,0.151263661,0.151263661,-0.117050055,0,0,1,1
2475,11,76,43,117,110,1,3229.779,30,3332.991,LESS,844,1286,2130,3,2,-7,-0.656185922,7,-0.349215148,-0.90279101,-0.564732204,227,117,110,0,1.336316841,1.443617351,1.170500555,-0.221408188,0.709054513,0.709054513,1.170500555,1.443617351,0,1,1
2476,11,77,40,80,64,1,2795.056,70,1218.027,LESS,192,1090,1282,3,2,-16,-1.499853537,16,1.222253018,0.566157074,-0.669586986,144,80,64,0,-0.31912044,0,-0.624266962,-0.221408188,0.199699281,0.199699281,-0.624266962,0,1,1,1
2477,11,78,31,80,78,0,1881.78,40,1824.618,LESS,-720,1200,480,2,1,-2,-0.187481692,2,-1.222253018,-0.535553989,-0.889868307,158,80,78,0,-0.039890055,0,-0.07803337,-0.713426383,-0.512773068,0.512773068,-0.07803337,0,0,0,0
2478,11,79,46,124,110,1,3240.899,0,2378.246,LESS,70,1532,1602,4,2,-14,-1.312371845,14,0.87303787,-2.004502074,-0.56205007,234,124,110,0,1.475932034,1.716734147,1.170500555,0.270610007,0.10439048,0.10439048,1.170500555,1.716734147,0,1,1
2479,11,80,58,92,110,0,4477.226,80,1926.274,LESS,-442,2544,2102,4,2,18,1.687335229,18,1.571468165,0.933394096,-0.263849149,202,92,110,1,0.837691154,0.468200222,1.170500555,0.270610007,-0.295593997,0.295593997,1.170500555,0.468200222,1,1,0
2480,11,81,48,128,110,0,4100.337,10,1699.149,MORE,-1578,3034,1456,4,1,-18,-1.687335229,18,1.571468165,-1.637265053,-0.354754425,238,128,110,1,1.555712144,1.872800887,1.170500555,0.270610007,-1.183059554,1.183059554,1.170500555,1.872800887,0,1,0
2481,11,82,8,50,58,1,4154.866,60,2754.709,MORE,522,1046,1568,3,2,8,0.749926769,8,-0.174607574,0.198920053,-0.341602081,108,50,58,0,-1.037141429,-1.170500555,-0.858367073,-0.221408188,0.457501775,0.457501775,-0.858367073,-1.170500555,0,1,1
2482,11,83,4,54,50,0,3758.666,30,2400.604,MORE,-714,2090,1376,4,1,-4,-0.374963384,4,-0.87303787,-0.90279101,-0.437165152,104,54,50,1,-1.116921539,-1.014433814,-1.170500555,0.270610007,-0.50808575,0.50808575,-1.170500555,-1.014433814,0,1,0
2483,11,84,37,80,69,0,7170.362,50,565.841,MORE,-408,3204,2796,8,1,-11,-1.031149307,11,0.349215148,-0.168316968,0.385732745,149,80,69,1,-0.219395302,0,-0.429183537,2.238682788,-0.269032528,0.269032528,-0.429183537,0,0,1,0
2484,11,85,52,105,110,1,13068.882,70,2181,MORE,3026,3650,6676,8,2,5,0.46870423,5,-0.698430296,0.566157074,1.808450274,215,105,110,0,1.096976512,0.975417129,1.170500555,2.238682788,2.413675856,2.413675856,1.170500555,0.975417129,1,1,1
2485,11,86,5,55,50,1,7234.332,90,1439.077,MORE,2012,2500,4512,7,2,-5,-0.46870423,5,-0.698430296,1.300631117,0.401162249,105,55,50,1,-1.096976512,-0.975417129,-1.170500555,1.746664593,1.6215191,1.6215191,-1.170500555,-0.975417129,1,1,1
2486,11,87,30,96,80,0,3331.992,90,1894.732,MORE,816,1842,2658,5,2,-16,-1.499853537,16,1.222253018,1.300631117,-0.540078523,176,96,80,1,0.31912044,0.624266962,0,0.762628203,0.687180362,0.687180362,0,0.624266962,1,1,1
2487,11,88,33,80,75,0,9521.081,80,6096.007,MORE,5668,3288,8956,7,2,-5,-0.46870423,5,-0.698430296,0.933394096,0.952723978,155,80,75,1,-0.099725137,0,-0.195083426,1.746664593,4.477658252,4.477658252,-0.195083426,0,1,1,1
2488,11,89,48,110,128,1,5705.359,80,2354.408,MORE,750,2778,3528,2,2,18,1.687335229,18,1.571468165,0.933394096,0.032375386,238,110,128,0,1.555712144,1.170500555,1.872800887,-0.713426383,0.635619863,0.635619863,1.872800887,1.170500555,1,0,1
2489,11,90,9,59,50,0,3063.55,40,1709.659,MORE,-564,1558,994,4,1,-9,-0.843667615,9,0,-0.535553989,-0.604826484,109,59,50,1,-1.017196402,-0.819350388,-1.170500555,0.270610007,-0.390902798,0.390902798,-1.170500555,-0.819350388,0,1,0
2490,11,91,44,110,119,1,2528.952,0,1852.366,MORE,-950,2310,1360,3,1,9,0.843667615,9,0,-2.004502074,-0.733771023,229,110,119,0,1.376206896,1.170500555,1.521650721,-0.221408188,-0.692453594,0.692453594,1.521650721,1.170500555,0,1,0
2491,11,92,2,52,50,1,4839.29,70,1823.604,MORE,984,1720,2704,5,2,-2,-0.187481692,2,-1.222253018,0.566157074,-0.17651965,102,52,50,1,-1.156811594,-1.092467184,-1.170500555,0.762628203,0.818425268,0.818425268,-1.170500555,-1.092467184,1,1,1
2492,11,93,8,58,50,0,3404.93,80,2023.691,MORE,406,2148,2554,5,2,-8,-0.749926769,8,-0.174607574,0.933394096,-0.522485946,108,58,50,1,-1.037141429,-0.858367073,-1.170500555,0.762628203,0.366880293,0.366880293,-1.170500555,-0.858367073,1,1,1
2493,11,94,44,119,110,0,4739.408,60,1927.706,MORE,236,2314,2550,6,2,-9,-0.843667615,9,0,0.198920053,-0.200611095,229,119,110,1,1.376206896,1.521650721,1.170500555,1.254646398,0.234072947,0.234072947,1.170500555,1.521650721,1,1,1
2494,11,95,34,74,80,1,4685.584,70,2096.584,MORE,2312,1134,3446,3,2,6,0.562445076,6,-0.523822722,0.566157074,-0.213593394,154,74,80,0,-0.119670165,-0.234100111,0,-0.221408188,1.855885004,1.855885004,0,-0.234100111,1,1,1
2495,11,96,24,86,80,0,3521.992,100,1646.685,MORE,846,1586,2432,5,2,-6,-0.562445076,6,-0.523822722,1.667868138,-0.4942507,166,86,80,1,0.119670165,0.234100111,0,0.762628203,0.710616952,0.710616952,0,0.234100111,1,1,1
2496,11,97,39,66,80,0,5351.809,20,3141.714,MORE,-3314,5234,1920,5,1,14,1.312371845,14,0.87303787,-1.270028032,-0.052900544,146,66,80,0,-0.279230385,-0.546233592,0,0.762628203,-2.539256919,2.539256919,0,-0.546233592,0,1,0
2497,11,98,9,50,59,1,4520.589,0,1418.413,MORE,-552,2532,1980,6,1,9,0.843667615,9,0,-2.004502074,-0.253390034,109,50,59,0,-1.017196402,-1.170500555,-0.819350388,1.254646398,-0.381528162,0.381528162,-0.819350388,-1.170500555,0,1,0
2498,11,99,57,94,110,1,3687.303,30,1587.581,MORE,-160,1534,1374,3,2,16,1.499853537,16,1.222253018,-0.90279101,-0.454377841,204,94,110,0,0.877581209,0.546233592,1.170500555,-0.221408188,-0.075290047,0.075290047,1.170500555,0.546233592,0,1,0
2499,11,100,60,110,87,0,7342.482,20,3543.084,MORE,570,2900,3470,4,1,-23,-2.15603946,23,2.444506035,-1.270028032,0.427247929,197,110,87,1,0.737966017,1.170500555,0.273116796,0.270610007,0.49500032,0.49500032,0.273116796,1.170500555,0,1,1
2500,11,101,33,75,80,1,4831.263,80,5305.735,MORE,2054,1602,3656,5,2,5,0.46870423,5,-0.698430296,0.933394096,-0.178455755,155,75,80,0,-0.099725137,-0.195083426,0,0.762628203,1.654330326,1.654330326,0,-0.195083426,1,1,1
2501,11,102,15,50,45,1,11852.555,0,4447.569,MORE,-2438,6508,4070,5,1,-5,-0.46870423,5,-0.698430296,-2.004502074,1.515073335,95,50,45,1,-1.296426786,-1.170500555,-1.36558398,0.762628203,-1.854908479,1.854908479,-1.36558398,-1.170500555,0,1,0
2502,11,103,59,89,110,1,14659.758,60,2919.795,MORE,-190,4500,4310,6,2,21,1.968557767,21,2.095290887,0.198920053,2.192168084,199,89,110,0,0.777856072,0.351150166,1.170500555,1.254646398,-0.098726637,0.098726637,1.170500555,0.351150166,0,1,0
2503,11,104,29,80,94,1,3897.805,70,922.024,MORE,548,1328,1876,3,2,14,1.312371845,14,0.87303787,0.566157074,-0.403604955,174,80,94,0,0.279230385,0,0.546233592,-0.221408188,0.477813487,0.477813487,0.546233592,0,1,1,1
2504,11,105,55,110,98,1,3527.564,70,1732.616,MORE,198,1400,1598,3,1,-12,-1.124890153,12,0.523822722,0.566157074,-0.492906739,208,110,98,1,0.957361319,1.170500555,0.702300333,-0.221408188,0.204386599,0.204386599,0.702300333,1.170500555,1,0,1
2505,11,106,29,94,80,0,2773.033,60,2700.617,MORE,-1230,1818,588,2,1,-14,-1.312371845,14,0.87303787,0.198920053,-0.674898913,174,94,80,1,0.279230385,0.546233592,0,-0.713426383,-0.911195105,0.911195105,0,0.546233592,0,0,0
2506,11,107,57,110,94,0,2300.7,60,1453.689,MORE,-840,1402,562,2,1,-16,-1.499853537,16,1.222253018,0.198920053,-0.788825193,204,110,94,1,0.877581209,1.170500555,0.546233592,-0.713426383,-0.60651943,0.60651943,0.546233592,1.170500555,0,0,0
2507,11,108,39,80,66,0,14388.758,60,2616.549,MORE,566,3860,4426,5,2,-14,-1.312371845,14,0.87303787,0.198920053,2.126803136,146,80,66,1,-0.279230385,0,-0.546233592,0.762628203,0.491875441,0.491875441,-0.546233592,0,0,1,1
2508,11,109,4,50,54,1,2212.062,40,3403.055,MORE,46,752,798,1,1,4,0.374963384,4,-0.87303787,-0.535553989,-0.810204596,104,50,54,0,-1.116921539,-1.170500555,-1.014433814,-1.205444578,0.085641207,0.085641207,-1.014433814,-1.170500555,0,0,0
2509,11,110,55,98,110,1,2736.71,60,1357.4,MORE,164,1132,1296,3,2,12,1.124890153,12,0.523822722,0.198920053,-0.683659987,208,98,110,0,0.957361319,0.702300333,1.170500555,-0.221408188,0.17782513,0.17782513,1.170500555,0.702300333,1,0,1
2510,11,111,2,50,52,1,23605.39,70,1476.935,MORE,-572,5726,5154,7,2,2,0.187481692,2,-1.222253018,0.566157074,4.349846189,102,50,52,0,-1.156811594,-1.170500555,-1.092467184,1.746664593,-0.397152555,0.397152555,-1.092467184,-1.170500555,1,1,0
2511,11,112,59,110,89,0,2208.33,80,2372.64,MORE,212,1580,1792,2,2,-21,-1.968557767,21,2.095290887,0.933394096,-0.811104751,199,110,89,1,0.777856072,1.170500555,0.351150166,-0.713426383,0.215323674,0.215323674,0.351150166,1.170500555,1,0,1
2512,11,113,60,87,110,1,3031.786,100,1961.076,MORE,1498,1010,2508,2,2,23,2.15603946,23,2.444506035,1.667868138,-0.612487931,197,87,110,0,0.737966017,0.273116796,1.170500555,-0.713426383,1.219972184,1.219972184,1.170500555,0.273116796,1,0,1
2513,11,114,52,110,105,0,2181.58,70,1996.841,MORE,-310,1362,1052,2,2,-5,-0.46870423,5,-0.698430296,0.566157074,-0.817556826,215,110,105,1,1.096976512,1.170500555,0.975417129,-0.713426383,-0.192472999,0.192472999,0.975417129,1.170500555,1,0,0
2514,11,115,30,80,96,1,2422.26,70,3498.944,MORE,1682,900,2582,1,2,16,1.499853537,16,1.222253018,0.566157074,-0.759505034,176,80,96,0,0.31912044,0,0.624266962,-1.205444578,1.363716605,1.363716605,0.624266962,0,1,0,1
2515,11,116,24,80,86,0,5657.024,70,1515.515,MORE,8,1878,1886,5,2,6,0.562445076,6,-0.523822722,0.566157074,0.020717029,166,80,86,0,0.119670165,0,0.234100111,0.762628203,0.05595486,0.05595486,0.234100111,0,1,1,0
2516,11,117,5,50,55,1,1928.941,30,4522.567,MORE,958,1010,1968,1,2,5,0.46870423,5,-0.698430296,-0.90279101,-0.878493118,105,50,55,0,-1.096976512,-1.170500555,-0.975417129,-1.205444578,0.798113556,0.798113556,-0.975417129,-1.170500555,0,0,1
2517,11,118,34,80,74,1,5892.906,60,3627.184,MORE,1562,1538,3100,4,2,-6,-0.562445076,6,-0.523822722,0.198920053,0.077611548,154,80,74,1,-0.119670165,0,-0.234100111,0.270610007,1.269970243,1.269970243,-0.234100111,0,0,1,1
2518,11,119,15,45,50,1,3976.784,20,7303.232,MORE,580,1330,1910,4,2,5,0.46870423,5,-0.698430296,-1.270028032,-0.384555294,95,45,50,0,-1.296426786,-1.36558398,-1.170500555,0.270610007,0.502812517,0.502812517,-1.170500555,-1.36558398,0,1,1
2519,11,120,37,69,80,1,2766.983,10,773.707,MORE,40,1304,1344,3,1,11,1.031149307,11,0.349215148,-1.637265053,-0.676358168,149,69,80,0,-0.219395302,-0.429183537,0,-0.221408188,0.080953889,0.080953889,0,-0.429183537,0,0,0
2520,11,121,48,128,110,1,2687.762,40,2912.947,LESS,892,1054,1946,3,2,-18,-1.687335229,18,1.571468165,-0.535553989,-0.695466199,238,128,110,0,1.555712144,1.872800887,1.170500555,-0.221408188,0.746553057,0.746553057,1.170500555,1.872800887,0,1,1
2521,11,122,8,50,58,0,2689.618,70,2372.179,LESS,-1448,1908,460,2,1,8,0.749926769,8,-0.174607574,0.566157074,-0.695018534,108,50,58,1,-1.037141429,-1.170500555,-0.858367073,-0.713426383,-1.081500995,1.081500995,-0.858367073,-1.170500555,1,0,0
2522,11,123,4,54,50,0,1769.454,60,2274.196,LESS,-930,1422,492,2,1,-4,-0.374963384,4,-0.87303787,0.198920053,-0.916961233,104,54,50,0,-1.116921539,-1.014433814,-1.170500555,-0.713426383,-0.676829201,0.676829201,-1.170500555,-1.014433814,1,0,0
2523,11,124,37,80,69,0,4536.286,30,1549.974,LESS,-1852,2514,662,1,1,-11,-1.031149307,11,0.349215148,-0.90279101,-0.249603932,149,80,69,0,-0.219395302,0,-0.429183537,-1.205444578,-1.397113746,1.397113746,-0.429183537,0,0,0,0
2524,11,125,52,105,110,1,2743.343,80,1846.331,LESS,1756,1066,2822,3,2,5,0.46870423,5,-0.698430296,0.933394096,-0.682060114,215,105,110,1,1.096976512,0.975417129,1.170500555,-0.221408188,1.421526861,1.421526861,1.170500555,0.975417129,1,1,1
2525,11,126,5,55,50,1,2843.907,60,8105.418,LESS,1546,1064,2610,3,2,-5,-0.46870423,5,-0.698430296,0.198920053,-0.657804171,105,55,50,0,-1.096976512,-0.975417129,-1.170500555,-0.221408188,1.257470728,1.257470728,-1.170500555,-0.975417129,0,1,1
2526,11,127,30,96,80,1,7210.607,70,4481.54,LESS,1912,1328,3240,1,2,-16,-1.499853537,16,1.222253018,0.566157074,0.395439802,176,96,80,0,0.31912044,0.624266962,0,-1.205444578,1.543397132,1.543397132,0,0.624266962,1,0,1
2527,11,128,33,80,75,1,8377.961,70,1609.999,LESS,2056,2460,4516,8,2,-5,-0.46870423,5,-0.698430296,0.566157074,0.677004499,155,80,75,0,-0.099725137,0,-0.195083426,2.238682788,1.655892766,1.655892766,-0.195083426,0,1,1,1
2528,11,129,48,110,128,0,3886.863,80,1355.537,LESS,-224,1734,1510,2,2,18,1.687335229,18,1.571468165,0.933394096,-0.406244155,238,110,128,1,1.555712144,1.170500555,1.872800887,-0.713426383,-0.125288106,0.125288106,1.872800887,1.170500555,1,0,1
2529,11,130,9,59,50,0,1763.849,20,1423.853,LESS,-1340,1766,426,2,1,-9,-0.843667615,9,0,-1.270028032,-0.918313154,109,59,50,0,-1.017196402,-0.819350388,-1.170500555,-0.713426383,-0.99712927,0.99712927,-1.170500555,-0.819350388,0,0,0
2530,11,131,44,110,119,1,7303.895,20,1511.428,LESS,54,3196,3250,6,1,9,0.843667615,9,0,-1.270028032,0.41794078,229,110,119,1,1.376206896,1.170500555,1.521650721,1.254646398,0.091890965,0.091890965,1.521650721,1.170500555,0,1,1
2531,11,132,2,52,50,1,3534.082,80,1310.214,LESS,924,1512,2436,5,2,-2,-0.187481692,2,-1.222253018,0.933394096,-0.491334604,102,52,50,0,-1.156811594,-1.092467184,-1.170500555,0.762628203,0.771552087,0.771552087,-1.170500555,-1.092467184,1,1,1
2532,11,133,8,58,50,1,2148.839,60,1794.216,LESS,314,896,1210,3,2,-8,-0.749926769,8,-0.174607574,0.198920053,-0.825453925,108,58,50,0,-1.037141429,-0.858367073,-1.170500555,-0.221408188,0.295008082,0.295008082,-1.170500555,-0.858367073,0,1,1
2533,11,134,44,119,110,1,2791.337,80,887.542,LESS,436,1152,1588,3,2,-9,-0.843667615,9,0,0.933394096,-0.670484006,229,119,110,0,1.376206896,1.521650721,1.170500555,-0.221408188,0.390316883,0.390316883,1.170500555,1.521650721,1,0,1
2534,11,135,34,74,80,0,2028.795,10,3734.974,LESS,-270,1448,1178,2,2,6,0.562445076,6,-0.523822722,-1.637265053,-0.854408426,154,74,80,1,-0.119670165,-0.234100111,0,-0.713426383,-0.161224212,0.161224212,0,-0.234100111,0,0,0
2535,11,136,24,86,80,1,3088.72,50,3057.891,LESS,-198,1056,858,2,2,-6,-0.562445076,6,-0.523822722,-0.168316968,-0.598755503,166,86,80,0,0.119670165,0.234100111,0,-0.713426383,-0.104976395,0.104976395,0,0.234100111,0,0,1
2536,11,137,39,66,80,0,4853.714,70,2899.621,LESS,-1014,2250,1236,2,1,14,1.312371845,14,0.87303787,0.566157074,-0.173040595,146,66,80,1,-0.279230385,-0.546233592,0,-0.713426383,-0.742451654,0.742451654,0,-0.546233592,1,0,0
2537,11,138,9,50,59,0,1864.535,80,1176.165,LESS,-2,1162,1160,2,2,9,0.843667615,9,0,0.933394096,-0.894027785,109,50,59,1,-1.017196402,-1.170500555,-0.819350388,-0.713426383,0.048142663,0.048142663,-0.819350388,-1.170500555,1,0,1
2538,11,139,57,94,110,0,2078.99,80,1271.222,LESS,-222,1104,882,1,2,16,1.499853537,16,1.222253018,0.933394096,-0.842301439,204,94,110,1,0.877581209,0.546233592,1.170500555,-1.205444578,-0.123725667,0.123725667,1.170500555,0.546233592,1,0,1
2539,11,140,60,110,87,1,7112.402,80,1676.642,LESS,1320,1046,2366,2,2,-23,-2.15603946,23,2.444506035,0.933394096,0.371752847,197,110,87,0,0.737966017,1.170500555,0.273116796,-0.713426383,1.080915081,1.080915081,0.273116796,1.170500555,1,0,1
2540,11,141,33,75,80,0,5146.265,90,1833.452,LESS,-634,2544,1910,4,2,5,0.46870423,5,-0.698430296,1.300631117,-0.102477566,155,75,80,1,-0.099725137,-0.195083426,0,0.270610007,-0.445588175,0.445588175,0,-0.195083426,1,1,0
2541,11,142,15,50,45,1,3957.137,80,4310.071,LESS,1466,964,2430,3,2,-5,-0.46870423,5,-0.698430296,0.933394096,-0.389294132,95,50,45,0,-1.296426786,-1.170500555,-1.36558398,-0.221408188,1.194973154,1.194973154,-1.36558398,-1.170500555,1,0,1
2542,11,143,59,89,110,0,5605.633,70,2224.17,LESS,-404,1740,1336,0,2,21,1.968557767,21,2.095290887,0.566157074,0.008321568,199,89,110,1,0.777856072,0.351150166,1.170500555,-1.697462773,-0.265907649,0.265907649,1.170500555,0.351150166,1,0,0
2543,11,144,29,80,94,0,3858.917,30,412.202,LESS,-1668,2592,924,3,1,14,1.312371845,14,0.87303787,-0.90279101,-0.412984704,174,80,94,1,0.279230385,0,0.546233592,-0.221408188,-1.253369325,1.253369325,0.546233592,0,0,0,0
2544,11,145,55,110,98,1,3866.477,60,1081.685,LESS,-88,950,862,2,1,-12,-1.124890153,12,0.523822722,0.198920053,-0.411161239,208,110,98,0,0.957361319,1.170500555,0.702300333,-0.713426383,-0.01904223,0.01904223,0.702300333,1.170500555,1,0,1
2545,11,146,29,94,80,0,10090.541,60,1806.394,LESS,-1734,2900,1166,1,2,-14,-1.312371845,14,0.87303787,0.198920053,1.0900772,174,94,80,0,0.279230385,0.546233592,0,-1.205444578,-1.304929824,1.304929824,0,0.546233592,1,0,0
2546,11,147,57,110,94,1,4324.304,80,1189.803,LESS,920,1340,2260,3,2,-16,-1.499853537,16,1.222253018,0.933394096,-0.300733793,204,110,94,0,0.877581209,1.170500555,0.546233592,-0.221408188,0.768427208,0.768427208,0.546233592,1.170500555,1,0,1
2547,11,148,39,80,66,1,21413.362,70,1050.09,LESS,586,3012,3598,5,2,-14,-1.312371845,14,0.87303787,0.566157074,3.821131077,146,80,66,0,-0.279230385,0,-0.546233592,0.762628203,0.507499835,0.507499835,-0.546233592,0,1,1,1
2548,11,149,4,50,54,0,6232.021,70,2038.435,LESS,-1244,2428,1184,2,2,4,0.374963384,4,-0.87303787,0.566157074,0.15940577,104,50,54,1,-1.116921539,-1.170500555,-1.014433814,-0.713426383,-0.922132181,0.922132181,-1.014433814,-1.170500555,1,0,0
2549,11,150,55,98,110,0,1966.864,30,1258.792,LESS,-320,890,570,2,1,12,1.124890153,12,0.523822722,-0.90279101,-0.869346125,208,98,110,1,0.957361319,0.702300333,1.170500555,-0.713426383,-0.200285196,0.200285196,1.170500555,0.702300333,0,0,0
2550,11,151,2,50,52,0,2071.327,70,2607.444,LESS,214,1060,1274,2,2,2,0.187481692,2,-1.222253018,0.566157074,-0.844149747,102,50,52,1,-1.156811594,-1.170500555,-1.092467184,-0.713426383,0.216886114,0.216886114,-1.092467184,-1.170500555,1,0,1
2551,11,152,59,110,89,1,2515.235,40,2634.793,LESS,1242,44,1286,1,2,-21,-1.968557767,21,2.095290887,-0.535553989,-0.737079551,199,110,89,0,0.777856072,1.170500555,0.351150166,-1.205444578,1.019979946,1.019979946,0.351150166,1.170500555,0,0,1
2552,11,153,60,87,110,0,7100.414,70,911.177,LESS,364,1880,2244,1,2,23,2.15603946,23,2.444506035,0.566157074,0.368861353,197,87,110,1,0.737966017,0.273116796,1.170500555,-1.205444578,0.334069066,0.334069066,1.170500555,0.273116796,1,0,1
2553,11,154,52,110,105,0,2024.837,80,1196.509,LESS,-648,1258,610,2,2,-5,-0.46870423,5,-0.698430296,0.933394096,-0.855363092,215,110,105,0,1.096976512,1.170500555,0.975417129,-0.713426383,-0.456525251,0.456525251,0.975417129,1.170500555,1,0,0
2554,11,155,30,80,96,0,13906.224,30,1290.264,LESS,-378,2552,2174,2,1,16,1.499853537,16,1.222253018,-0.90279101,2.010416385,176,80,96,1,0.31912044,0,0.624266962,-0.713426383,-0.245595937,0.245595937,0.624266962,0,0,0,0
2555,11,156,24,80,86,1,3782.858,60,1339.641,LESS,-576,1430,854,2,2,6,0.562445076,6,-0.523822722,0.198920053,-0.431330064,166,80,86,1,0.119670165,0,0.234100111,-0.713426383,-0.400277434,0.400277434,0.234100111,0,0,0,0
2556,11,157,5,50,55,0,2844.036,100,2484.58,LESS,-246,1526,1280,2,2,5,0.46870423,5,-0.698430296,1.667868138,-0.657773056,105,50,55,1,-1.096976512,-1.170500555,-0.975417129,-0.713426383,-0.142474939,0.142474939,-0.975417129,-1.170500555,1,0,0
2557,11,158,34,80,74,0,3896.436,20,1828.174,LESS,-1152,1810,658,0,1,-6,-0.562445076,6,-0.523822722,-1.270028032,-0.403935156,154,80,74,0,-0.119670165,0,-0.234100111,-1.697462773,-0.85025997,0.85025997,-0.234100111,0,0,0,0
2558,11,159,15,45,50,0,9063.275,70,2463.632,LESS,-102,3510,3408,7,2,5,0.46870423,5,-0.698430296,0.566157074,0.842301597,95,45,50,1,-1.296426786,-1.36558398,-1.170500555,1.746664593,-0.029979305,0.029979305,-1.170500555,-1.36558398,1,1,1
2559,11,160,37,69,80,0,9224.087,0,3967.197,LESS,-3130,5432,2302,6,1,11,1.031149307,11,0.349215148,-2.004502074,0.881089302,149,69,80,1,-0.219395302,-0.429183537,0,1.254646398,-2.395512498,2.395512498,0,-0.429183537,0,1,0
2560,11,161,3,50,53,1,2360.284,90,1356.282,MORE,1152,820,1972,3,2,3,0.281222538,3,-1.047645444,1.300631117,-0.774453588,103,50,53,0,-1.136866566,-1.170500555,-1.053450499,-0.221408188,0.949670174,0.949670174,-1.053450499,-1.170500555,1,0,1
2561,11,162,20,50,40,1,5328.319,20,1494.77,MORE,504,1412,1916,5,2,-10,-0.937408461,10,0.174607574,-1.270028032,-0.058566311,90,50,40,1,-1.396151924,-1.170500555,-1.560667406,0.762628203,0.443439821,0.443439821,-1.560667406,-1.170500555,0,1,1
2562,11,163,25,80,88,1,2798.265,80,2119.569,MORE,416,1188,1604,3,2,8,0.749926769,8,-0.174607574,0.933394096,-0.668812979,168,80,88,0,0.15956022,0,0.312133481,-0.221408188,0.374692489,0.374692489,0.312133481,0,1,1,1
2563,11,164,42,115,110,0,16547.093,60,1189.565,MORE,-1596,4642,3046,10,1,-5,-0.46870423,5,-0.698430296,0.198920053,2.647391527,225,115,110,1,1.296426786,1.36558398,1.170500555,3.222719178,-1.197121508,1.197121508,1.170500555,1.36558398,0,1,0
2564,11,165,53,103,110,0,3215.762,50,1853.989,MORE,-580,1352,772,2,1,7,0.656185922,7,-0.349215148,-0.168316968,-0.568113091,213,103,110,0,1.057086457,0.897383758,1.170500555,-0.713426383,-0.403402313,0.403402313,1.170500555,0.897383758,0,0,0
2565,11,166,26,90,80,0,4805.152,70,954.333,MORE,-1194,2216,1022,3,1,-10,-0.937408461,10,0.174607574,0.566157074,-0.184753704,170,90,80,1,0.199450275,0.390166852,0,-0.221408188,-0.883071196,0.883071196,0,0.390166852,1,1,0
2566,11,167,35,80,72,1,3876.601,80,920.129,MORE,282,1616,1898,5,2,-8,-0.749926769,8,-0.174607574,0.933394096,-0.40871934,152,80,72,1,-0.15956022,0,-0.312133481,0.762628203,0.270009052,0.270009052,-0.312133481,0,1,1,1
2567,11,168,28,93,80,1,3662.945,40,470.249,MORE,766,890,1656,2,2,-13,-1.218630999,13,0.698430296,-0.535553989,-0.460252968,173,93,80,1,0.259285357,0.507216907,0,-0.713426383,0.648119378,0.648119378,0,0.507216907,0,0,1
2568,11,169,26,80,90,1,7214.56,60,3785.701,MORE,1440,1336,2776,2,2,10,0.937408461,10,0.174607574,0.198920053,0.396393261,170,80,90,0,0.199450275,0,0.390166852,-0.713426383,1.174661442,1.174661442,0.390166852,0,0,0,1
2569,11,170,25,88,80,0,2799.691,100,2210.324,MORE,-56,1766,1710,2,2,-8,-0.749926769,8,-0.174607574,1.667868138,-0.668469029,168,88,80,1,0.15956022,0.312133481,0,-0.713426383,0.0059568,0.0059568,0,0.312133481,1,0,0
2570,11,171,36,80,70,0,3203.563,60,944.314,MORE,-764,1246,482,2,1,-10,-0.937408461,10,0.174607574,0.198920053,-0.571055479,150,80,70,1,-0.199450275,0,-0.390166852,-0.713426383,-0.547146734,0.547146734,-0.390166852,0,0,0,0
2571,11,172,28,80,93,1,2004.114,80,850.049,MORE,508,662,1170,3,2,13,1.218630999,13,0.698430296,0.933394096,-0.86036146,173,80,93,0,0.259285357,0,0.507216907,-0.221408188,0.4465647,0.4465647,0.507216907,0,1,1,1
2572,11,173,21,82,80,0,6071.469,30,1967.618,MORE,-2034,3702,1668,3,1,-2,-0.187481692,2,-1.222253018,-0.90279101,0.120680777,162,82,80,1,0.039890055,0.07803337,0,-0.221408188,-1.539295728,1.539295728,0,0.07803337,0,1,0
2573,11,174,19,50,41,1,1447.59,70,3648.81,MORE,-406,1110,704,1,2,-9,-0.843667615,9,0,0.566157074,-0.99459453,91,50,41,1,-1.376206896,-1.170500555,-1.521650721,-1.205444578,-0.267470088,0.267470088,-1.521650721,-1.170500555,1,0,0
2574,11,175,56,96,110,1,2234.921,60,1301.798,MORE,98,796,894,3,2,14,1.312371845,14,0.87303787,0.198920053,-0.804691027,206,96,110,0,0.917471264,0.624266962,1.170500555,-0.221408188,0.126264631,0.126264631,1.170500555,0.624266962,0,0,1
2575,11,176,23,80,85,1,3708.76,80,9590.479,MORE,496,980,1476,0,2,5,0.46870423,5,-0.698430296,0.933394096,-0.449202433,165,80,85,0,0.099725137,0,0.195083426,-1.697462773,0.437190064,0.437190064,0.195083426,0,1,0,1
2576,11,177,10,60,50,0,3523.153,80,842.342,MORE,-316,1584,1268,4,2,-10,-0.937408461,10,0.174607574,0.933394096,-0.493970668,110,60,50,1,-0.997251374,-0.780333703,-1.170500555,0.270610007,-0.197160317,0.197160317,-1.170500555,-0.780333703,1,1,0
2577,11,178,19,41,50,0,7845.473,50,1328.931,MORE,654,1720,2374,5,2,9,0.843667615,9,0,-0.168316968,0.548568889,91,41,50,0,-1.376206896,-1.521650721,-1.170500555,0.762628203,0.560622773,0.560622773,-1.170500555,-1.521650721,0,1,1
2578,11,179,56,110,96,0,5287.708,100,2112.642,MORE,-730,2440,1710,2,2,-14,-1.312371845,14,0.87303787,1.667868138,-0.068361646,206,110,96,1,0.917471264,1.170500555,0.624266962,-0.713426383,-0.520585265,0.520585265,0.624266962,1.170500555,1,0,0
2579,11,180,35,72,80,1,1772.283,70,1153.106,MORE,304,600,904,3,2,8,0.749926769,8,-0.174607574,0.566157074,-0.916278881,152,72,80,0,-0.15956022,-0.312133481,0,-0.221408188,0.287195885,0.287195885,0,-0.312133481,1,0,1
2580,11,181,11,49,50,0,2435.127,40,10552.329,MORE,-530,1262,732,1,1,1,0.093740846,1,-1.396860592,-0.535553989,-0.756401526,99,49,50,0,-1.216646676,-1.20951724,-1.170500555,-1.205444578,-0.364341329,0.364341329,-1.170500555,-1.20951724,0,0,0
2581,11,182,17,43,50,1,1368.463,20,471.462,MORE,338,468,806,1,2,7,0.656185922,7,-0.349215148,-1.270028032,-1.013679889,93,43,50,0,-1.336316841,-1.443617351,-1.170500555,-1.205444578,0.313757354,0.313757354,-1.170500555,-1.443617351,0,0,1
2582,11,183,1,51,50,0,2530.144,80,7106.213,MORE,-1602,3048,1446,1,2,-1,-0.093740846,1,-1.396860592,0.933394096,-0.733483514,101,51,50,1,-1.176756621,-1.131483869,-1.170500555,-1.205444578,-1.201808826,1.201808826,-1.170500555,-1.131483869,1,0,0
2583,11,184,41,112,110,0,5170.237,80,695.328,MORE,-552,2368,1816,3,2,-2,-0.187481692,2,-1.222253018,0.933394096,-0.096695542,222,112,110,1,1.236591704,1.248533925,1.170500555,-0.221408188,-0.381528162,0.381528162,1.170500555,1.248533925,1,1,0
2584,11,185,20,40,50,0,14426.898,10,3623.897,MORE,-532,2756,2224,5,1,10,0.937408461,10,0.174607574,-1.637265053,2.136002469,90,40,50,0,-1.396151924,-1.560667406,-1.170500555,0.762628203,-0.365903768,0.365903768,-1.170500555,-1.560667406,0,1,0
2585,11,186,1,50,51,1,10303.299,60,2725.503,MORE,222,1904,2126,6,2,1,0.093740846,1,-1.396860592,0.198920053,1.141394231,101,50,51,0,-1.176756621,-1.170500555,-1.131483869,1.254646398,0.223135871,0.223135871,-1.131483869,-1.170500555,0,1,1
2586,11,187,23,85,80,1,5913.5,70,7392.936,MORE,1260,1376,2636,1,2,-5,-0.46870423,5,-0.698430296,0.566157074,0.082578801,165,85,80,1,0.099725137,0.195083426,0,-1.205444578,1.0340419,1.0340419,0,0.195083426,1,0,1
2587,11,188,11,50,49,0,8980.201,0,2617.276,MORE,-530,1774,1244,2,1,-1,-0.093740846,1,-1.396860592,-2.004502074,0.822264226,99,50,49,1,-1.216646676,-1.170500555,-1.20951724,-0.713426383,-0.364341329,0.364341329,-1.20951724,-1.170500555,0,0,0
2588,11,189,17,50,43,1,2652.93,80,2817.775,MORE,254,896,1150,1,2,-7,-0.656185922,7,-0.349215148,0.933394096,-0.703867645,93,50,43,1,-1.336316841,-1.170500555,-1.443617351,-1.205444578,0.248134901,0.248134901,-1.443617351,-1.170500555,1,0,1
2589,11,190,21,80,82,1,3262.577,20,1843.789,MORE,-1484,2482,998,2,1,2,0.187481692,2,-1.222253018,-1.270028032,-0.556821357,162,80,82,0,0.039890055,0,0.07803337,-0.713426383,-1.109624904,1.109624904,0.07803337,0,0,0,0
2590,11,191,10,50,60,1,9705.507,60,1521.534,MORE,-396,1874,1478,4,2,10,0.937408461,10,0.174607574,0.198920053,0.997207357,110,50,60,0,-0.997251374,-1.170500555,-0.780333703,0.270610007,-0.259657891,0.259657891,-0.780333703,-1.170500555,0,1,0
2591,11,192,3,53,50,1,4653.63,80,984.214,MORE,1584,486,2070,0,2,-3,-0.281222538,3,-1.047645444,0.933394096,-0.221300669,103,53,50,1,-1.136866566,-1.053450499,-1.170500555,-1.697462773,1.287157076,1.287157076,-1.170500555,-1.053450499,1,0,1
2592,11,193,45,122,110,0,2075.242,80,1271.917,MORE,-74,898,824,1,2,-12,-1.124890153,12,0.523822722,0.933394096,-0.843205453,232,122,110,1,1.436041979,1.638700776,1.170500555,-1.205444578,-0.008105154,0.008105154,1.170500555,1.638700776,1,0,0
2593,11,194,38,67,80,1,1184.873,90,1091.627,MORE,-110,568,458,1,2,13,1.218630999,13,0.698430296,1.300631117,-1.057961626,147,67,80,0,-0.259285357,-0.507216907,0,-1.205444578,-0.036229063,0.036229063,0,-0.507216907,1,0,0
2594,11,195,38,80,67,1,10564.16,80,1133.308,MORE,406,1760,2166,2,2,-13,-1.218630999,13,0.698430296,0.933394096,1.204313661,147,80,67,1,-0.259285357,0,-0.507216907,-0.713426383,0.366880293,0.366880293,-0.507216907,0,1,0,1
2595,11,196,36,70,80,1,1824.847,70,1155.896,MORE,718,336,1054,0,2,10,0.937408461,10,0.174607574,0.566157074,-0.903600493,150,70,80,0,-0.199450275,-0.390166852,0,-1.697462773,0.610620833,0.610620833,0,-0.390166852,1,0,1
2596,11,197,45,110,122,0,2398.761,80,4046.389,MORE,-832,1440,608,2,2,12,1.124890153,12,0.523822722,0.933394096,-0.765172971,232,110,122,0,1.436041979,1.170500555,1.638700776,-0.713426383,-0.600269672,0.600269672,1.638700776,1.170500555,1,0,0
2597,11,198,42,110,115,0,4017.863,80,1689.959,MORE,-520,1202,682,2,2,5,0.46870423,5,-0.698430296,0.933394096,-0.374647077,225,110,115,0,1.296426786,1.170500555,1.36558398,-0.713426383,-0.356529132,0.356529132,1.36558398,1.170500555,1,0,0
2598,11,199,41,110,112,0,2069.535,40,475.299,MORE,-532,1104,572,2,1,2,0.187481692,2,-1.222253018,-0.535553989,-0.844581976,222,110,112,0,1.236591704,1.170500555,1.248533925,-0.713426383,-0.365903768,0.365903768,1.248533925,1.170500555,0,0,0
2599,11,200,53,110,103,1,6801.251,90,2074.711,MORE,1598,1266,2864,2,2,-7,-0.656185922,7,-0.349215148,1.300631117,0.296703516,213,110,103,1,1.057086457,1.170500555,0.897383758,-0.713426383,1.298094152,1.298094152,0.897383758,1.170500555,1,0,1
2600,11,201,3,50,53,0,5934.043,30,2755.857,LESS,-2096,4032,1936,4,1,3,0.281222538,3,-1.047645444,-0.90279101,0.087533754,103,50,53,1,-1.136866566,-1.170500555,-1.053450499,0.270610007,-1.587731348,1.587731348,-1.053450499,-1.170500555,0,1,0
2601,11,202,20,50,40,1,5620.092,70,1593.672,LESS,2756,1204,3960,2,2,-10,-0.937408461,10,0.174607574,0.566157074,0.011809065,90,50,40,0,-1.396151924,-1.170500555,-1.560667406,-0.713426383,2.202746542,2.202746542,-1.560667406,-1.170500555,1,0,1
2602,11,203,25,80,88,0,4725.86,70,1548.096,LESS,-312,2578,2266,6,2,8,0.749926769,8,-0.174607574,0.566157074,-0.20387886,168,80,88,1,0.15956022,0,0.312133481,1.254646398,-0.194035438,0.194035438,0.312133481,0,1,1,0
2603,11,204,42,115,110,0,2458.088,40,704.772,LESS,-1098,1734,636,2,1,-5,-0.46870423,5,-0.698430296,-0.535553989,-0.750863354,225,115,110,0,1.296426786,1.36558398,1.170500555,-0.713426383,-0.808074107,0.808074107,1.170500555,1.36558398,0,0,0
2604,11,205,53,103,110,0,4713.656,70,1135.416,LESS,838,1614,2452,4,2,7,0.656185922,7,-0.349215148,0.566157074,-0.206822454,213,103,110,1,1.057086457,0.897383758,1.170500555,0.270610007,0.704367195,0.704367195,1.170500555,0.897383758,1,1,1
2605,11,206,26,90,80,0,5889.694,0,1598.054,LESS,-1612,3748,2136,6,1,-10,-0.937408461,10,0.174607574,-2.004502074,0.076836816,170,90,80,0,0.199450275,0.390166852,0,1.254646398,-1.209621023,1.209621023,0,0.390166852,0,1,0
2606,11,207,35,80,72,1,7370.666,50,1709.969,LESS,152,3094,3246,6,1,-8,-0.749926769,8,-0.174607574,-0.168316968,0.434045883,152,80,72,0,-0.15956022,0,-0.312133481,1.254646398,0.168450494,0.168450494,-0.312133481,0,0,1,1
2607,11,208,28,93,80,1,4335.509,70,1990.538,LESS,-24,1836,1812,5,2,-13,-1.218630999,13,0.698430296,0.566157074,-0.298031158,173,93,80,0,0.259285357,0.507216907,0,0.762628203,0.03095583,0.03095583,0,0.507216907,1,1,1
2608,11,209,26,80,90,0,6086.482,30,1687.52,LESS,-1128,3078,1950,5,1,10,0.937408461,10,0.174607574,-0.90279101,0.124301899,170,80,90,1,0.199450275,0,0.390166852,0.762628203,-0.831510698,0.831510698,0.390166852,0,0,1,0
2609,11,210,25,88,80,1,7796.757,0,3438.723,LESS,-3376,5262,1886,6,1,-8,-0.749926769,8,-0.174607574,-2.004502074,0.536818636,168,88,80,0,0.15956022,0.312133481,0,1.254646398,-2.58769254,2.58769254,0,0.312133481,0,1,0
2610,11,211,36,80,70,1,2339.991,20,1416.294,LESS,-190,1282,1092,2,1,-10,-0.937408461,10,0.174607574,-1.270028032,-0.77934824,150,80,70,0,-0.199450275,0,-0.390166852,-0.713426383,-0.098726637,0.098726637,-0.390166852,0,0,0,1
2611,11,212,28,80,93,1,17110.889,10,3045.182,LESS,-994,4148,3154,7,1,13,1.218630999,13,0.698430296,-1.637265053,2.783378597,173,80,93,1,0.259285357,0,0.507216907,1.746664593,-0.72682726,0.72682726,0.507216907,0,0,1,0
2612,11,213,21,82,80,1,3283.169,20,5562.655,LESS,-588,1560,972,3,1,-2,-0.187481692,2,-1.222253018,-1.270028032,-0.551854585,162,82,80,0,0.039890055,0.07803337,0,-0.221408188,-0.40965207,0.40965207,0,0.07803337,0,0,0
2613,11,214,19,50,41,1,8189.443,80,2272.829,LESS,10,2834,2844,3,2,-9,-0.843667615,9,0,0.933394096,0.631534133,91,50,41,0,-1.376206896,-1.170500555,-1.521650721,-0.221408188,0.057517299,0.057517299,-1.521650721,-1.170500555,1,0,1
2614,11,215,56,96,110,0,9023.685,30,2913.708,LESS,-1670,3794,2124,7,2,14,1.312371845,14,0.87303787,-0.90279101,0.832752526,206,96,110,1,0.917471264,0.624266962,1.170500555,1.746664593,-1.254931764,1.254931764,1.170500555,0.624266962,0,1,0
2615,11,216,23,80,85,0,2890.884,40,359.801,LESS,-1294,1658,364,2,1,5,0.46870423,5,-0.698430296,-0.535553989,-0.646473362,165,80,85,1,0.099725137,0,0.195083426,-0.713426383,-0.961193165,0.961193165,0.195083426,0,0,0,0
2616,11,217,10,60,50,1,2341.412,20,1480.965,LESS,180,1104,1284,3,1,-10,-0.937408461,10,0.174607574,-1.270028032,-0.779005497,110,60,50,0,-0.997251374,-0.780333703,-1.170500555,-0.221408188,0.190324645,0.190324645,-1.170500555,-0.780333703,0,0,1
2617,11,218,19,41,50,0,1701.515,90,2918.758,LESS,1920,850,2770,3,2,9,0.843667615,9,0,1.300631117,-0.933348057,91,41,50,1,-1.376206896,-1.521650721,-1.170500555,-0.221408188,1.549646889,1.549646889,-1.170500555,-1.521650721,1,0,1
2618,11,219,56,110,96,1,5335.534,0,3129.199,LESS,-1868,3648,1780,5,1,-14,-1.312371845,14,0.87303787,-2.004502074,-0.056826059,206,110,96,0,0.917471264,1.170500555,0.624266962,0.762628203,-1.409613261,1.409613261,0.624266962,1.170500555,0,1,0
2619,11,220,35,72,80,1,3426.286,60,2917.255,LESS,1046,1286,2332,4,2,8,0.749926769,8,-0.174607574,0.198920053,-0.517334898,152,72,80,1,-0.15956022,-0.312133481,0,0.270610007,0.866860888,0.866860888,0,-0.312133481,1,1,1
2620,11,221,11,49,50,0,1762.008,30,3551.302,LESS,-458,1500,1042,1,1,1,0.093740846,1,-1.396860592,-0.90279101,-0.918757202,99,49,50,1,-1.216646676,-1.20951724,-1.170500555,-1.205444578,-0.308093512,0.308093512,-1.170500555,-1.20951724,0,0,0
2621,11,222,17,43,50,0,1917.575,70,2679.346,LESS,-944,1506,562,2,1,7,0.656185922,7,-0.349215148,0.566157074,-0.881234586,93,43,50,1,-1.336316841,-1.443617351,-1.170500555,-0.713426383,-0.687766276,0.687766276,-1.170500555,-1.443617351,1,0,0
2622,11,223,1,51,50,0,4289.202,20,540.755,LESS,-1146,2322,1176,3,1,-1,-0.093740846,1,-1.396860592,-1.270028032,-0.309200363,101,51,50,0,-1.176756621,-1.131483869,-1.170500555,-0.221408188,-0.845572652,0.845572652,-1.170500555,-1.131483869,0,0,0
2623,11,224,41,112,110,1,5466.972,0,840.712,LESS,-270,2514,2244,6,1,-2,-0.187481692,2,-1.222253018,-2.004502074,-0.025123336,222,112,110,0,1.236591704,1.248533925,1.170500555,1.254646398,-0.161224212,0.161224212,1.170500555,1.248533925,0,1,0
2624,11,225,20,40,50,0,5389.663,90,2090.325,LESS,508,1932,2440,5,2,10,0.937408461,10,0.174607574,1.300631117,-0.043770195,90,40,50,1,-1.396151924,-1.560667406,-1.170500555,0.762628203,0.4465647,0.4465647,-1.170500555,-1.560667406,1,1,1
2625,11,226,1,50,51,0,5505.255,70,1457.158,LESS,16,2388,2404,7,2,1,0.093740846,1,-1.396860592,0.566157074,-0.015889512,101,50,51,1,-1.176756621,-1.170500555,-1.131483869,1.746664593,0.062204617,0.062204617,-1.131483869,-1.170500555,1,1,1
2626,11,227,23,85,80,1,7281.303,30,2482.47,LESS,-292,2720,2428,4,2,-5,-0.46870423,5,-0.698430296,-0.90279101,0.412491611,165,85,80,0,0.099725137,0.195083426,0,0.270610007,-0.178411045,0.178411045,0,0.195083426,0,1,0
2627,11,228,11,50,49,0,3460.741,40,1590.282,LESS,-1152,1564,412,2,1,-1,-0.093740846,1,-1.396860592,-0.535553989,-0.509024384,99,50,49,0,-1.216646676,-1.170500555,-1.20951724,-0.713426383,-0.85025997,0.85025997,-1.20951724,-1.170500555,0,0,0
2628,11,229,17,50,43,0,2174.413,10,425.049,LESS,-490,1034,544,2,1,-7,-0.656185922,7,-0.349215148,-1.637265053,-0.8192855,93,50,43,0,-1.336316841,-1.170500555,-1.443617351,-0.713426383,-0.333092541,0.333092541,-1.443617351,-1.170500555,0,0,0
2629,11,230,21,80,82,0,5571.987,80,5303.346,LESS,-358,3022,2664,6,2,2,0.187481692,2,-1.222253018,0.933394096,0.000206184,162,80,82,1,0.039890055,0,0.07803337,1.254646398,-0.229971543,0.229971543,0.07803337,0,1,1,0
2630,11,231,10,50,60,0,2261.369,90,2112.558,LESS,-148,1668,1520,2,2,10,0.937408461,10,0.174607574,1.300631117,-0.798311794,110,50,60,1,-0.997251374,-1.170500555,-0.780333703,-0.713426383,-0.065915411,0.065915411,-0.780333703,-1.170500555,1,0,1
2631,11,232,3,53,50,0,2294.443,40,3756.723,LESS,-240,988,748,3,1,-3,-0.281222538,3,-1.047645444,-0.535553989,-0.790334376,103,53,50,0,-1.136866566,-1.053450499,-1.170500555,-0.221408188,-0.137787621,0.137787621,-1.170500555,-1.053450499,0,0,1
2632,11,233,45,122,110,1,6211.309,10,3905.231,LESS,-2526,4272,1746,4,1,-12,-1.124890153,12,0.523822722,-1.637265053,0.154410055,232,122,110,0,1.436041979,1.638700776,1.170500555,0.270610007,-1.923655811,1.923655811,1.170500555,1.638700776,0,1,0
2633,11,234,38,67,80,0,3827.236,70,2527.863,LESS,474,2130,2604,4,2,13,1.218630999,13,0.698430296,0.566157074,-0.420626132,147,67,80,1,-0.259285357,-0.507216907,0,0.270610007,0.420003231,0.420003231,0,-0.507216907,1,1,1
2634,11,235,38,80,67,1,5168.678,30,2674.828,LESS,-224,2434,2210,8,1,-13,-1.218630999,13,0.698430296,-0.90279101,-0.097071571,147,80,67,0,-0.259285357,0,-0.507216907,2.238682788,-0.125288106,0.125288106,-0.507216907,0,0,1,1
2635,11,236,36,70,80,0,6455.771,10,543.291,LESS,-1326,3006,1680,3,1,10,0.937408461,10,0.174607574,-1.637265053,0.213374062,150,70,80,1,-0.199450275,-0.390166852,0,-0.221408188,-0.986192194,0.986192194,0,-0.390166852,0,0,0
2636,11,237,45,110,122,1,5957.186,10,2775.257,LESS,-782,2910,2128,6,1,12,1.124890153,12,0.523822722,-1.637265053,0.093115824,232,110,122,1,1.436041979,1.170500555,1.638700776,1.254646398,-0.561208688,0.561208688,1.638700776,1.170500555,0,1,0
2637,11,238,42,110,115,1,3704.989,30,1290.233,LESS,8,1510,1518,5,1,5,0.46870423,5,-0.698430296,-0.90279101,-0.450111994,225,110,115,1,1.296426786,1.170500555,1.36558398,0.762628203,0.05595486,0.05595486,1.36558398,1.170500555,0,1,1
2638,11,239,41,110,112,1,4106.09,30,1427.163,LESS,-466,2104,1638,5,1,2,0.187481692,2,-1.222253018,-0.90279101,-0.353366807,222,110,112,1,1.236591704,1.170500555,1.248533925,0.762628203,-0.314343269,0.314343269,1.248533925,1.170500555,0,1,0
2639,11,240,53,110,103,1,2312.514,40,711.361,LESS,-142,914,772,3,1,-7,-0.656185922,7,-0.349215148,-0.535553989,-0.785975667,213,110,103,0,1.057086457,1.170500555,0.897383758,-0.221408188,-0.061228092,0.061228092,0.897383758,1.170500555,0,0,1
2640,12,1,49,110,131,1,5012.381,70,720.22,MORE,36,2072,2108,3,2,21,1.968557767,21,2.095290887,-0.270830623,3.143443346,241,110,131,0,1.615547226,1.170500555,1.989850943,0.359808153,-0.586774645,0.586774645,1.989850943,1.170500555,0,1,0
2641,12,2,13,47,50,1,4646.738,60,2400.817,MORE,-112,2244,2132,5,1,3,0.281222538,3,-1.047645444,-0.786698478,2.741844161,97,47,50,0,-1.256536731,-1.28755061,-1.170500555,1.958955502,-0.820416277,0.820416277,-1.170500555,-1.28755061,0,1,0
2642,12,3,16,50,44,1,4092.891,70,1007.862,MORE,308,1646,1954,5,2,-6,-0.562445076,6,-0.523822722,-0.270830623,2.133533587,94,50,44,1,-1.316371814,-1.170500555,-1.404600665,1.958955502,-0.157379214,0.157379214,-1.404600665,-1.170500555,0,1,0
2643,12,4,7,57,50,1,2190.67,80,795.299,MORE,676,786,1462,3,2,-7,-0.656185922,7,-0.349215148,0.245037231,0.044254148,107,57,50,1,-1.057086457,-0.897383758,-1.170500555,0.359808153,0.423567546,0.423567546,-1.170500555,-0.897383758,0,1,1
2644,12,5,18,42,50,1,5622.538,70,652.572,MORE,2986,692,3678,3,2,8,0.749926769,8,-0.174607574,-0.270830623,3.813601269,92,42,50,0,-1.356261869,-1.482634036,-1.170500555,0.359808153,4.070271391,4.070271391,-1.170500555,-1.482634036,0,1,1
2645,12,6,51,108,110,0,2724.52,80,587.944,MORE,96,1150,1246,4,2,2,0.187481692,2,-1.222253018,0.245037231,0.63060128,218,108,110,0,1.156811594,1.092467184,1.170500555,1.159381828,-0.492055065,0.492055065,1.170500555,1.092467184,0,1,0
2646,12,7,31,78,80,1,2449.388,60,1932.387,MORE,1090,406,1496,1,2,2,0.187481692,2,-1.222253018,-0.786698478,0.328413663,158,78,80,0,-0.039890055,-0.07803337,0,-1.239339195,1.07713265,1.07713265,0,-0.07803337,0,0,1
2647,12,8,58,110,92,0,1639.989,60,567.327,MORE,-414,942,528,2,1,-18,-1.687335229,18,1.571468165,-0.786698478,-0.560579093,202,110,92,1,0.837691154,1.170500555,0.468200222,-0.439765521,-1.297171498,1.297171498,0.468200222,1.170500555,0,1,0
2648,12,9,12,50,48,0,3432.606,60,738.952,MORE,-168,1250,1082,3,1,-2,-0.187481692,2,-1.222253018,-0.786698478,1.408318233,98,50,48,1,-1.236591704,-1.170500555,-1.248533925,0.359808153,-0.908821218,0.908821218,-1.248533925,-1.170500555,0,1,0
2649,12,10,54,110,101,0,2934.281,70,1325.34,MORE,-194,1442,1248,4,1,-9,-0.843667615,9,0,-0.270830623,0.860989518,211,110,101,1,1.017196402,1.170500555,0.819350388,1.159381828,-0.94986637,0.94986637,0.819350388,1.170500555,0,1,0
2650,12,11,14,46,50,1,1190.89,70,601.621,MORE,430,398,828,1,2,4,0.374963384,4,-0.87303787,-0.270830623,-1.053841078,96,46,50,0,-1.276481759,-1.326567295,-1.170500555,-1.239339195,0.035217266,0.035217266,-1.170500555,-1.326567295,0,0,0
2651,12,12,22,80,83,1,1767.183,60,1712.593,MORE,324,438,762,1,2,3,0.281222538,3,-1.047645444,-0.786698478,-0.420877234,163,80,83,0,0.059835082,0,0.117050055,-1.239339195,-0.132120659,0.132120659,0.117050055,0,0,0,0
2652,12,13,6,50,56,1,1294.651,60,1791.231,MORE,380,348,728,1,2,6,0.562445076,6,-0.523822722,-0.786698478,-0.939876547,106,50,56,0,-1.077031484,-1.170500555,-0.936400444,-1.239339195,-0.043715717,0.043715717,-0.936400444,-1.170500555,0,0,0
2653,12,14,13,50,47,0,2238.074,70,1701.206,MORE,-472,1258,786,2,1,-3,-0.281222538,3,-1.047645444,-0.270830623,0.096319708,97,50,47,1,-1.256536731,-1.170500555,-1.28755061,-0.439765521,-1.388733759,1.388733759,-1.28755061,-1.170500555,0,1,0
2654,12,15,46,110,124,0,6584.98,70,1347.056,MORE,394,2104,2498,3,1,14,1.312371845,14,0.87303787,-0.270830623,4.870686793,234,110,124,0,1.475932034,1.170500555,1.716734147,0.359808153,-0.021614482,0.021614482,1.716734147,1.170500555,0,1,0
2655,12,16,27,91,80,1,1428.599,60,677.974,MORE,564,362,926,1,2,-11,-1.031149307,11,0.349215148,-0.786698478,-0.792756521,171,91,80,1,0.219395302,0.429183537,0,-1.239339195,0.246757662,0.246757662,0,0.429183537,0,0,0
2656,12,17,40,64,80,1,1490.428,70,1395.002,MORE,684,470,1154,1,2,16,1.499853537,16,1.222253018,-0.270830623,-0.724847452,144,64,80,0,-0.31912044,-0.624266962,0,-1.239339195,0.436196823,0.436196823,0,-0.624266962,0,0,1
2657,12,18,22,83,80,1,2125.862,50,1513.774,MORE,444,610,1054,2,2,-3,-0.281222538,3,-1.047645444,-1.302566332,-0.026926868,163,83,80,1,0.059835082,0.117050055,0,-0.439765521,0.057318502,0.057318502,0,0.117050055,0,1,0
2658,12,19,54,101,110,1,1668.862,70,809.275,MORE,738,366,1104,1,2,9,0.843667615,9,0,-0.270830623,-0.528866812,211,101,110,0,1.017196402,0.819350388,1.170500555,-1.239339195,0.521444446,0.521444446,1.170500555,0.819350388,0,0,1
2659,12,20,6,56,50,0,3030.588,70,1572.139,MORE,-486,1572,1086,4,2,-6,-0.562445076,6,-0.523822722,-0.270830623,0.966767046,106,56,50,1,-1.077031484,-0.936400444,-1.170500555,1.159381828,-1.410834994,1.410834994,-1.170500555,-0.936400444,0,1,0
2660,12,21,18,50,42,0,4424.91,80,658.199,MORE,38,2130,2168,4,2,-8,-0.749926769,8,-0.174607574,0.245037231,2.498202293,92,50,42,1,-1.356261869,-1.170500555,-1.482634036,1.159381828,-0.583617326,0.583617326,-1.482634036,-1.170500555,1,1,0
2661,12,22,43,110,117,1,2969.178,70,580.926,MORE,810,834,1644,2,2,7,0.656185922,7,-0.349215148,-0.270830623,0.899318179,227,110,117,0,1.336316841,1.170500555,1.443617351,-0.439765521,0.635107942,0.635107942,1.443617351,1.170500555,0,1,1
2662,12,23,32,77,80,1,1303.449,70,1539.59,MORE,762,294,1056,1,2,3,0.281222538,3,-1.047645444,-0.270830623,-0.930213379,157,77,80,0,-0.059835082,-0.117050055,0,-1.239339195,0.559332278,0.559332278,0,-0.117050055,0,0,1
2663,12,24,27,80,91,1,1357.856,70,531.259,MORE,812,300,1112,1,2,11,1.031149307,11,0.349215148,-0.270830623,-0.870456166,171,80,91,0,0.219395302,0,0.429183537,-1.239339195,0.638265261,0.638265261,0.429183537,0,0,0,1
2664,12,25,16,44,50,1,2354.092,70,1549.766,MORE,634,816,1450,3,2,6,0.562445076,6,-0.523822722,-0.270830623,0.223746554,94,44,50,0,-1.316371814,-1.404600665,-1.170500555,0.359808153,0.35726384,0.35726384,-1.170500555,-1.404600665,0,1,0
2665,12,26,7,50,57,1,2004.533,80,637.016,MORE,722,684,1406,3,2,7,0.656185922,7,-0.349215148,0.245037231,-0.16018698,107,50,57,0,-1.057086457,-1.170500555,-0.897383758,0.359808153,0.496185891,0.496185891,-0.897383758,-1.170500555,1,1,1
2666,12,27,14,50,46,0,3356.951,70,475.594,MORE,424,1056,1480,2,2,-4,-0.374963384,4,-0.87303787,-0.270830623,1.325223558,96,50,46,1,-1.276481759,-1.170500555,-1.326567295,-0.439765521,0.025745308,0.025745308,-1.326567295,-1.170500555,0,1,0
2667,12,28,51,110,108,1,1521.511,80,686.902,MORE,430,474,904,1,2,-2,-0.187481692,2,-1.222253018,0.245037231,-0.690707847,218,110,108,1,1.156811594,1.170500555,1.092467184,-1.239339195,0.035217266,0.035217266,1.092467184,1.170500555,0,0,0
2668,12,29,50,133,110,1,1888.712,70,2557.294,MORE,-2,826,824,1,2,-23,-2.15603946,23,2.444506035,-0.270830623,-0.287397454,243,133,110,1,1.655437281,2.067884313,1.170500555,-1.239339195,-0.646763713,0.646763713,1.170500555,2.067884313,0,0,0
2669,12,30,49,131,110,0,3473.523,80,564.787,MORE,192,1444,1636,3,2,-21,-1.968557767,21,2.095290887,0.245037231,1.453258883,241,131,110,1,1.615547226,1.989850943,1.170500555,0.359808153,-0.340503736,0.340503736,1.170500555,1.989850943,1,1,0
2670,12,31,47,126,110,1,1729.091,60,1518.692,MORE,444,676,1120,1,2,-16,-1.499853537,16,1.222253018,-0.786698478,-0.462715082,236,126,110,1,1.515822089,1.794767517,1.170500555,-1.239339195,0.057318502,0.057318502,1.170500555,1.794767517,0,0,0
2671,12,32,50,110,133,1,2395.127,70,1458.256,MORE,36,746,782,2,2,23,2.15603946,23,2.444506035,-0.270830623,0.268816807,243,110,133,0,1.655437281,1.170500555,2.067884313,-0.439765521,-0.586774645,0.586774645,2.067884313,1.170500555,0,1,0
2672,12,33,47,110,126,1,1582.413,80,565.764,MORE,874,316,1190,1,2,16,1.499853537,16,1.222253018,0.245037231,-0.623816936,236,110,126,0,1.515822089,1.170500555,1.794767517,-1.239339195,0.736142161,0.736142161,1.794767517,1.170500555,1,0,1
2673,12,34,12,48,50,1,3903.343,60,985.443,MORE,1608,792,2400,3,2,2,0.187481692,2,-1.222253018,-0.786698478,1.925346032,98,48,50,0,-1.236591704,-1.248533925,-1.170500555,0.359808153,1.894878361,1.894878361,-1.170500555,-1.248533925,0,1,1
2674,12,35,32,80,77,0,2663.144,60,362.908,MORE,-470,1414,944,4,2,-3,-0.281222538,3,-1.047645444,-0.786698478,0.563189757,157,80,77,1,-0.059835082,0,-0.117050055,1.159381828,-1.38557644,1.38557644,-0.117050055,0,0,1,0
2675,12,36,43,117,110,1,1934.49,80,635.7,MORE,522,690,1212,3,2,-7,-0.656185922,7,-0.349215148,0.245037231,-0.237117789,227,117,110,1,1.336316841,1.443617351,1.170500555,0.359808153,0.180453956,0.180453956,1.170500555,1.443617351,1,1,0
2676,12,37,40,80,64,0,2405.19,70,1514.385,MORE,-148,1208,1060,2,2,-16,-1.499853537,16,1.222253018,-0.270830623,0.279869371,144,80,64,1,-0.31912044,0,-0.624266962,-0.439765521,-0.877248025,0.877248025,-0.624266962,0,0,1,0
2677,12,38,31,80,78,1,1545.105,70,812.57,MORE,852,398,1250,1,2,-2,-0.187481692,2,-1.222253018,-0.270830623,-0.664793687,158,80,78,1,-0.039890055,0,-0.07803337,-1.239339195,0.701411648,0.701411648,-0.07803337,0,0,0,1
2678,12,39,46,124,110,0,2604.714,70,1988.39,MORE,-1998,1998,0,0,1,-14,-1.312371845,14,0.87303787,-0.270830623,0.499013934,234,124,110,1,1.475932034,1.716734147,1.170500555,-2.03891287,-3.79776842,3.79776842,1.170500555,1.716734147,0,0,0
2679,12,40,58,92,110,1,1120.327,80,1225.977,MORE,766,302,1068,1,2,18,1.687335229,18,1.571468165,0.245037231,-1.131343022,202,92,110,0,0.837691154,0.468200222,1.170500555,-1.239339195,0.565646916,0.565646916,1.170500555,0.468200222,1,0,1
2680,12,41,49,110,131,0,4133.502,100,2319.173,LESS,-178,2108,1930,3,2,21,1.968557767,21,2.095290887,1.276772939,2.178138145,241,110,131,1,1.615547226,1.170500555,1.989850943,0.359808153,-0.924607815,0.924607815,1.989850943,1.170500555,1,1,0
2681,12,42,13,47,50,0,2344.901,80,1289.56,LESS,532,1006,1538,4,2,3,0.281222538,3,-1.047645444,0.245037231,0.21365174,97,47,50,1,-1.256536731,-1.28755061,-1.170500555,1.159381828,0.196240553,0.196240553,-1.170500555,-1.28755061,1,1,1
2682,12,43,16,50,44,0,4172.514,80,1289.197,LESS,-426,1950,1524,4,2,-6,-0.562445076,6,-0.523822722,0.245037231,2.220986463,94,50,44,0,-1.316371814,-1.170500555,-1.404600665,1.159381828,-1.316115414,1.316115414,-1.404600665,-1.170500555,1,1,0
2683,12,44,7,57,50,1,2683.681,80,1270.562,LESS,992,610,1602,2,2,-7,-0.656185922,7,-0.349215148,0.245037231,0.585746301,107,57,50,0,-1.057086457,-0.897383758,-1.170500555,-0.439765521,0.922424002,0.922424002,-1.170500555,-0.897383758,1,0,1
2684,12,45,18,42,50,0,2372.649,80,661.379,LESS,142,992,1134,2,2,8,0.749926769,8,-0.174607574,0.245037231,0.244128391,92,42,50,1,-1.356261869,-1.482634036,-1.170500555,-0.439765521,-0.41943672,0.41943672,-1.170500555,-1.482634036,1,0,0
2685,12,46,51,108,110,1,2718.971,80,996.493,LESS,604,1100,1704,3,2,2,0.187481692,2,-1.222253018,0.245037231,0.624506609,218,108,110,1,1.156811594,1.092467184,1.170500555,0.359808153,0.309904049,0.309904049,1.170500555,1.092467184,1,1,1
2686,12,47,31,78,80,0,2275.609,80,1149.489,LESS,-112,1156,1044,4,2,2,0.187481692,2,-1.222253018,0.245037231,0.137545782,158,78,80,1,-0.039890055,-0.07803337,0,1.159381828,-0.820416277,0.820416277,0,-0.07803337,1,1,0
2687,12,48,58,110,92,1,3663.207,80,1724.11,LESS,914,1514,2428,3,2,-18,-1.687335229,18,1.571468165,0.245037231,1.661595812,202,110,92,0,0.837691154,1.170500555,0.468200222,0.359808153,0.799288548,0.799288548,0.468200222,1.170500555,1,1,1
2688,12,49,12,50,48,0,4535.443,80,636.239,LESS,72,1924,1996,5,2,-2,-0.187481692,2,-1.222253018,0.245037231,2.619604761,98,50,48,0,-1.236591704,-1.170500555,-1.248533925,1.958955502,-0.529942897,0.529942897,-1.248533925,-1.170500555,1,1,0
2689,12,50,54,110,101,1,3811.3,70,756.81,LESS,524,1236,1760,2,2,-9,-0.843667615,9,0,-0.270830623,1.824251812,211,110,101,0,1.017196402,1.170500555,0.819350388,-0.439765521,0.183611275,0.183611275,0.819350388,1.170500555,0,0,1
2690,12,51,14,46,50,0,1867.991,70,1906.049,LESS,-218,928,710,1,2,4,0.374963384,4,-0.87303787,-0.270830623,-0.310156092,96,46,50,1,-1.276481759,-1.326567295,-1.170500555,-1.239339195,-0.987754202,0.987754202,-1.170500555,-1.326567295,0,0,0
2691,12,52,22,80,83,0,3144.909,80,584.543,LESS,626,866,1492,4,2,3,0.281222538,3,-1.047645444,0.245037231,1.092330014,163,80,83,1,0.059835082,0,0.117050055,1.159381828,0.344634562,0.344634562,0.117050055,0,1,1,1
2692,12,53,6,50,56,0,1893.776,80,2028.186,LESS,-142,978,836,2,2,6,0.562445076,6,-0.523822722,0.245037231,-0.281835476,106,50,56,1,-1.077031484,-1.170500555,-0.936400444,-0.439765521,-0.867776067,0.867776067,-0.936400444,-1.170500555,1,0,0
2693,12,54,13,50,47,0,1612.25,80,1674.87,LESS,160,762,922,2,2,-3,-0.281222538,3,-1.047645444,0.245037231,-0.591045859,97,50,47,0,-1.256536731,-1.170500555,-1.28755061,-0.439765521,-0.391020846,0.391020846,-1.28755061,-1.170500555,1,0,0
2694,12,55,46,110,124,0,3018.789,80,2861.926,LESS,-522,2086,1564,4,2,14,1.312371845,14,0.87303787,0.245037231,0.953807769,234,110,124,1,1.475932034,1.170500555,1.716734147,1.159381828,-1.467666743,1.467666743,1.716734147,1.170500555,1,1,0
2695,12,56,27,91,80,0,3229.221,80,722.196,LESS,432,1384,1816,4,2,-11,-1.031149307,11,0.349215148,0.245037231,1.184932991,171,91,80,0,0.219395302,0.429183537,0,1.159381828,0.038374586,0.038374586,0,0.429183537,1,1,1
2696,12,57,40,64,80,0,2085.74,80,1544.729,LESS,-276,1278,1002,3,2,16,1.499853537,16,1.222253018,0.245037231,-0.070994339,144,64,80,1,-0.31912044,-0.624266962,0,0.359808153,-1.079316463,1.079316463,0,-0.624266962,0,1,0
2697,12,58,22,83,80,0,3047.369,70,1949.011,LESS,508,1214,1722,4,2,-3,-0.281222538,3,-1.047645444,-0.270830623,0.985198237,163,83,80,0,0.059835082,0.117050055,0,1.159381828,0.158352721,0.158352721,0,0.117050055,0,1,1
2698,12,59,54,101,110,0,2189.348,70,1784.322,LESS,578,1086,1664,4,1,9,0.843667615,9,0,-0.270830623,0.042802146,211,101,110,1,1.017196402,0.819350388,1.170500555,1.159381828,0.268858898,0.268858898,1.170500555,0.819350388,0,1,1
2699,12,60,6,56,50,0,2105.953,80,1307.251,LESS,790,656,1446,3,2,-6,-0.562445076,6,-0.523822722,0.245037231,-0.048793656,106,56,50,0,-1.077031484,-0.936400444,-1.170500555,0.359808153,0.603534749,0.603534749,-1.170500555,-0.936400444,0,1,1
2700,12,61,18,50,42,0,2914.924,80,1803.093,LESS,112,1294,1406,4,2,-8,-0.749926769,8,-0.174607574,0.245037231,0.839729011,92,50,42,0,-1.356261869,-1.170500555,-1.482634036,1.159381828,-0.46679651,0.46679651,-1.482634036,-1.170500555,1,1,0
2701,12,62,43,110,117,0,2821.451,80,2165.512,LESS,482,1352,1834,3,2,7,0.656185922,7,-0.349215148,0.245037231,0.73706417,227,110,117,1,1.336316841,1.170500555,1.443617351,0.359808153,0.117307569,0.117307569,1.443617351,1.170500555,1,1,1
2702,12,63,32,77,80,0,1907.541,70,596.931,LESS,386,792,1178,4,2,3,0.281222538,3,-1.047645444,-0.270830623,-0.266716869,157,77,80,1,-0.059835082,-0.117050055,0,1.159381828,-0.034243759,0.034243759,0,-0.117050055,0,1,1
2703,12,64,27,80,91,0,2266.263,90,2359.055,LESS,122,1336,1458,4,2,11,1.031149307,11,0.349215148,0.760905085,0.127280726,171,80,91,1,0.219395302,0,0.429183537,1.159381828,-0.451009913,0.451009913,0.429183537,0,1,1,0
2704,12,65,16,44,50,0,1622.718,90,2520.128,LESS,520,830,1350,2,2,6,0.562445076,6,-0.523822722,0.760905085,-0.579548468,94,44,50,1,-1.316371814,-1.404600665,-1.170500555,-0.439765521,0.177296637,0.177296637,-1.170500555,-1.404600665,1,0,1
2705,12,66,7,50,57,0,1739.322,90,2308.085,LESS,358,658,1016,4,2,7,0.656185922,7,-0.349215148,0.760905085,-0.451477997,107,50,57,1,-1.057086457,-1.170500555,-0.897383758,1.159381828,-0.07844623,0.07844623,-0.897383758,-1.170500555,1,1,1
2706,12,67,14,50,46,0,1307.09,90,1128.469,LESS,430,686,1116,2,2,-4,-0.374963384,4,-0.87303787,0.760905085,-0.926214335,96,50,46,0,-1.276481759,-1.170500555,-1.326567295,-0.439765521,0.035217266,0.035217266,-1.326567295,-1.170500555,1,0,1
2707,12,68,51,110,108,1,2422.374,80,533.872,LESS,558,738,1296,3,2,-2,-0.187481692,2,-1.222253018,0.245037231,0.298743191,218,110,108,0,1.156811594,1.170500555,1.092467184,0.359808153,0.237285704,0.237285704,1.092467184,1.170500555,0,1,1
2708,12,69,50,133,110,1,1741.762,90,634.54,LESS,1270,396,1666,1,2,-23,-2.15603946,23,2.444506035,0.760905085,-0.448798055,243,133,110,0,1.655437281,2.067884313,1.170500555,-1.239339195,1.361291392,1.361291392,1.170500555,2.067884313,1,0,1
2709,12,70,49,131,110,1,2127.148,80,2722.119,LESS,742,838,1580,4,2,-21,-1.968557767,21,2.095290887,0.245037231,-0.025514406,241,131,110,0,1.615547226,1.989850943,1.170500555,1.159381828,0.527759084,0.527759084,1.170500555,1.989850943,0,1,1
2710,12,71,47,126,110,0,1678.147,80,1357.464,LESS,-282,920,638,2,2,-16,-1.499853537,16,1.222253018,0.245037231,-0.518668755,236,126,110,0,1.515822089,1.794767517,1.170500555,-0.439765521,-1.088788421,1.088788421,1.170500555,1.794767517,0,0,0
2711,12,72,50,110,133,0,1387.816,80,936.644,LESS,-180,722,542,3,2,23,2.15603946,23,2.444506035,0.245037231,-0.837549993,243,110,133,1,1.655437281,1.170500555,2.067884313,0.359808153,-0.927765134,0.927765134,2.067884313,1.170500555,0,1,0
2712,12,73,47,110,126,0,3761.125,80,994.934,LESS,64,1564,1628,4,1,16,1.499853537,16,1.222253018,0.245037231,1.76914276,236,110,126,1,1.515822089,1.170500555,1.794767517,1.159381828,-0.542572174,0.542572174,1.794767517,1.170500555,0,1,0
2713,12,74,12,48,50,0,2172.223,80,1052.427,LESS,-126,1054,928,5,2,2,0.187481692,2,-1.222253018,0.245037231,0.023993128,98,48,50,1,-1.236591704,-1.248533925,-1.170500555,1.958955502,-0.842517512,0.842517512,-1.170500555,-1.248533925,0,1,0
2714,12,75,32,80,77,0,1835.106,80,2054.531,LESS,-442,1162,720,2,2,-3,-0.281222538,3,-1.047645444,0.245037231,-0.3462749,157,80,77,0,-0.059835082,0,-0.117050055,-0.439765521,-1.341373969,1.341373969,-0.117050055,0,0,0,0
2715,12,76,43,117,110,0,1694.167,80,675.811,LESS,-418,1100,682,2,2,-7,-0.656185922,7,-0.349215148,0.245037231,-0.501073398,227,117,110,0,1.336316841,1.443617351,1.170500555,-0.439765521,-1.303486137,1.303486137,1.170500555,1.443617351,0,0,0
2716,12,77,40,80,64,0,1639.164,40,437.917,LESS,-340,904,564,3,2,-16,-1.499853537,16,1.222253018,-1.818434186,-0.56148522,144,80,64,0,-0.31912044,0,-0.624266962,0.359808153,-1.180350682,1.180350682,-0.624266962,0,0,1,0
2717,12,78,31,80,78,0,1822.856,80,728.996,LESS,98,786,884,2,2,-2,-0.187481692,2,-1.222253018,0.245037231,-0.359729526,158,80,78,0,-0.039890055,0,-0.07803337,-0.439765521,-0.488897745,0.488897745,-0.07803337,0,0,0,0
2718,12,79,46,124,110,0,1955.912,90,576.611,LESS,62,1134,1196,2,2,-14,-1.312371845,14,0.87303787,0.760905085,-0.213589217,234,124,110,0,1.475932034,1.716734147,1.170500555,-0.439765521,-0.545729493,0.545729493,1.170500555,1.716734147,1,0,0
2719,12,80,58,92,110,0,1829.862,90,1200.454,LESS,370,1028,1398,2,2,18,1.687335229,18,1.571468165,0.760905085,-0.352034578,202,92,110,1,0.837691154,0.468200222,1.170500555,-0.439765521,-0.059502314,0.059502314,1.170500555,0.468200222,1,0,1
2720,12,81,48,128,110,0,2319.583,90,3620.087,MORE,506,1434,1940,4,2,-18,-1.687335229,18,1.571468165,0.760905085,0.185844047,238,128,110,1,1.555712144,1.872800887,1.170500555,1.159381828,0.155195401,0.155195401,1.170500555,1.872800887,1,1,0
2721,12,82,8,50,58,1,2658.008,90,1733.719,MORE,1026,922,1948,3,2,8,0.749926769,8,-0.174607574,0.760905085,0.557548699,108,50,58,0,-1.037141429,-1.170500555,-0.858367073,0.359808153,0.976098431,0.976098431,-0.858367073,-1.170500555,1,1,1
2722,12,83,4,54,50,0,4644.769,90,1073.908,MORE,460,2076,2536,6,2,-4,-0.374963384,4,-0.87303787,0.760905085,2.739681536,104,54,50,1,-1.116921539,-1.014433814,-1.170500555,2.758529177,0.082577056,0.082577056,-1.170500555,-1.014433814,1,1,0
2723,12,84,37,80,69,0,2336.904,20,1689.57,MORE,-636,1380,744,2,1,-11,-1.031149307,11,0.349215148,-2.850169894,0.20486834,149,80,69,1,-0.219395302,0,-0.429183537,-0.439765521,-1.647633945,1.647633945,-0.429183537,0,0,1,0
2724,12,85,52,105,110,1,2232.262,70,1564.033,MORE,442,808,1250,3,2,5,0.46870423,5,-0.698430296,-0.270830623,0.089936174,215,105,110,0,1.096976512,0.975417129,1.170500555,0.359808153,0.054161182,0.054161182,1.170500555,0.975417129,0,1,0
2725,12,86,5,55,50,0,2404.233,60,1460.526,MORE,-582,1316,734,2,1,-5,-0.46870423,5,-0.698430296,-0.786698478,0.278818262,105,55,50,1,-1.096976512,-0.975417129,-1.170500555,-0.439765521,-1.562386323,1.562386323,-1.170500555,-0.975417129,0,0,0
2726,12,87,30,96,80,0,3773.941,80,1247.405,MORE,290,2010,2300,5,2,-16,-1.499853537,16,1.222253018,0.245037231,1.783219045,176,96,80,1,0.31912044,0.624266962,0,1.958955502,-0.185795088,0.185795088,0,0.624266962,1,1,0
2727,12,88,33,80,75,0,1389.338,80,2212.317,MORE,244,892,1136,2,2,-5,-0.46870423,5,-0.698430296,0.245037231,-0.835878325,155,80,75,1,-0.099725137,0,-0.195083426,-0.439765521,-0.258413433,0.258413433,-0.195083426,0,1,0,0
2728,12,89,48,110,128,1,1345.217,90,2604.087,MORE,1216,326,1542,1,2,18,1.687335229,18,1.571468165,0.760905085,-0.884338045,238,110,128,0,1.555712144,1.170500555,1.872800887,-1.239339195,1.276043769,1.276043769,1.872800887,1.170500555,1,0,1
2729,12,90,9,59,50,0,2517.299,80,2631.09,MORE,-236,1608,1372,1,2,-9,-0.843667615,9,0,0.245037231,0.403002818,109,59,50,1,-1.017196402,-0.819350388,-1.170500555,-1.239339195,-1.016170076,1.016170076,-1.170500555,-0.819350388,1,0,0
2730,12,91,44,110,119,1,1667.654,80,1497.959,MORE,1600,362,1962,1,2,9,0.843667615,9,0,0.245037231,-0.530193603,229,110,119,0,1.376206896,1.170500555,1.521650721,-1.239339195,1.882249084,1.882249084,1.521650721,1.170500555,1,0,1
2731,12,92,2,52,50,0,2896.692,80,1982.463,MORE,150,1312,1462,4,2,-2,-0.187481692,2,-1.222253018,0.245037231,0.819704134,102,52,50,1,-1.156811594,-1.092467184,-1.170500555,1.159381828,-0.406807442,0.406807442,-1.170500555,-1.092467184,1,1,0
2732,12,93,8,58,50,1,1162.424,90,702.6,MORE,936,256,1192,1,2,-8,-0.749926769,8,-0.174607574,0.760905085,-1.085106335,108,58,50,1,-1.037141429,-0.858367073,-1.170500555,-1.239339195,0.834019061,0.834019061,-1.170500555,-0.858367073,1,0,1
2733,12,94,44,119,110,0,1708.837,90,1104.725,MORE,-202,988,786,2,2,-9,-0.843667615,9,0,0.760905085,-0.484960796,229,119,110,1,1.376206896,1.521650721,1.170500555,-0.439765521,-0.962495647,0.962495647,1.170500555,1.521650721,1,1,0
2734,12,95,34,74,80,1,1290.039,90,597.066,MORE,982,302,1284,1,2,6,0.562445076,6,-0.523822722,0.760905085,-0.944942077,154,74,80,0,-0.119670165,-0.234100111,0,-1.239339195,0.906637406,0.906637406,0,-0.234100111,1,0,1
2735,12,96,24,86,80,1,1770.544,80,1630.783,MORE,1484,374,1858,1,2,-6,-0.562445076,6,-0.523822722,0.245037231,-0.417185724,166,86,80,1,0.119670165,0.234100111,0,-1.239339195,1.699124562,1.699124562,0,0.234100111,1,0,1
2736,12,97,39,66,80,1,1432.934,90,2238.265,MORE,2130,254,2384,1,2,14,1.312371845,14,0.87303787,0.760905085,-0.787995231,146,66,80,0,-0.279230385,-0.546233592,0,-1.239339195,2.718938711,2.718938711,0,-0.546233592,1,0,1
2737,12,98,9,50,59,1,3000.278,40,1272.109,MORE,712,864,1576,3,2,9,0.843667615,9,0,-1.818434186,0.933476456,109,50,59,0,-1.017196402,-1.170500555,-0.819350388,0.359808153,0.480399294,0.480399294,-0.819350388,-1.170500555,0,1,1
2738,12,99,57,94,110,1,1799.973,80,1601.246,MORE,670,642,1312,3,2,16,1.499853537,16,1.222253018,0.245037231,-0.384862768,204,94,110,0,0.877581209,0.546233592,1.170500555,0.359808153,0.414095588,0.414095588,1.170500555,0.546233592,1,1,1
2739,12,100,60,110,87,0,1775.2,80,1134.16,MORE,160,786,946,3,2,-23,-2.15603946,23,2.444506035,0.245037231,-0.412071867,197,110,87,1,0.737966017,1.170500555,0.273116796,0.359808153,-0.391020846,0.391020846,0.273116796,1.170500555,1,1,0
2740,12,101,33,75,80,1,1256.005,90,614.303,MORE,938,224,1162,1,2,5,0.46870423,5,-0.698430296,0.760905085,-0.982322873,155,75,80,0,-0.099725137,-0.195083426,0,-1.239339195,0.83717638,0.83717638,0,-0.195083426,1,0,1
2741,12,102,15,50,45,0,3209.321,90,585.463,MORE,122,1470,1592,4,2,-5,-0.46870423,5,-0.698430296,0.760905085,1.163076088,95,50,45,1,-1.296426786,-1.170500555,-1.36558398,1.159381828,-0.451009913,0.451009913,-1.36558398,-1.170500555,1,1,0
2742,12,103,59,89,110,1,1909.739,80,1443.472,MORE,592,680,1272,1,2,21,1.968557767,21,2.095290887,0.245037231,-0.264302725,199,89,110,0,0.777856072,0.351150166,1.170500555,-1.239339195,0.290960133,0.290960133,1.170500555,0.351150166,1,0,0
2743,12,104,29,80,94,1,1389.695,80,666.407,MORE,638,270,908,1,2,14,1.312371845,14,0.87303787,0.245037231,-0.835486218,174,80,94,0,0.279230385,0,0.546233592,-1.239339195,0.363578478,0.363578478,0.546233592,0,1,0,0
2744,12,105,55,110,98,1,1464.614,80,658.519,MORE,770,360,1130,1,2,-12,-1.124890153,12,0.523822722,0.245037231,-0.753199919,208,110,98,1,0.957361319,1.170500555,0.702300333,-1.239339195,0.571961555,0.571961555,0.702300333,1.170500555,1,0,1
2745,12,106,29,94,80,1,2393.765,90,1283.431,MORE,890,874,1764,3,2,-14,-1.312371845,14,0.87303787,0.760905085,0.267320872,174,94,80,1,0.279230385,0.546233592,0,0.359808153,0.761400716,0.761400716,0,0.546233592,1,1,1
2746,12,107,57,110,94,1,1465.825,80,1432.394,MORE,1452,388,1840,1,2,-16,-1.499853537,16,1.222253018,0.245037231,-0.751869833,204,110,94,1,0.877581209,1.170500555,0.546233592,-1.239339195,1.648607452,1.648607452,0.546233592,1.170500555,1,0,1
2747,12,108,39,80,66,1,1234.519,80,1415.7,MORE,776,332,1108,1,2,-14,-1.312371845,14,0.87303787,0.245037231,-1.005921739,146,80,66,1,-0.279230385,0,-0.546233592,-1.239339195,0.581433513,0.581433513,-0.546233592,0,1,0,1
2748,12,109,4,50,54,1,2530.536,70,573.753,MORE,592,696,1288,3,2,4,0.374963384,4,-0.87303787,-0.270830623,0.417541503,104,50,54,0,-1.116921539,-1.170500555,-1.014433814,0.359808153,0.290960133,0.290960133,-1.014433814,-1.170500555,0,1,0
2749,12,110,55,98,110,1,1402.307,80,517.159,MORE,820,344,1164,1,2,12,1.124890153,12,0.523822722,0.245037231,-0.821633994,208,98,110,0,0.957361319,0.702300333,1.170500555,-1.239339195,0.650894539,0.650894539,1.170500555,0.702300333,0,0,1
2750,12,111,2,50,52,1,1189.071,90,878.807,MORE,1264,294,1558,1,2,2,0.187481692,2,-1.222253018,0.760905085,-1.055838953,102,50,52,0,-1.156811594,-1.170500555,-1.092467184,-1.239339195,1.351819434,1.351819434,-1.092467184,-1.170500555,1,0,1
2751,12,112,59,110,89,0,2251.736,80,1881.041,MORE,-16,934,918,2,2,-21,-1.968557767,21,2.095290887,0.245037231,0.111325186,199,110,89,1,0.777856072,1.170500555,0.351150166,-0.439765521,-0.668864948,0.668864948,0.351150166,1.170500555,0,1,0
2752,12,113,60,87,110,1,1241.553,80,1138.797,MORE,858,292,1150,1,2,23,2.15603946,23,2.444506035,0.245037231,-0.998196038,197,87,110,0,0.737966017,0.273116796,1.170500555,-1.239339195,0.710883606,0.710883606,1.170500555,0.273116796,0,0,1
2753,12,114,52,110,105,1,1491.138,80,620.984,MORE,1050,282,1332,1,2,-5,-0.46870423,5,-0.698430296,0.245037231,-0.724067632,215,110,105,1,1.096976512,1.170500555,0.975417129,-1.239339195,1.013986264,1.013986264,0.975417129,1.170500555,0,0,1
2754,12,115,30,80,96,1,1117.673,80,1314.295,MORE,800,262,1062,1,2,16,1.499853537,16,1.222253018,0.245037231,-1.134258008,176,80,96,0,0.31912044,0,0.624266962,-1.239339195,0.619321345,0.619321345,0.624266962,0,1,0,1
2755,12,116,24,80,86,1,1573.281,90,716.147,MORE,160,616,776,1,2,6,0.562445076,6,-0.523822722,0.760905085,-0.633846948,166,80,86,0,0.119670165,0,0.234100111,-1.239339195,-0.391020846,0.391020846,0.234100111,0,1,0,0
2756,12,117,5,50,55,1,4591.682,80,1914.617,MORE,-1096,2912,1816,3,2,5,0.46870423,5,-0.698430296,0.245037231,2.681374127,105,50,55,0,-1.096976512,-1.170500555,-0.975417129,0.359808153,-2.373817395,2.373817395,-0.975417129,-1.170500555,0,1,0
2757,12,118,34,80,74,1,1523.109,80,1091.416,MORE,1206,310,1516,1,2,-6,-0.562445076,6,-0.523822722,0.245037231,-0.688952705,154,80,74,1,-0.119670165,0,-0.234100111,-1.239339195,1.260257173,1.260257173,-0.234100111,0,0,0,1
2758,12,119,15,45,50,1,1425.348,80,537.178,MORE,668,342,1010,1,2,5,0.46870423,5,-0.698430296,0.245037231,-0.796327214,95,45,50,0,-1.296426786,-1.36558398,-1.170500555,-1.239339195,0.410938268,0.410938268,-1.170500555,-1.36558398,0,0,0
2759,12,120,37,69,80,1,1289.357,80,1150.871,MORE,1684,340,2024,1,2,11,1.031149307,11,0.349215148,0.245037231,-0.945691142,149,69,80,0,-0.219395302,-0.429183537,0,-1.239339195,2.014856496,2.014856496,0,-0.429183537,0,0,1
2760,12,121,48,128,110,1,2394.368,90,1076.126,LESS,378,866,1244,3,2,-18,-1.687335229,18,1.571468165,0.760905085,0.267983169,238,128,110,0,1.555712144,1.872800887,1.170500555,0.359808153,-0.046873037,0.046873037,1.170500555,1.872800887,1,1,1
2761,12,122,8,50,58,0,2603.083,90,2095.939,LESS,556,1178,1734,2,2,8,0.749926769,8,-0.174607574,0.760905085,0.497222547,108,50,58,1,-1.037141429,-1.170500555,-0.858367073,-0.439765521,0.234128385,0.234128385,-0.858367073,-1.170500555,1,0,1
2762,12,123,4,54,50,0,1765.114,80,2092.154,LESS,-170,1106,936,2,2,-4,-0.374963384,4,-0.87303787,0.245037231,-0.423149693,104,54,50,0,-1.116921539,-1.014433814,-1.170500555,-0.439765521,-0.911978538,0.911978538,-1.170500555,-1.014433814,1,0,0
2763,12,124,37,80,69,1,2620.021,70,1894.58,LESS,1114,814,1928,3,2,-11,-1.031149307,11,0.349215148,-0.270830623,0.515826177,149,80,69,0,-0.219395302,0,-0.429183537,0.359808153,1.115020483,1.115020483,-0.429183537,0,0,1,1
2764,12,125,52,105,110,0,2092.026,80,2013.372,LESS,96,938,1034,4,2,5,0.46870423,5,-0.698430296,0.245037231,-0.064090194,215,105,110,1,1.096976512,0.975417129,1.170500555,1.159381828,-0.492055065,0.492055065,1.170500555,0.975417129,1,1,0
2765,12,126,5,55,50,0,1375.603,90,1446.296,LESS,234,698,932,3,2,-5,-0.46870423,5,-0.698430296,0.760905085,-0.850963982,105,55,50,0,-1.096976512,-0.975417129,-1.170500555,0.359808153,-0.27420003,0.27420003,-1.170500555,-0.975417129,1,1,1
2766,12,127,30,96,80,0,1931.041,90,1777.377,LESS,1206,858,2064,5,2,-16,-1.499853537,16,1.222253018,0.760905085,-0.240905953,176,96,80,0,0.31912044,0.624266962,0,1.958955502,1.260257173,1.260257173,0,0.624266962,1,1,1
2767,12,128,33,80,75,1,2155.306,80,1271.057,LESS,680,790,1470,3,2,-5,-0.46870423,5,-0.698430296,0.245037231,0.005412563,155,80,75,0,-0.099725137,0,-0.195083426,0.359808153,0.429882184,0.429882184,-0.195083426,0,0,1,1
2768,12,129,48,110,128,0,1245.369,90,1273.703,LESS,340,750,1090,3,2,18,1.687335229,18,1.571468165,0.760905085,-0.994004784,238,110,128,1,1.555712144,1.170500555,1.872800887,0.359808153,-0.106862104,0.106862104,1.872800887,1.170500555,1,1,1
2769,12,130,9,59,50,1,1689.232,90,1612.008,LESS,904,638,1542,3,2,-9,-0.843667615,9,0,0.760905085,-0.506493691,109,59,50,0,-1.017196402,-0.819350388,-1.170500555,0.359808153,0.783501951,0.783501951,-1.170500555,-0.819350388,1,1,1
2770,12,131,44,110,119,0,1911.731,90,1805.699,LESS,456,1054,1510,3,2,9,0.843667615,9,0,0.760905085,-0.262114838,229,110,119,1,1.376206896,1.170500555,1.521650721,0.359808153,0.076262418,0.076262418,1.521650721,1.170500555,1,1,1
2771,12,132,2,52,50,0,1341.89,80,1202.417,LESS,266,712,978,3,2,-2,-0.187481692,2,-1.222253018,0.245037231,-0.887992212,102,52,50,0,-1.156811594,-1.092467184,-1.170500555,0.359808153,-0.22368292,0.22368292,-1.170500555,-1.092467184,0,1,1
2772,12,133,8,58,50,0,1148.135,90,636.795,LESS,152,686,838,3,2,-8,-0.749926769,8,-0.174607574,0.760905085,-1.10080047,108,58,50,0,-1.037141429,-0.858367073,-1.170500555,0.359808153,-0.403650123,0.403650123,-1.170500555,-0.858367073,1,1,0
2773,12,134,44,119,110,1,2136.489,80,1842.865,LESS,1014,714,1728,3,2,-9,-0.843667615,9,0,0.245037231,-0.015254842,229,119,110,0,1.376206896,1.521650721,1.170500555,0.359808153,0.957154515,0.957154515,1.170500555,1.521650721,0,1,1
2774,12,135,34,74,80,0,2217.437,90,1426.058,LESS,-92,1516,1424,3,2,6,0.562445076,6,-0.523822722,0.760905085,0.07365333,154,74,80,1,-0.119670165,-0.234100111,0,0.359808153,-0.788843083,0.788843083,0,-0.234100111,1,1,0
2775,12,136,24,86,80,0,1448.725,80,2038.094,LESS,302,1002,1304,5,2,-6,-0.562445076,6,-0.523822722,0.245037231,-0.770651394,166,86,80,0,0.119670165,0.234100111,0,1.958955502,-0.166851172,0.166851172,0,0.234100111,0,1,1
2776,12,137,39,66,80,0,1879.483,80,1521.099,LESS,356,788,1144,1,2,14,1.312371845,14,0.87303787,0.245037231,-0.297534005,146,66,80,1,-0.279230385,-0.546233592,0,-1.239339195,-0.08160355,0.08160355,0,-0.546233592,0,0,1
2777,12,138,9,50,59,0,1172.7,80,1716.861,LESS,64,650,714,2,2,9,0.843667615,9,0,0.245037231,-1.073819825,109,50,59,1,-1.017196402,-1.170500555,-0.819350388,-0.439765521,-0.542572174,0.542572174,-0.819350388,-1.170500555,0,0,0
2778,12,139,57,94,110,0,2866.332,90,2538.774,LESS,238,1450,1688,3,2,16,1.499853537,16,1.222253018,0.760905085,0.786358627,204,94,110,1,0.877581209,0.546233592,1.170500555,0.359808153,-0.267885391,0.267885391,1.170500555,0.546233592,1,1,1
2779,12,140,60,110,87,0,3222.912,80,1511.411,LESS,284,1506,1790,2,2,-23,-2.15603946,23,2.444506035,0.245037231,1.178003584,197,110,87,0,0.737966017,1.170500555,0.273116796,-0.439765521,-0.195267046,0.195267046,0.273116796,1.170500555,0,0,1
2780,12,141,33,75,80,0,1398.012,90,2172.259,LESS,480,806,1286,3,2,5,0.46870423,5,-0.698430296,0.760905085,-0.826351351,155,75,80,1,-0.099725137,-0.195083426,0,0.359808153,0.11415025,0.11415025,0,-0.195083426,1,1,1
2781,12,142,15,50,45,0,2513.735,80,631.674,LESS,676,834,1510,2,2,-5,-0.46870423,5,-0.698430296,0.245037231,0.399088345,95,50,45,0,-1.296426786,-1.170500555,-1.36558398,-0.439765521,0.423567546,0.423567546,-1.36558398,-1.170500555,0,0,1
2782,12,143,59,89,110,1,4561.14,80,956.052,LESS,1228,1432,2660,4,2,21,1.968557767,21,2.095290887,0.245037231,2.647828723,199,89,110,1,0.777856072,0.351150166,1.170500555,1.159381828,1.294987685,1.294987685,1.170500555,0.351150166,0,1,1
2783,12,144,29,80,94,0,1761.128,80,768.901,LESS,80,720,800,5,2,14,1.312371845,14,0.87303787,0.245037231,-0.427527664,174,80,94,1,0.279230385,0,0.546233592,1.958955502,-0.517313619,0.517313619,0.546233592,0,0,1,0
2784,12,145,55,110,98,1,2467.72,90,1252.951,LESS,2048,678,2726,3,2,-12,-1.124890153,12,0.523822722,0.760905085,0.348548374,208,110,98,0,0.957361319,1.170500555,0.702300333,0.359808153,2.589488617,2.589488617,0.702300333,1.170500555,1,1,1
2785,12,146,29,94,80,1,2671.93,90,603.417,LESS,974,656,1630,3,2,-14,-1.312371845,14,0.87303787,0.760905085,0.572839745,174,94,80,0,0.279230385,0.546233592,0,0.359808153,0.894008128,0.894008128,0,0.546233592,1,1,1
2786,12,147,57,110,94,0,1884.568,80,2078.634,LESS,676,656,1332,2,2,-16,-1.499853537,16,1.222253018,0.245037231,-0.291948962,204,110,94,0,0.877581209,1.170500555,0.546233592,-0.439765521,0.423567546,0.423567546,0.546233592,1.170500555,0,0,1
2787,12,148,39,80,66,1,2232.173,30,1256.239,LESS,-82,988,906,3,2,-14,-1.312371845,14,0.87303787,-2.33430204,0.089838422,146,80,66,0,-0.279230385,0,-0.546233592,0.359808153,-0.773056486,0.773056486,-0.546233592,0,0,0,0
2788,12,149,4,50,54,0,1105.443,60,572.646,LESS,-194,610,416,2,1,4,0.374963384,4,-0.87303787,-0.786698478,-1.147690667,104,50,54,1,-1.116921539,-1.170500555,-1.014433814,-0.439765521,-0.94986637,0.94986637,-1.014433814,-1.170500555,0,0,0
2789,12,150,55,98,110,0,3727.982,70,1186.579,LESS,-24,1598,1574,3,2,12,1.124890153,12,0.523822722,-0.270830623,1.732740582,208,98,110,1,0.957361319,0.702300333,1.170500555,0.359808153,-0.681494225,0.681494225,1.170500555,0.702300333,0,0,0
2790,12,151,2,50,52,0,1173.489,60,1458.409,LESS,-430,808,378,2,1,2,0.187481692,2,-1.222253018,-0.786698478,-1.072953238,102,50,52,1,-1.156811594,-1.170500555,-1.092467184,-0.439765521,-1.322430053,1.322430053,-1.092467184,-1.170500555,0,0,0
2791,12,152,59,110,89,1,2806.945,70,1113.046,LESS,698,974,1672,3,2,-21,-1.968557767,21,2.095290887,-0.270830623,0.721131696,199,110,89,0,0.777856072,1.170500555,0.351150166,0.359808153,0.458298059,0.458298059,0.351150166,1.170500555,0,0,1
2792,12,153,60,87,110,0,2102.418,80,624.232,LESS,136,1154,1290,3,2,23,2.15603946,23,2.444506035,0.245037231,-0.052676277,197,87,110,1,0.737966017,0.273116796,1.170500555,0.359808153,-0.428908678,0.428908678,1.170500555,0.273116796,0,1,0
2793,12,154,52,110,105,0,2204.227,80,699.248,LESS,226,1120,1346,2,2,-5,-0.46870423,5,-0.698430296,0.245037231,0.0591443,215,110,105,0,1.096976512,1.170500555,0.975417129,-0.439765521,-0.286829307,0.286829307,0.975417129,1.170500555,0,0,1
2794,12,155,30,80,96,0,1929.529,80,2096.966,LESS,504,684,1188,3,2,16,1.499853537,16,1.222253018,0.245037231,-0.242566638,176,80,96,1,0.31912044,0,0.624266962,0.359808153,0.152038082,0.152038082,0.624266962,0,0,0,1
2795,12,156,24,80,86,0,2294.689,70,2115.162,LESS,336,1046,1382,5,2,6,0.562445076,6,-0.523822722,-0.270830623,0.158502049,166,80,86,1,0.119670165,0,0.234100111,1.958955502,-0.113176743,0.113176743,0.234100111,0,0,1,1
2796,12,157,5,50,55,0,1277.845,100,1804.857,LESS,630,490,1120,2,2,5,0.46870423,5,-0.698430296,1.276772939,-0.958335196,105,50,55,1,-1.096976512,-1.170500555,-0.975417129,-0.439765521,0.350949201,0.350949201,-0.975417129,-1.170500555,1,0,1
2797,12,158,34,80,74,1,3445.291,90,1656.761,LESS,1462,1186,2648,5,2,-6,-0.562445076,6,-0.523822722,0.760905085,1.422250637,154,80,74,0,-0.119670165,0,-0.234100111,1.958955502,1.664394049,1.664394049,-0.234100111,0,1,1,1
2798,12,159,15,45,50,0,2538.566,90,1261.635,LESS,562,1396,1958,4,2,5,0.46870423,5,-0.698430296,0.760905085,0.426361148,95,45,50,1,-1.296426786,-1.36558398,-1.170500555,1.159381828,0.243600343,0.243600343,-1.170500555,-1.36558398,1,1,1
2799,12,160,37,69,80,0,2016.201,90,820.014,LESS,78,1032,1110,5,2,11,1.031149307,11,0.349215148,0.760905085,-0.147371586,149,69,80,1,-0.219395302,-0.429183537,0,1.958955502,-0.520470939,0.520470939,0,-0.429183537,1,1,0
2800,12,161,3,50,53,0,1246.182,90,2200.392,MORE,-818,1234,416,1,2,3,0.281222538,3,-1.047645444,0.760905085,-0.993111836,103,50,53,0,-1.136866566,-1.170500555,-1.053450499,-1.239339195,-1.934950006,1.934950006,-1.053450499,-1.170500555,1,0,0
2801,12,162,20,50,40,1,2715.792,100,848.732,MORE,644,984,1628,3,2,-10,-0.937408461,10,0.174607574,1.276772939,0.621014996,90,50,40,1,-1.396151924,-1.170500555,-1.560667406,0.359808153,0.373050436,0.373050436,-1.560667406,-1.170500555,1,1,0
2802,12,163,25,80,88,1,1603.725,90,1023.181,MORE,1626,372,1998,1,2,8,0.749926769,8,-0.174607574,0.760905085,-0.60040918,168,80,88,0,0.15956022,0,0.312133481,-1.239339195,1.923294235,1.923294235,0.312133481,0,1,0,1
2803,12,164,42,115,110,1,3490.857,80,2275.406,MORE,1038,1518,2556,6,2,-5,-0.46870423,5,-0.698430296,0.245037231,1.472297454,225,115,110,1,1.296426786,1.36558398,1.170500555,2.758529177,0.995042347,0.995042347,1.170500555,1.36558398,0,1,1
2804,12,165,53,103,110,1,2474.318,100,1380.717,MORE,1316,606,1922,2,2,7,0.656185922,7,-0.349215148,1.276772939,0.355795201,213,103,110,0,1.057086457,0.897383758,1.170500555,-0.439765521,1.433909737,1.433909737,1.170500555,0.897383758,1,0,1
2805,12,166,26,90,80,0,3312.936,50,1119.404,MORE,328,1254,1582,5,2,-10,-0.937408461,10,0.174607574,-1.302566332,1.276880262,170,90,80,1,0.199450275,0.390166852,0,1.958955502,-0.12580602,0.12580602,0,0.390166852,0,1,0
2806,12,167,35,80,72,1,2107.919,70,1719.5,MORE,928,622,1550,3,2,-8,-0.749926769,8,-0.174607574,-0.270830623,-0.046634326,152,80,72,1,-0.15956022,0,-0.312133481,0.359808153,0.821389783,0.821389783,-0.312133481,0,0,1,1
2807,12,168,28,93,80,0,1611.534,90,1774.256,MORE,610,906,1516,3,2,-13,-1.218630999,13,0.698430296,0.760905085,-0.591832268,173,93,80,1,0.259285357,0.507216907,0,0.359808153,0.319376007,0.319376007,0,0.507216907,1,1,0
2808,12,169,26,80,90,1,1120.909,90,1608.675,MORE,1492,214,1706,1,2,10,0.937408461,10,0.174607574,0.760905085,-1.13070379,170,80,90,0,0.199450275,0,0.390166852,-1.239339195,1.711753839,1.711753839,0.390166852,0,1,0,1
2809,12,170,25,88,80,0,1756.347,90,1752.424,MORE,38,796,834,1,2,-8,-0.749926769,8,-0.174607574,0.760905085,-0.432778812,168,88,80,1,0.15956022,0.312133481,0,-1.239339195,-0.583617326,0.583617326,0,0.312133481,1,0,0
2810,12,171,36,80,70,1,1201.742,90,860.75,MORE,958,210,1168,1,2,-10,-0.937408461,10,0.174607574,0.760905085,-1.041921926,150,80,70,1,-0.199450275,0,-0.390166852,-1.239339195,0.868749574,0.868749574,-0.390166852,0,1,0,1
2811,12,172,28,80,93,1,1355.249,90,576.539,MORE,884,320,1204,1,2,13,1.218630999,13,0.698430296,0.760905085,-0.87331953,173,80,93,0,0.259285357,0,0.507216907,-1.239339195,0.751928758,0.751928758,0.507216907,0,1,0,1
2812,12,173,21,82,80,1,1976.005,90,1092.912,MORE,1456,380,1836,1,2,-2,-0.187481692,2,-1.222253018,0.760905085,-0.191520334,162,82,80,1,0.039890055,0.07803337,0,-1.239339195,1.654922091,1.654922091,0,0.07803337,1,0,1
2813,12,174,19,50,41,0,3158.077,90,660.894,MORE,20,1548,1568,5,2,-9,-0.843667615,9,0,0.760905085,1.106792914,91,50,41,1,-1.376206896,-1.170500555,-1.521650721,1.958955502,-0.6120332,0.6120332,-1.521650721,-1.170500555,1,1,0
2814,12,175,56,96,110,1,1300.309,80,808.134,MORE,1102,304,1406,1,2,14,1.312371845,14,0.87303787,0.245037231,-0.933662157,206,96,110,0,0.917471264,0.624266962,1.170500555,-1.239339195,1.096076567,1.096076567,1.170500555,0.624266962,1,0,1
2815,12,176,23,80,85,1,1160.845,90,690.685,MORE,956,200,1156,1,2,5,0.46870423,5,-0.698430296,0.760905085,-1.086840609,165,80,85,0,0.099725137,0,0.195083426,-1.239339195,0.865592254,0.865592254,0.195083426,0,1,0,1
2816,12,177,10,60,50,0,1980.262,90,932.531,MORE,288,846,1134,2,2,-10,-0.937408461,10,0.174607574,0.760905085,-0.186844714,110,60,50,1,-0.997251374,-0.780333703,-1.170500555,-0.439765521,-0.188952407,0.188952407,-1.170500555,-0.780333703,1,1,0
2817,12,178,19,41,50,1,1208.765,80,1333.45,MORE,1172,316,1488,1,2,9,0.843667615,9,0,0.245037231,-1.034208306,91,41,50,0,-1.376206896,-1.521650721,-1.170500555,-1.239339195,1.206582744,1.206582744,-1.170500555,-1.521650721,0,0,1
2818,12,179,56,110,96,0,1475.131,90,964.467,MORE,-136,806,670,3,2,-14,-1.312371845,14,0.87303787,0.760905085,-0.741648711,206,110,96,1,0.917471264,1.170500555,0.624266962,0.359808153,-0.858304109,0.858304109,0.624266962,1.170500555,1,1,0
2819,12,180,35,72,80,1,1204.252,80,849.868,MORE,1460,206,1666,1,2,8,0.749926769,8,-0.174607574,0.245037231,-1.039165101,152,72,80,0,-0.15956022,-0.312133481,0,-1.239339195,1.66123673,1.66123673,0,-0.312133481,0,0,1
2820,12,181,11,49,50,0,1540.564,80,1362.181,MORE,434,1062,1496,3,2,1,0.093740846,1,-1.396860592,0.245037231,-0.669781235,99,49,50,0,-1.216646676,-1.20951724,-1.170500555,0.359808153,0.041531905,0.041531905,-1.170500555,-1.20951724,0,1,0
2821,12,182,17,43,50,1,2375.858,70,1392.776,MORE,834,794,1628,3,2,7,0.656185922,7,-0.349215148,-0.270830623,0.247652954,93,43,50,0,-1.336316841,-1.443617351,-1.170500555,0.359808153,0.672995774,0.672995774,-1.170500555,-1.443617351,0,1,1
2822,12,183,1,51,50,1,3069.247,100,1362.978,MORE,1040,1350,2390,3,2,-1,-0.093740846,1,-1.396860592,1.276772939,1.009227651,101,51,50,1,-1.176756621,-1.131483869,-1.170500555,0.359808153,0.998199667,0.998199667,-1.170500555,-1.131483869,1,1,1
2823,12,184,41,112,110,1,3198.568,70,1153.218,MORE,450,1182,1632,4,2,-2,-0.187481692,2,-1.222253018,-0.270830623,1.151265672,222,112,110,1,1.236591704,1.248533925,1.170500555,1.159381828,0.06679046,0.06679046,1.170500555,1.248533925,0,1,0
2824,12,185,20,40,50,1,1931.763,70,983.552,MORE,480,602,1082,3,2,10,0.937408461,10,0.174607574,-0.270830623,-0.240112954,90,40,50,0,-1.396151924,-1.560667406,-1.170500555,0.359808153,0.11415025,0.11415025,-1.170500555,-1.560667406,0,1,0
2825,12,186,1,50,51,1,1189.781,80,1302.335,MORE,1074,250,1324,1,2,1,0.093740846,1,-1.396860592,0.245037231,-1.055059133,101,50,51,0,-1.176756621,-1.170500555,-1.131483869,-1.239339195,1.051874096,1.051874096,-1.131483869,-1.170500555,1,0,1
2826,12,187,23,85,80,0,3198.531,90,652.972,MORE,138,1584,1722,4,2,-5,-0.46870423,5,-0.698430296,0.760905085,1.151225033,165,85,80,1,0.099725137,0.195083426,0,1.159381828,-0.425751358,0.425751358,0,0.195083426,1,1,0
2827,12,188,11,50,49,1,1332.856,80,1617.416,MORE,1190,266,1456,1,2,-1,-0.093740846,1,-1.396860592,0.245037231,-0.897914587,99,50,49,1,-1.216646676,-1.170500555,-1.20951724,-1.239339195,1.234998618,1.234998618,-1.20951724,-1.170500555,1,0,1
2828,12,189,17,50,43,1,2105.839,80,1180.186,MORE,1022,722,1744,3,2,-7,-0.656185922,7,-0.349215148,0.245037231,-0.048918867,93,50,43,1,-1.336316841,-1.170500555,-1.443617351,0.359808153,0.969783793,0.969783793,-1.443617351,-1.170500555,1,1,1
2829,12,190,21,80,82,1,2128.659,80,2000.424,MORE,1520,724,2244,3,2,2,0.187481692,2,-1.222253018,0.245037231,-0.023854819,162,80,82,0,0.039890055,0,0.07803337,0.359808153,1.75595631,1.75595631,0.07803337,0,1,1,1
2830,12,191,10,50,60,1,1234.054,80,1222.164,MORE,1258,362,1620,1,2,10,0.937408461,10,0.174607574,0.245037231,-1.006432466,110,50,60,0,-0.997251374,-1.170500555,-0.780333703,-1.239339195,1.342347476,1.342347476,-0.780333703,-1.170500555,1,0,1
2831,12,192,3,53,50,1,1231.836,80,1756.383,MORE,796,366,1162,1,2,-3,-0.281222538,3,-1.047645444,0.245037231,-1.008868577,103,53,50,1,-1.136866566,-1.053450499,-1.170500555,-1.239339195,0.613006707,0.613006707,-1.170500555,-1.053450499,0,0,1
2832,12,193,45,122,110,1,2939.993,80,1027.246,MORE,476,1382,1858,3,2,-12,-1.124890153,12,0.523822722,0.245037231,0.867263218,232,122,110,1,1.436041979,1.638700776,1.170500555,0.359808153,0.107835611,0.107835611,1.170500555,1.638700776,1,1,0
2833,12,194,38,67,80,1,1417.895,80,2046.029,MORE,1212,256,1468,1,2,13,1.218630999,13,0.698430296,0.245037231,-0.804513119,147,67,80,0,-0.259285357,-0.507216907,0,-1.239339195,1.269729131,1.269729131,0,-0.507216907,0,0,1
2834,12,195,38,80,67,1,1590.047,50,1031.149,MORE,724,266,990,1,2,-13,-1.218630999,13,0.698430296,-1.302566332,-0.615432232,147,80,67,1,-0.259285357,0,-0.507216907,-1.239339195,0.49934321,0.49934321,-0.507216907,0,0,0,1
2835,12,196,36,70,80,1,1628.809,100,1549.63,MORE,1116,604,1720,3,2,10,0.937408461,10,0.174607574,1.276772939,-0.572858499,150,70,80,0,-0.199450275,-0.390166852,0,0.359808153,1.118177802,1.118177802,0,-0.390166852,1,1,1
2836,12,197,45,110,122,1,1363.523,100,575.852,MORE,1240,226,1466,1,2,12,1.124890153,12,0.523822722,1.276772939,-0.864231891,232,110,122,0,1.436041979,1.170500555,1.638700776,-1.239339195,1.313931601,1.313931601,1.638700776,1.170500555,1,0,1
2837,12,198,42,110,115,1,1978.787,100,761.005,MORE,1052,676,1728,3,2,5,0.46870423,5,-0.698430296,1.276772939,-0.188464761,225,110,115,0,1.296426786,1.170500555,1.36558398,0.359808153,1.017143583,1.017143583,1.36558398,1.170500555,1,1,1
2838,12,199,41,110,112,1,1261.728,90,2059.158,MORE,1788,304,2092,1,2,2,0.187481692,2,-1.222253018,0.760905085,-0.976037091,222,110,112,0,1.236591704,1.170500555,1.248533925,-1.239339195,2.179037102,2.179037102,1.248533925,1.170500555,1,0,1
2839,12,200,53,110,103,0,2846.988,50,1533.798,MORE,-238,1422,1184,4,1,-7,-0.656185922,7,-0.349215148,-1.302566332,0.765112399,213,110,103,1,1.057086457,1.170500555,0.897383758,1.159381828,-1.019327395,1.019327395,0.897383758,1.170500555,0,1,0
2840,12,201,3,50,53,0,1864.1,90,1026.084,LESS,-22,1054,1032,2,2,3,0.281222538,3,-1.047645444,0.760905085,-0.314429721,103,50,53,1,-1.136866566,-1.170500555,-1.053450499,-0.439765521,-0.678336906,0.678336906,-1.053450499,-1.170500555,1,0,0
2841,12,202,20,50,40,0,2652.956,40,760.751,LESS,-220,1296,1076,5,2,-10,-0.937408461,10,0.174607574,-1.818434186,0.551999901,90,50,40,0,-1.396151924,-1.170500555,-1.560667406,1.958955502,-0.990911521,0.990911521,-1.560667406,-1.170500555,0,1,0
2842,12,203,25,80,88,0,2208.343,90,695.596,LESS,98,1146,1244,5,2,8,0.749926769,8,-0.174607574,0.760905085,0.063665055,168,80,88,1,0.15956022,0,0.312133481,1.958955502,-0.488897745,0.488897745,0.312133481,0,1,1,0
2843,12,204,42,115,110,0,3470.655,90,1271.269,LESS,-150,2120,1970,5,2,-5,-0.46870423,5,-0.698430296,0.760905085,1.450108853,225,115,110,0,1.296426786,1.36558398,1.170500555,1.958955502,-0.880405344,0.880405344,1.170500555,1.36558398,1,1,0
2844,12,205,53,103,110,0,1891.715,80,1737.183,LESS,220,1152,1372,2,2,7,0.656185922,7,-0.349215148,0.245037231,-0.284099148,213,103,110,1,1.057086457,0.897383758,1.170500555,-0.439765521,-0.296301265,0.296301265,1.170500555,0.897383758,0,0,1
2845,12,206,26,90,80,0,1603.93,90,1502.117,LESS,-378,1358,980,2,2,-10,-0.937408461,10,0.174607574,0.760905085,-0.600184021,170,90,80,0,0.199450275,0.390166852,0,-0.439765521,-1.24033975,1.24033975,0,0.390166852,1,0,0
2846,12,207,35,80,72,0,1766.97,90,787.8,LESS,-772,1430,658,2,2,-8,-0.749926769,8,-0.174607574,0.760905085,-0.42111118,152,80,72,0,-0.15956022,0,-0.312133481,-0.439765521,-1.862331661,1.862331661,-0.312133481,0,1,0,0
2847,12,208,28,93,80,1,3594.639,90,1170.223,LESS,1224,1384,2608,5,2,-13,-1.218630999,13,0.698430296,0.760905085,1.58628505,173,93,80,0,0.259285357,0.507216907,0,1.958955502,1.288673047,1.288673047,0,0.507216907,1,1,1
2848,12,209,26,80,90,0,1325.091,100,2668.485,LESS,770,906,1676,2,2,10,0.937408461,10,0.174607574,1.276772939,-0.906443173,170,80,90,1,0.199450275,0,0.390166852,-0.439765521,0.571961555,0.571961555,0.390166852,0,1,0,1
2849,12,210,25,88,80,0,1278.315,100,1069.163,LESS,192,748,940,3,2,-8,-0.749926769,8,-0.174607574,1.276772939,-0.957818978,168,88,80,0,0.15956022,0.312133481,0,0.359808153,-0.340503736,0.340503736,0,0.312133481,1,0,1
2850,12,211,36,80,70,1,3239.257,90,1355.211,LESS,562,1532,2094,5,2,-10,-0.937408461,10,0.174607574,0.760905085,1.1959559,150,80,70,0,-0.199450275,0,-0.390166852,1.958955502,0.243600343,0.243600343,-0.390166852,0,1,1,1
2851,12,212,28,80,93,0,1261.593,90,1192.847,LESS,-60,718,658,3,2,13,1.218630999,13,0.698430296,0.760905085,-0.976185367,173,80,93,1,0.259285357,0,0.507216907,0.359808153,-0.738325974,0.738325974,0.507216907,0,1,1,0
2852,12,213,21,82,80,0,1838.701,50,646.871,LESS,-298,838,540,3,2,-2,-0.187481692,2,-1.222253018,-1.302566332,-0.342326379,162,82,80,0,0.039890055,0.07803337,0,0.359808153,-1.114046976,1.114046976,0,0.07803337,0,0,0
2853,12,214,19,50,41,1,1856.837,10,1572.058,LESS,72,836,908,3,1,-9,-0.843667615,9,0,-3.366037748,-0.322406941,91,50,41,0,-1.376206896,-1.170500555,-1.521650721,0.359808153,-0.529942897,0.529942897,-1.521650721,-1.170500555,0,1,0
2854,12,215,56,96,110,0,2209.429,40,1035.442,LESS,-516,1108,592,2,1,14,1.312371845,14,0.87303787,-1.818434186,0.064857849,206,96,110,1,0.917471264,0.624266962,1.170500555,-0.439765521,-1.458194785,1.458194785,1.170500555,0.624266962,0,0,0
2855,12,216,23,80,85,0,1270.56,30,735.149,LESS,-192,592,400,2,1,5,0.46870423,5,-0.698430296,-2.33430204,-0.96633658,165,80,85,1,0.099725137,0,0.195083426,-0.439765521,-0.94670905,0.94670905,0.195083426,0,0,0,0
2856,12,217,10,60,50,0,1256.982,20,1017.65,LESS,-366,776,410,2,1,-10,-0.937408461,10,0.174607574,-2.850169894,-0.981249798,110,60,50,0,-0.997251374,-0.780333703,-1.170500555,-0.439765521,-1.221395834,1.221395834,-1.170500555,-0.780333703,0,0,0
2857,12,218,19,41,50,0,1452.656,20,1013.245,LESS,-476,862,386,2,1,9,0.843667615,9,0,-2.850169894,-0.766333831,91,41,50,1,-1.376206896,-1.521650721,-1.170500555,-0.439765521,-1.395048398,1.395048398,-1.170500555,-1.521650721,0,0,0
2858,12,219,56,110,96,1,2016.06,20,897.819,LESS,860,402,1262,1,2,-14,-1.312371845,14,0.87303787,-2.850169894,-0.147526451,206,110,96,0,0.917471264,1.170500555,0.624266962,-1.239339195,0.714040926,0.714040926,0.624266962,1.170500555,0,0,1
2859,12,220,35,72,80,0,1395.569,10,976.476,LESS,-1032,1466,434,2,1,8,0.749926769,8,-0.174607574,-3.366037748,-0.829034588,152,72,80,1,-0.15956022,-0.312133481,0,-0.439765521,-2.272783176,2.272783176,0,-0.312133481,0,0,0
2860,12,221,11,49,50,0,1502.532,90,895.548,LESS,-42,906,864,2,2,1,0.093740846,1,-1.396860592,0.760905085,-0.711553182,99,49,50,1,-1.216646676,-1.20951724,-1.170500555,-0.439765521,-0.7099101,0.7099101,-1.170500555,-1.20951724,1,0,0
2861,12,222,17,43,50,0,1211.473,50,758.336,LESS,-318,702,384,2,1,7,0.656185922,7,-0.349215148,-1.302566332,-1.03123401,93,43,50,1,-1.336316841,-1.443617351,-1.170500555,-0.439765521,-1.145620169,1.145620169,-1.170500555,-1.443617351,0,0,0
2862,12,223,1,51,50,0,1307.368,40,1106.567,LESS,-410,804,394,2,1,-1,-0.093740846,1,-1.396860592,-1.818434186,-0.925908997,101,51,50,0,-1.176756621,-1.131483869,-1.170500555,-0.439765521,-1.290856859,1.290856859,-1.170500555,-1.131483869,0,0,0
2863,12,224,41,112,110,1,2329.4,10,885.102,LESS,186,1110,1296,3,1,-2,-0.187481692,2,-1.222253018,-3.366037748,0.19662642,222,112,110,0,1.236591704,1.248533925,1.170500555,0.359808153,-0.349975694,0.349975694,1.170500555,1.248533925,0,0,1
2864,12,225,20,40,50,0,1350.66,30,1293.637,LESS,-590,888,298,2,1,10,0.937408461,10,0.174607574,-2.33430204,-0.878359798,90,40,50,1,-1.396151924,-1.560667406,-1.170500555,-0.439765521,-1.5750156,1.5750156,-1.170500555,-1.560667406,0,0,0
2865,12,226,1,50,51,0,1188.06,20,1002.733,LESS,-358,702,344,2,1,1,0.093740846,1,-1.396860592,-2.850169894,-1.056949371,101,50,51,1,-1.176756621,-1.170500555,-1.131483869,-0.439765521,-1.208766556,1.208766556,-1.131483869,-1.170500555,0,0,0
2866,12,227,23,85,80,1,1724.176,30,1544.666,LESS,608,574,1182,3,2,-5,-0.46870423,5,-0.698430296,-2.33430204,-0.468113407,165,85,80,0,0.099725137,0.195083426,0,0.359808153,0.316218688,0.316218688,0,0.195083426,0,0,1
2867,12,228,11,50,49,0,1287.188,30,868.077,LESS,-330,704,374,2,1,-1,-0.093740846,1,-1.396860592,-2.33430204,-0.948073435,99,50,49,0,-1.216646676,-1.170500555,-1.20951724,-0.439765521,-1.164564085,1.164564085,-1.20951724,-1.170500555,0,0,0
2868,12,229,17,50,43,0,1480.752,20,732.068,LESS,-706,1110,404,2,1,-7,-0.656185922,7,-0.349215148,-2.850169894,-0.735474959,93,50,43,0,-1.336316841,-1.170500555,-1.443617351,-0.439765521,-1.758140122,1.758140122,-1.443617351,-1.170500555,0,0,0
2869,12,230,21,80,82,0,1532.6,30,1002.641,LESS,-526,1016,490,2,1,2,0.187481692,2,-1.222253018,-2.33430204,-0.67852839,162,80,82,1,0.039890055,0,0.07803337,-0.439765521,-1.473981381,1.473981381,0.07803337,0,0,0,0
2870,12,231,10,50,60,0,1978.654,90,796.607,LESS,-322,1266,944,4,2,10,0.937408461,10,0.174607574,0.760905085,-0.18861084,110,50,60,1,-0.997251374,-1.170500555,-0.780333703,1.159381828,-1.151934808,1.151934808,-0.780333703,-1.170500555,1,1,0
2871,12,232,3,53,50,1,1926.633,90,2387.067,LESS,490,1080,1570,3,2,-3,-0.281222538,3,-1.047645444,0.760905085,-0.245747422,103,53,50,0,-1.136866566,-1.053450499,-1.170500555,0.359808153,0.129936847,0.129936847,-1.170500555,-1.053450499,1,0,1
2872,12,233,45,122,110,1,2075.389,80,1043.763,LESS,872,666,1538,3,2,-12,-1.124890153,12,0.523822722,0.245037231,-0.082363224,232,122,110,0,1.436041979,1.638700776,1.170500555,0.359808153,0.732984842,0.732984842,1.170500555,1.638700776,0,0,1
2873,12,234,38,67,80,0,1205.748,90,1161.765,LESS,-94,670,576,2,2,13,1.218630999,13,0.698430296,0.760905085,-1.037521989,147,67,80,1,-0.259285357,-0.507216907,0,-0.439765521,-0.792000403,0.792000403,0,-0.507216907,1,0,0
2874,12,235,38,80,67,0,1598.612,90,1247.384,LESS,170,988,1158,3,2,-13,-1.218630999,13,0.698430296,0.760905085,-0.606024977,147,80,67,0,-0.259285357,0,-0.507216907,0.359808153,-0.375234249,0.375234249,-0.507216907,0,1,0,1
2875,12,236,36,70,80,0,1185.141,90,594.812,LESS,194,690,884,3,2,10,0.937408461,10,0.174607574,0.760905085,-1.060155416,150,70,80,1,-0.199450275,-0.390166852,0,0.359808153,-0.337346417,0.337346417,0,-0.390166852,1,0,1
2876,12,237,45,110,122,1,1761.099,10,1422.294,LESS,288,674,962,3,2,12,1.124890153,12,0.523822722,-3.366037748,-0.427559516,232,110,122,1,1.436041979,1.170500555,1.638700776,0.359808153,-0.188952407,0.188952407,1.638700776,1.170500555,0,0,1
2877,12,238,42,110,115,1,1941.056,0,1203.727,LESS,-4,1082,1078,3,1,5,0.46870423,5,-0.698430296,-3.881905603,-0.229906109,225,110,115,1,1.296426786,1.170500555,1.36558398,0.359808153,-0.649921032,0.649921032,1.36558398,1.170500555,0,0,0
2878,12,239,41,110,112,0,2288.716,90,597.412,LESS,-558,1522,964,3,2,2,0.187481692,2,-1.222253018,0.760905085,0.151941683,222,110,112,1,1.236591704,1.170500555,1.248533925,0.359808153,-1.524498491,1.524498491,1.248533925,1.170500555,1,1,0
2879,12,240,53,110,103,0,1670.329,100,1109.301,LESS,-548,1124,576,3,2,-7,-0.656185922,7,-0.349215148,1.276772939,-0.527255552,213,110,103,0,1.057086457,1.170500555,0.897383758,0.359808153,-1.508711894,1.508711894,0.897383758,1.170500555,1,1,0
2880,13,1,49,110,131,0,4071.551,54,1888.253,LESS,-130,2028,1898,3,2,21,1.968557767,21,2.095290887,-0.555869993,-1.4096712,241,110,131,1,1.615547226,1.170500555,1.989850943,0.470175924,-0.193327141,0.193327141,1.989850943,1.170500555,0,1,0
2881,13,2,13,47,50,0,3803.34,74,1491.027,LESS,232,2012,2244,2,2,3,0.281222538,3,-1.047645444,0.745679259,-1.728721046,97,47,50,1,-1.256536731,-1.28755061,-1.170500555,-0.922937925,0.207614853,0.207614853,-1.170500555,-1.28755061,1,0,1
2882,13,3,16,50,44,0,5355.137,34,3144.64,LESS,-370,2902,2532,4,2,-6,-0.562445076,6,-0.523822722,-1.857419244,0.117215899,94,50,44,0,-1.316371814,-1.170500555,-1.404600665,1.863289774,-0.459145039,0.459145039,-1.404600665,-1.170500555,0,1,0
2883,13,4,7,57,50,1,5200.359,54,2735.857,LESS,1058,1680,2738,3,1,-7,-0.656185922,7,-0.349215148,-0.555869993,-0.066899954,107,57,50,0,-1.057086457,-0.897383758,-1.170500555,0.470175924,1.122471449,1.122471449,-1.170500555,-0.897383758,0,1,1
2884,13,5,18,42,50,0,4265.177,84,2626.896,LESS,-90,2472,2382,2,2,8,0.749926769,8,-0.174607574,1.396453885,-1.179343788,92,42,50,1,-1.356261869,-1.482634036,-1.170500555,-0.922937925,-0.149024159,0.149024159,-1.170500555,-1.482634036,1,0,0
2885,13,6,51,108,110,0,5453.819,44,2430.293,LESS,1410,2268,3678,4,2,2,0.187481692,2,-1.222253018,-1.206644619,0.23460287,218,108,110,1,1.156811594,1.092467184,1.170500555,1.863289774,1.512337699,1.512337699,1.170500555,1.092467184,0,1,1
2886,13,7,31,78,80,0,5005.561,64,1461.659,LESS,464,1684,2148,2,1,2,0.187481692,2,-1.222253018,0.094904633,-0.298621516,158,78,80,1,-0.039890055,-0.07803337,0,-0.922937925,0.464572154,0.464572154,0,-0.07803337,1,0,1
2887,13,8,58,110,92,1,3920.254,64,1901.748,LESS,104,1636,1740,3,2,-18,-1.687335229,18,1.571468165,0.094904633,-1.589646236,202,110,92,0,0.837691154,1.170500555,0.468200222,0.470175924,0.065845308,0.065845308,0.468200222,1.170500555,1,1,1
2888,13,9,12,50,48,1,6348.57,64,1644.935,LESS,890,2780,3670,3,2,-2,-0.187481692,2,-1.222253018,0.094904633,1.298952091,98,50,48,0,-1.236591704,-1.170500555,-1.248533925,0.470175924,0.936398921,0.936398921,-1.248533925,-1.170500555,1,1,1
2889,13,10,54,110,101,1,6490.011,34,1500.315,LESS,-24,2796,2772,3,2,-9,-0.843667615,9,0,-1.857419244,1.467202943,211,110,101,0,1.017196402,1.170500555,0.819350388,0.470175924,-0.075924237,0.075924237,0.819350388,1.170500555,0,1,0
2890,13,11,14,46,50,0,4763.616,84,2494.497,LESS,630,1924,2554,1,2,4,0.374963384,4,-0.87303787,1.396453885,-0.586426696,96,46,50,1,-1.276481759,-1.326567295,-1.170500555,-2.316051775,0.648429533,0.648429533,-1.170500555,-1.326567295,1,0,1
2891,13,12,22,80,83,1,5934.737,64,2153.502,LESS,274,2196,2470,3,2,3,0.281222538,3,-1.047645444,0.094904633,0.806677893,163,80,83,1,0.059835082,0,0.117050055,0.470175924,0.254132985,0.254132985,0.117050055,0,0,1,1
2892,13,13,6,50,56,0,5205.076,64,1705.179,LESS,284,2066,2350,3,2,6,0.562445076,6,-0.523822722,0.094904633,-0.061288856,106,50,56,1,-1.077031484,-1.170500555,-0.936400444,0.470175924,0.265208731,0.265208731,-0.936400444,-1.170500555,0,1,1
2893,13,14,13,50,47,1,4810.081,44,1595.853,LESS,680,1656,2336,3,2,-3,-0.281222538,3,-1.047645444,-1.206644619,-0.53115435,97,50,47,0,-1.256536731,-1.170500555,-1.28755061,0.470175924,0.703808261,0.703808261,-1.28755061,-1.170500555,0,1,1
2894,13,15,46,110,124,0,5431.334,64,987.979,LESS,-1086,2894,1808,4,2,14,1.312371845,14,0.87303787,0.094904633,0.207855885,234,110,124,1,1.475932034,1.170500555,1.716734147,1.863289774,-1.252168432,1.252168432,1.716734147,1.170500555,0,1,0
2895,13,16,27,91,80,0,6128.27,34,1788,LESS,-244,2778,2534,4,2,-11,-1.031149307,11,0.349215148,-1.857419244,1.036894677,171,91,80,0,0.219395302,0.429183537,0,1.863289774,-0.319590643,0.319590643,0,0.429183537,0,1,0
2896,13,17,40,64,80,0,4469.657,74,1308.495,LESS,642,1734,2376,2,2,16,1.499853537,16,1.222253018,0.745679259,-0.936105022,144,64,80,1,-0.31912044,-0.624266962,0,-0.922937925,0.661720428,0.661720428,0,-0.624266962,1,0,1
2897,13,18,22,83,80,0,5740.029,64,1603.428,LESS,1478,2134,3612,3,2,-3,-0.281222538,3,-1.047645444,0.094904633,0.57506339,163,83,80,0,0.059835082,0.117050055,0,0.470175924,1.587652769,1.587652769,0,0.117050055,0,1,1
2898,13,19,54,101,110,1,5992.316,34,1535.374,LESS,-558,2824,2266,3,2,9,0.843667615,9,0,-1.857419244,0.875170875,211,101,110,1,1.017196402,0.819350388,1.170500555,0.470175924,-0.667369058,0.667369058,1.170500555,0.819350388,0,1,0
2899,13,20,6,56,50,1,5097.172,94,496.407,LESS,550,1910,2460,3,2,-6,-0.562445076,6,-0.523822722,2.04722851,-0.189645838,106,56,50,0,-1.077031484,-0.936400444,-1.170500555,0.470175924,0.559823567,0.559823567,-1.170500555,-0.936400444,1,1,1
2900,13,21,18,50,42,1,4768.77,54,1996.437,LESS,570,2064,2634,3,2,-8,-0.749926769,8,-0.174607574,-0.555869993,-0.580295765,92,50,42,0,-1.356261869,-1.170500555,-1.482634036,0.470175924,0.581975059,0.581975059,-1.482634036,-1.170500555,0,1,1
2901,13,22,43,110,117,1,6163.882,34,1535.565,LESS,-578,3050,2472,3,2,7,0.656185922,7,-0.349215148,-1.857419244,1.079256859,227,110,117,1,1.336316841,1.170500555,1.443617351,0.470175924,-0.689520549,0.689520549,1.443617351,1.170500555,0,1,0
2902,13,23,32,77,80,0,5691.348,64,2195.088,LESS,-136,2556,2420,3,1,3,0.281222538,3,-1.047645444,0.094904633,0.517155006,157,77,80,1,-0.059835082,-0.117050055,0,0.470175924,-0.199972589,0.199972589,0,-0.117050055,0,1,0
2903,13,24,27,80,91,0,5221.368,84,2307.743,LESS,516,2404,2920,3,2,11,1.031149307,11,0.349215148,1.396453885,-0.041908741,171,80,91,1,0.219395302,0,0.429183537,0.470175924,0.522166032,0.522166032,0.429183537,0,1,1,1
2904,13,25,16,44,50,0,4817.055,94,1746.209,LESS,524,2468,2992,2,2,6,0.562445076,6,-0.523822722,2.04722851,-0.522858442,94,44,50,1,-1.316371814,-1.404600665,-1.170500555,-0.922937925,0.531026628,0.531026628,-1.170500555,-1.404600665,1,0,1
2905,13,26,7,50,57,0,6344.612,74,2135.109,LESS,-992,3684,2692,4,2,7,0.656185922,7,-0.349215148,0.745679259,1.29424386,107,50,57,1,-1.057086457,-1.170500555,-0.897383758,1.863289774,-1.148056422,1.148056422,-0.897383758,-1.170500555,1,1,0
2906,13,27,14,50,46,1,5554.286,94,1670.851,LESS,1920,2264,4184,3,2,-4,-0.374963384,4,-0.87303787,2.04722851,0.354113185,96,50,46,0,-1.276481759,-1.170500555,-1.326567295,0.470175924,2.07720073,2.07720073,-1.326567295,-1.170500555,1,1,1
2907,13,28,51,110,108,1,6319.595,44,2476.061,LESS,-622,3330,2708,3,2,-2,-0.187481692,2,-1.222253018,-1.206644619,1.264484939,218,110,108,0,1.156811594,1.170500555,1.092467184,0.470175924,-0.738253831,0.738253831,1.092467184,1.170500555,0,1,0
2908,13,29,50,133,110,0,5996.478,34,1416.059,LESS,-1438,3364,1926,3,1,-23,-2.15603946,23,2.444506035,-1.857419244,0.880121773,243,133,110,0,1.655437281,2.067884313,1.170500555,0.470175924,-1.642034681,1.642034681,1.170500555,2.067884313,0,1,0
2909,13,30,49,131,110,1,4910.072,84,1948.192,LESS,1672,2010,3682,2,2,-21,-1.968557767,21,2.095290887,1.396453885,-0.412210261,241,131,110,0,1.615547226,1.989850943,1.170500555,-0.922937925,1.802522236,1.802522236,1.170500555,1.989850943,1,0,1
2910,13,31,47,126,110,1,6431.187,74,2498.042,LESS,1180,2972,4152,3,2,-16,-1.499853537,16,1.222253018,0.745679259,1.397228974,236,126,110,0,1.515822089,1.794767517,1.170500555,0.470175924,1.257595547,1.257595547,1.170500555,1.794767517,1,1,1
2911,13,32,50,110,133,0,6390.944,74,1497.565,LESS,-190,2844,2654,3,2,23,2.15603946,23,2.444506035,0.745679259,1.349357996,243,110,133,1,1.655437281,1.170500555,2.067884313,0.470175924,-0.259781616,0.259781616,2.067884313,1.170500555,1,1,0
2912,13,33,47,110,126,0,6172.81,94,1117.015,LESS,406,2906,3312,1,2,16,1.499853537,16,1.222253018,2.04722851,1.089877143,236,110,126,1,1.515822089,1.170500555,1.794767517,-2.316051775,0.400332829,0.400332829,1.794767517,1.170500555,1,0,1
2913,13,34,12,48,50,1,5447.255,74,2500.551,LESS,2016,2218,4234,3,2,2,0.187481692,2,-1.222253018,0.745679259,0.226794678,98,48,50,1,-1.236591704,-1.248533925,-1.170500555,0.470175924,2.183527889,2.183527889,-1.170500555,-1.248533925,1,1,1
2914,13,35,32,80,77,0,4500.988,34,2182.949,LESS,998,1674,2672,1,2,-3,-0.281222538,3,-1.047645444,-1.857419244,-0.898835295,157,80,77,0,-0.059835082,0,-0.117050055,-2.316051775,1.056016975,1.056016975,-0.117050055,0,0,0,1
2915,13,36,43,117,110,0,5599.001,44,1765.564,LESS,-640,2762,2122,4,1,-7,-0.656185922,7,-0.349215148,-1.206644619,0.407303821,227,117,110,0,1.336316841,1.443617351,1.170500555,1.863289774,-0.758190173,0.758190173,1.170500555,1.443617351,0,1,0
2916,13,37,40,80,64,1,4918.652,74,1881.549,LESS,746,2096,2842,3,2,-16,-1.499853537,16,1.222253018,0.745679259,-0.402003939,144,80,64,0,-0.31912044,0,-0.624266962,0.470175924,0.776908183,0.776908183,-0.624266962,0,1,1,1
2917,13,38,31,80,78,1,6631.777,74,1578.112,LESS,-8,3360,3352,2,2,-2,-0.187481692,2,-1.222253018,0.745679259,1.635840398,158,80,78,0,-0.039890055,0,-0.07803337,-0.922937925,-0.058203044,0.058203044,-0.07803337,0,1,0,0
2918,13,39,46,124,110,1,5534.829,44,2578.11,LESS,-172,2578,2406,3,2,-14,-1.312371845,14,0.87303787,-1.206644619,0.33096815,234,124,110,0,1.475932034,1.716734147,1.170500555,0.470175924,-0.239845273,0.239845273,1.170500555,1.716734147,0,1,0
2919,13,40,58,92,110,0,6145.396,74,2519.393,LESS,-732,3172,2440,2,1,18,1.687335229,18,1.571468165,0.745679259,1.057266875,202,92,110,1,0.837691154,0.468200222,1.170500555,-0.922937925,-0.860087033,0.860087033,1.170500555,0.468200222,1,0,0
2920,13,41,49,110,131,1,4728.534,74,1299.401,MORE,238,2124,2362,3,2,21,1.968557767,21,2.095290887,0.745679259,-0.628158417,241,110,131,0,1.615547226,1.170500555,1.989850943,0.470175924,0.214260301,0.214260301,1.989850943,1.170500555,1,1,1
2921,13,42,13,47,50,1,4777.03,64,1168.958,MORE,-118,2118,2000,3,2,3,0.281222538,3,-1.047645444,0.094904633,-0.570470099,97,47,50,0,-1.256536731,-1.28755061,-1.170500555,0.470175924,-0.180036247,0.180036247,-1.170500555,-1.28755061,0,1,0
2922,13,43,16,50,44,0,5237.59,44,1806.562,MORE,-468,2642,2174,4,1,-6,-0.562445076,6,-0.523822722,-1.206644619,-0.022611894,94,50,44,1,-1.316371814,-1.170500555,-1.404600665,1.863289774,-0.567687347,0.567687347,-1.404600665,-1.170500555,0,1,0
2923,13,44,7,57,50,0,4732.615,54,2192.113,MORE,-914,2418,1504,3,2,-7,-0.656185922,7,-0.349215148,-0.555869993,-0.623303872,107,57,50,1,-1.057086457,-0.897383758,-1.170500555,0.470175924,-1.061665605,1.061665605,-1.170500555,-0.897383758,0,1,0
2924,13,45,18,42,50,1,5130.834,74,844.845,MORE,742,1832,2574,3,2,8,0.749926769,8,-0.174607574,0.745679259,-0.149603275,92,42,50,0,-1.356261869,-1.482634036,-1.170500555,0.470175924,0.772477885,0.772477885,-1.170500555,-1.482634036,1,1,1
2925,13,46,51,108,110,0,4248.016,70,1916.208,MORE,946,2050,2996,4,2,2,0.187481692,2,-1.222253018,0.485369408,-1.19975762,218,108,110,0,1.156811594,1.092467184,1.170500555,1.863289774,0.998423097,0.998423097,1.170500555,1.092467184,1,1,1
2926,13,47,31,78,80,1,4516.884,74,1258.293,MORE,734,1762,2496,3,2,2,0.187481692,2,-1.222253018,0.745679259,-0.879926241,158,78,80,0,-0.039890055,-0.07803337,0,0.470175924,0.763617288,0.763617288,0,-0.07803337,1,1,1
2927,13,48,58,110,92,0,4790.279,74,1915.698,MORE,-212,2344,2132,4,2,-18,-1.687335229,18,1.571468165,0.745679259,-0.554709778,202,110,92,1,0.837691154,1.170500555,0.468200222,1.863289774,-0.284148256,0.284148256,0.468200222,1.170500555,1,1,0
2928,13,49,12,50,48,1,3812.761,44,383.238,MORE,342,1686,2028,3,2,-2,-0.187481692,2,-1.222253018,-1.206644619,-1.717514315,98,50,48,1,-1.236591704,-1.170500555,-1.248533925,0.470175924,0.329448056,0.329448056,-1.248533925,-1.170500555,0,1,1
2929,13,50,54,110,101,1,4843.772,74,1003.721,MORE,510,2348,2858,3,2,-9,-0.843667615,9,0,0.745679259,-0.49107729,211,110,101,1,1.017196402,1.170500555,0.819350388,0.470175924,0.515520584,0.515520584,0.819350388,1.170500555,1,1,1
2930,13,51,14,46,50,0,5095.775,84,1770.597,MORE,1020,1864,2884,3,2,4,0.374963384,4,-0.87303787,1.396453885,-0.191307637,96,46,50,0,-1.276481759,-1.326567295,-1.170500555,0.470175924,1.080383616,1.080383616,-1.170500555,-1.326567295,1,1,1
2931,13,52,22,80,83,1,4325.052,64,1273.75,MORE,1566,1458,3024,2,2,3,0.281222538,3,-1.047645444,0.094904633,-1.108119604,163,80,83,0,0.059835082,0,0.117050055,-0.922937925,1.685119332,1.685119332,0.117050055,0,0,0,1
2932,13,53,6,50,56,1,4924.589,34,516.903,MORE,-316,2484,2168,3,2,6,0.562445076,6,-0.523822722,-1.857419244,-0.394941593,106,50,56,0,-1.077031484,-1.170500555,-0.936400444,0.470175924,-0.399336012,0.399336012,-0.936400444,-1.170500555,0,1,0
2933,13,54,13,50,47,1,4976.991,74,2123.1,MORE,106,2472,2578,3,2,-3,-0.281222538,3,-1.047645444,0.745679259,-0.332606901,97,50,47,1,-1.256536731,-1.170500555,-1.28755061,0.470175924,0.068060457,0.068060457,-1.28755061,-1.170500555,1,0,1
2934,13,55,46,110,124,1,5782.88,74,1960.536,MORE,1620,1716,3336,3,2,14,1.312371845,14,0.87303787,0.745679259,0.626036709,234,110,124,0,1.475932034,1.170500555,1.716734147,0.470175924,1.744928359,1.744928359,1.716734147,1.170500555,1,0,1
2935,13,56,27,91,80,1,6755.802,54,1570.008,MORE,40,3024,3064,2,2,-11,-1.031149307,11,0.349215148,-0.555869993,1.783374083,171,91,80,1,0.219395302,0.429183537,0,-0.922937925,-0.005039464,0.005039464,0,0.429183537,0,0,1
2936,13,57,40,64,80,1,5654.201,64,1625.247,MORE,1636,1874,3510,3,2,16,1.499853537,16,1.222253018,0.094904633,0.472966868,144,64,80,0,-0.31912044,-0.624266962,0,0.470175924,1.762649552,1.762649552,0,-0.624266962,1,0,1
2937,13,58,22,83,80,1,5400.034,74,1662.944,MORE,656,2432,3088,3,2,-3,-0.281222538,3,-1.047645444,0.745679259,0.170623034,163,83,80,1,0.059835082,0.117050055,0,0.470175924,0.677226472,0.677226472,0,0.117050055,1,0,1
2938,13,59,54,101,110,1,4913.412,74,1836.388,MORE,1102,1878,2980,3,2,9,0.843667615,9,0,0.745679259,-0.40823717,211,101,110,0,1.017196402,0.819350388,1.170500555,0.470175924,1.171204731,1.171204731,1.170500555,0.819350388,1,0,1
2939,13,60,6,56,50,1,6080.446,44,3171.574,MORE,1678,2188,3866,3,2,-6,-0.562445076,6,-0.523822722,-1.206644619,0.980005736,106,56,50,1,-1.077031484,-0.936400444,-1.170500555,0.470175924,1.809167684,1.809167684,-1.170500555,-0.936400444,0,1,1
2940,13,61,18,50,42,0,6902.097,64,2366.446,MORE,-1538,3584,2046,3,1,-8,-0.749926769,8,-0.174607574,0.094904633,1.957399001,92,50,42,1,-1.356261869,-1.170500555,-1.482634036,0.470175924,-1.752792138,1.752792138,-1.482634036,-1.170500555,1,1,0
2941,13,62,43,110,117,0,6638.75,44,2480.759,MORE,1712,2638,4350,5,2,7,0.656185922,7,-0.349215148,-1.206644619,1.644135116,227,110,117,0,1.336316841,1.170500555,1.443617351,3.256403624,1.846825219,1.846825219,1.443617351,1.170500555,0,1,1
2942,13,63,32,77,80,0,5702.751,64,2751.851,MORE,508,2160,2668,4,1,3,0.281222538,3,-1.047645444,0.094904633,0.530719421,157,77,80,0,-0.059835082,-0.117050055,0,1.863289774,0.513305435,0.513305435,0,-0.117050055,1,1,1
2943,13,64,27,80,91,1,3842.298,84,1403,MORE,1494,1580,3074,3,2,11,1.031149307,11,0.349215148,1.396453885,-1.682378637,171,80,91,0,0.219395302,0,0.429183537,0.470175924,1.605373963,1.605373963,0.429183537,0,1,1,1
2944,13,65,16,44,50,1,5351.669,84,1485.055,MORE,958,2102,3060,3,2,6,0.562445076,6,-0.523822722,1.396453885,0.113090547,94,44,50,0,-1.316371814,-1.404600665,-1.170500555,0.470175924,1.011713992,1.011713992,-1.170500555,-1.404600665,1,1,1
2945,13,66,7,50,57,0,6971.184,44,2676.532,MORE,394,3054,3448,4,2,7,0.656185922,7,-0.349215148,-1.206644619,2.0395813,107,50,57,0,-1.057086457,-1.170500555,-0.897383758,1.863289774,0.387041934,0.387041934,-0.897383758,-1.170500555,0,1,1
2946,13,67,14,50,46,0,5742.077,74,1448.246,MORE,-360,2870,2510,3,2,-4,-0.374963384,4,-0.87303787,0.745679259,0.577499584,96,50,46,1,-1.276481759,-1.170500555,-1.326567295,0.470175924,-0.448069293,0.448069293,-1.326567295,-1.170500555,1,1,0
2947,13,68,51,110,108,1,4953.392,74,1486.388,MORE,1392,2124,3516,3,2,-2,-0.187481692,2,-1.222253018,0.745679259,-0.360679043,218,110,108,1,1.156811594,1.170500555,1.092467184,0.470175924,1.492401356,1.492401356,1.092467184,1.170500555,1,1,1
2948,13,69,50,133,110,0,5710.593,44,2180.654,MORE,-944,2970,2026,3,2,-23,-2.15603946,23,2.444506035,-1.206644619,0.540047857,243,133,110,1,1.655437281,2.067884313,1.170500555,0.470175924,-1.094892843,1.094892843,1.170500555,2.067884313,0,1,0
2949,13,70,49,131,110,0,5005.606,84,1714.593,MORE,546,2392,2938,4,2,-21,-1.968557767,21,2.095290887,1.396453885,-0.298567986,241,131,110,1,1.615547226,1.989850943,1.170500555,1.863289774,0.555393269,0.555393269,1.170500555,1.989850943,1,1,1
2950,13,71,47,126,110,1,4991.3,14,419.372,MORE,246,2028,2274,2,2,-16,-1.499853537,16,1.222253018,-3.158968496,-0.315585659,236,126,110,1,1.515822089,1.794767517,1.170500555,-0.922937925,0.223120897,0.223120897,1.170500555,1.794767517,0,0,1
2951,13,72,50,110,133,1,4425.756,64,1925.607,MORE,566,1894,2460,3,2,23,2.15603946,23,2.444506035,0.094904633,-0.988327367,243,110,133,0,1.655437281,1.170500555,2.067884313,0.470175924,0.57754476,0.57754476,2.067884313,1.170500555,1,1,1
2952,13,73,47,110,126,1,3912.845,74,2227.888,MORE,1822,1664,3486,3,2,16,1.499853537,16,1.222253018,0.745679259,-1.598459597,236,110,126,0,1.515822089,1.170500555,1.794767517,0.470175924,1.968658422,1.968658422,1.794767517,1.170500555,1,1,1
2953,13,74,12,48,50,1,5197.845,54,1801.159,MORE,22,2028,2050,2,2,2,0.187481692,2,-1.222253018,-0.555869993,-0.069890477,98,48,50,0,-1.236591704,-1.248533925,-1.170500555,-0.922937925,-0.024975807,0.024975807,-1.170500555,-1.248533925,0,0,1
2954,13,75,32,80,77,1,4044.83,74,1632.973,MORE,320,1902,2222,3,2,-3,-0.281222538,3,-1.047645444,0.745679259,-1.441457111,157,80,77,1,-0.059835082,0,-0.117050055,0.470175924,0.305081416,0.305081416,-0.117050055,0,1,1,1
2955,13,76,43,117,110,0,6092.637,74,1871.591,MORE,-174,2872,2698,3,2,-7,-0.656185922,7,-0.349215148,0.745679259,0.994507515,227,117,110,1,1.336316841,1.443617351,1.170500555,0.470175924,-0.242060423,0.242060423,1.170500555,1.443617351,1,1,0
2956,13,77,40,80,64,0,4904.838,74,2024.982,MORE,-726,2990,2264,2,2,-16,-1.499853537,16,1.222253018,0.745679259,-0.418436355,144,80,64,1,-0.31912044,0,-0.624266962,-0.922937925,-0.853441586,0.853441586,-0.624266962,0,1,0,0
2957,13,78,31,80,78,1,5516.299,64,1979.037,MORE,-136,2344,2208,3,2,-2,-0.187481692,2,-1.222253018,0.094904633,0.308925826,158,80,78,1,-0.039890055,0,-0.07803337,0.470175924,-0.199972589,0.199972589,-0.07803337,0,1,1,0
2958,13,79,46,124,110,0,6759.424,84,1566.541,MORE,1248,2780,4028,2,2,-14,-1.312371845,14,0.87303787,1.396453885,1.787682626,234,124,110,1,1.475932034,1.716734147,1.170500555,-0.922937925,1.332910618,1.332910618,1.170500555,1.716734147,1,0,1
2959,13,80,58,92,110,1,3572.406,94,2507.649,MORE,1252,1920,3172,3,2,18,1.687335229,18,1.571468165,2.04722851,-2.003428113,202,92,110,0,0.837691154,0.468200222,1.170500555,0.470175924,1.337340916,1.337340916,1.170500555,0.468200222,1,0,1
2960,13,81,48,128,110,1,4088.777,74,1626.484,LESS,-26,2070,2044,3,2,-18,-1.687335229,18,1.571468165,0.745679259,-1.389180047,238,128,110,0,1.555712144,1.872800887,1.170500555,0.470175924,-0.078139386,0.078139386,1.170500555,1.872800887,1,1,0
2961,13,82,8,50,58,0,4742.607,74,2264.569,LESS,-108,2392,2284,2,2,8,0.749926769,8,-0.174607574,0.745679259,-0.611417909,108,50,58,1,-1.037141429,-1.170500555,-0.858367073,-0.922937925,-0.168960501,0.168960501,-0.858367073,-1.170500555,1,0,0
2962,13,83,4,54,50,0,6010.044,34,1882.368,LESS,-530,2892,2362,3,2,-4,-0.374963384,4,-0.87303787,-1.857419244,0.896259181,104,54,50,0,-1.116921539,-1.014433814,-1.170500555,0.470175924,-0.63635697,0.63635697,-1.170500555,-1.014433814,0,1,0
2963,13,84,37,80,69,1,4972.817,54,2349.769,LESS,1422,1688,3110,3,2,-11,-1.031149307,11,0.349215148,-0.555869993,-0.337572074,149,80,69,0,-0.219395302,0,-0.429183537,0.470175924,1.525628593,1.525628593,-0.429183537,0,0,1,1
2964,13,85,52,105,110,0,5159.719,54,1416.466,LESS,-1160,2626,1466,3,2,5,0.46870423,5,-0.698430296,-0.555869993,-0.115243183,215,105,110,1,1.096976512,0.975417129,1.170500555,0.470175924,-1.33412895,1.33412895,1.170500555,0.975417129,0,1,0
2965,13,86,5,55,50,1,5641.536,74,1144.999,LESS,-380,2720,2340,3,2,-5,-0.46870423,5,-0.698430296,0.745679259,0.457901243,105,55,50,0,-1.096976512,-0.975417129,-1.170500555,0.470175924,-0.470220784,0.470220784,-1.170500555,-0.975417129,1,1,0
2966,13,87,30,96,80,1,4705.511,64,1542.437,LESS,-748,2216,1468,3,2,-16,-1.499853537,16,1.222253018,0.094904633,-0.655545379,176,96,80,0,0.31912044,0.624266962,0,0.470175924,-0.877808227,0.877808227,0,0.624266962,1,1,0
2967,13,88,33,80,75,1,6562.621,44,2408.866,LESS,2102,2126,4228,3,2,-5,-0.46870423,5,-0.698430296,-1.206644619,1.55357602,155,80,75,0,-0.099725137,0,-0.195083426,0.470175924,2.278779302,2.278779302,-0.195083426,0,0,1,1
2968,13,89,48,110,128,0,5491.312,34,1791.297,LESS,-306,2552,2246,3,2,18,1.687335229,18,1.571468165,-1.857419244,0.279202592,238,110,128,1,1.555712144,1.170500555,1.872800887,0.470175924,-0.388260266,0.388260266,1.872800887,1.170500555,0,1,0
2969,13,90,9,59,50,1,4989.419,94,1684.944,LESS,434,2548,2982,3,2,-9,-0.843667615,9,0,2.04722851,-0.317823199,109,59,50,0,-1.017196402,-0.819350388,-1.170500555,0.470175924,0.431344917,0.431344917,-1.170500555,-0.819350388,1,1,1
2970,13,91,44,110,119,0,5587.143,34,1976.989,LESS,94,2160,2254,3,2,9,0.843667615,9,0,-1.857419244,0.393198162,229,110,119,1,1.376206896,1.170500555,1.521650721,0.470175924,0.054769563,0.054769563,1.521650721,1.170500555,0,1,1
2971,13,92,2,52,50,0,5624.509,24,1635.652,LESS,-1136,3360,2224,3,2,-2,-0.187481692,2,-1.222253018,-2.50819387,0.43764681,102,52,50,0,-1.156811594,-1.092467184,-1.170500555,0.470175924,-1.30754716,1.30754716,-1.170500555,-1.092467184,0,1,0
2972,13,93,8,58,50,1,6289.553,44,2186.41,LESS,1166,2102,3268,2,2,-8,-0.749926769,8,-0.174607574,-1.206644619,1.228748539,108,58,50,0,-1.037141429,-0.858367073,-1.170500555,-0.922937925,1.242089503,1.242089503,-1.170500555,-0.858367073,0,0,1
2973,13,94,44,119,110,1,4868.574,64,1852.857,LESS,394,1860,2254,2,2,-9,-0.843667615,9,0,0.094904633,-0.461574121,229,119,110,0,1.376206896,1.521650721,1.170500555,-0.922937925,0.387041934,0.387041934,1.170500555,1.521650721,1,0,1
2974,13,95,34,74,80,0,5237.417,64,1964.392,LESS,-1006,2684,1678,2,1,6,0.562445076,6,-0.523822722,0.094904633,-0.022817686,154,74,80,1,-0.119670165,-0.234100111,0,-0.922937925,-1.163562466,1.163562466,0,-0.234100111,1,0,0
2975,13,96,24,86,80,1,5083.344,54,1433.209,LESS,-130,2624,2494,3,2,-6,-0.562445076,6,-0.523822722,-0.555869993,-0.206094908,166,86,80,0,0.119670165,0.234100111,0,0.470175924,-0.193327141,0.193327141,0,0.234100111,0,1,0
2976,13,97,39,66,80,0,5152.319,74,3074.964,LESS,-348,2796,2448,2,2,14,1.312371845,14,0.87303787,0.745679259,-0.124045838,146,66,80,1,-0.279230385,-0.546233592,0,-0.922937925,-0.434778398,0.434778398,0,-0.546233592,1,0,0
2977,13,98,9,50,59,0,5295.773,74,1908.106,LESS,538,2862,3400,4,2,9,0.843667615,9,0,0.745679259,0.046599575,109,50,59,1,-1.017196402,-1.170500555,-0.819350388,1.863289774,0.546532672,0.546532672,-0.819350388,-1.170500555,1,1,1
2978,13,99,57,94,110,1,5441.379,64,1749.741,LESS,-72,2322,2250,3,2,16,1.499853537,16,1.222253018,0.094904633,0.219804894,204,94,110,1,0.877581209,0.546233592,1.170500555,0.470175924,-0.129087816,0.129087816,1.170500555,0.546233592,1,1,0
2979,13,100,60,110,87,1,6426.097,34,1529.406,LESS,1498,1606,3104,2,2,-23,-2.15603946,23,2.444506035,-1.857419244,1.391174175,197,110,87,0,0.737966017,1.170500555,0.273116796,-0.922937925,1.609804261,1.609804261,0.273116796,1.170500555,0,0,1
2980,13,101,33,75,80,1,5147.489,74,2063.675,LESS,954,1962,2916,3,2,5,0.46870423,5,-0.698430296,0.745679259,-0.129791354,155,75,80,1,-0.099725137,-0.195083426,0,0.470175924,1.007283694,1.007283694,0,-0.195083426,1,1,1
2981,13,102,15,50,45,1,6903.816,74,2035.004,LESS,72,3092,3164,3,2,-5,-0.46870423,5,-0.698430296,0.745679259,1.959443834,95,50,45,0,-1.296426786,-1.170500555,-1.36558398,0.470175924,0.030402922,0.030402922,-1.36558398,-1.170500555,1,1,1
2982,13,103,59,89,110,0,5571.482,74,2285.111,LESS,-2116,3972,1856,2,2,21,1.968557767,21,2.095290887,0.745679259,0.374568651,199,89,110,1,0.777856072,0.351150166,1.170500555,-0.922937925,-2.39297024,2.39297024,1.170500555,0.351150166,1,0,0
2983,13,104,29,80,94,0,4844.277,64,1999.376,LESS,-302,2494,2192,2,2,14,1.312371845,14,0.87303787,0.094904633,-0.490476568,174,80,94,1,0.279230385,0,0.546233592,-0.922937925,-0.383829968,0.383829968,0.546233592,0,0,0,0
2984,13,105,55,110,98,1,5286.754,84,2878.266,LESS,1340,2556,3896,3,2,-12,-1.124890153,12,0.523822722,1.396453885,0.035871042,208,110,98,0,0.957361319,1.170500555,0.702300333,0.470175924,1.434807479,1.434807479,0.702300333,1.170500555,1,1,1
2985,13,106,29,94,80,1,6952.101,34,1457.03,LESS,-1982,4030,2048,3,2,-14,-1.312371845,14,0.87303787,-1.857419244,2.016881157,174,94,80,0,0.279230385,0.546233592,0,0.470175924,-2.244555248,2.244555248,0,0.546233592,0,1,0
2986,13,107,57,110,94,1,6356.381,34,1459.576,LESS,-1268,3104,1836,3,2,-16,-1.499853537,16,1.222253018,-1.857419244,1.30824365,204,110,94,0,0.877581209,1.170500555,0.546233592,0.470175924,-1.453747004,1.453747004,0.546233592,1.170500555,0,1,0
2987,13,108,39,80,66,1,5737.051,74,1536.197,LESS,614,2390,3004,3,2,-14,-1.312371845,14,0.87303787,0.745679259,0.571520916,146,80,66,0,-0.279230385,0,-0.546233592,0.470175924,0.63070834,0.63070834,-0.546233592,0,1,1,1
2988,13,109,4,50,54,0,5265.026,64,1923.063,LESS,-1006,3070,2064,3,2,4,0.374963384,4,-0.87303787,0.094904633,0.010024544,104,50,54,1,-1.116921539,-1.170500555,-1.014433814,0.470175924,-1.163562466,1.163562466,-1.014433814,-1.170500555,0,1,0
2989,13,110,55,98,110,0,5402.867,64,2345.517,LESS,304,2434,2738,3,2,12,1.124890153,12,0.523822722,0.094904633,0.173993023,208,98,110,1,0.957361319,0.702300333,1.170500555,0.470175924,0.287360223,0.287360223,1.170500555,0.702300333,0,1,1
2990,13,111,2,50,52,0,4650.749,94,1906.253,LESS,798,2106,2904,2,2,2,0.187481692,2,-1.222253018,2.04722851,-0.720687404,102,50,52,1,-1.156811594,-1.170500555,-1.092467184,-0.922937925,0.834502061,0.834502061,-1.092467184,-1.170500555,1,0,1
2991,13,112,59,110,89,1,2940.232,74,3439.967,LESS,1390,1200,2590,1,2,-21,-1.968557767,21,2.095290887,0.745679259,-2.755429401,199,110,89,0,0.777856072,1.170500555,0.351150166,-2.316051775,1.490186207,1.490186207,0.351150166,1.170500555,1,0,1
2992,13,113,60,87,110,0,4932.683,54,2101.308,LESS,-1684,2716,1032,2,1,23,2.15603946,23,2.444506035,-0.555869993,-0.385313392,197,87,110,1,0.737966017,0.273116796,1.170500555,-0.922937925,-1.914498025,1.914498025,1.170500555,0.273116796,0,0,0
2993,13,114,52,110,105,0,5092.359,74,1899.594,LESS,634,2104,2738,2,2,-5,-0.46870423,5,-0.698430296,0.745679259,-0.195371133,215,110,105,0,1.096976512,1.170500555,0.975417129,-0.922937925,0.652859831,0.652859831,0.975417129,1.170500555,1,0,1
2994,13,115,30,80,96,0,4935.015,84,2585.835,LESS,-932,2888,1956,2,2,16,1.499853537,16,1.222253018,1.396453885,-0.382539366,176,80,96,1,0.31912044,0,0.624266962,-0.922937925,-1.081601948,1.081601948,0.624266962,0,1,0,0
2995,13,116,24,80,86,0,5036.011,74,2386.95,LESS,-510,2702,2192,4,2,6,0.562445076,6,-0.523822722,0.745679259,-0.262399781,166,80,86,1,0.119670165,0,0.234100111,1.863289774,-0.614205479,0.614205479,0.234100111,0,1,1,0
2996,13,117,5,50,55,0,4137.873,84,2016.958,LESS,354,2078,2432,1,2,5,0.46870423,5,-0.698430296,1.396453885,-1.330778,105,50,55,1,-1.096976512,-1.170500555,-0.975417129,-2.316051775,0.342738951,0.342738951,-0.975417129,-1.170500555,1,0,1
2997,13,118,34,80,74,1,5783.633,74,2097.689,LESS,-104,2740,2636,3,2,-6,-0.562445076,6,-0.523822722,0.745679259,0.626932439,154,80,74,0,-0.119670165,0,-0.234100111,0.470175924,-0.164530203,0.164530203,-0.234100111,0,1,1,0
2998,13,119,15,45,50,0,4097.353,84,2526.741,LESS,314,1834,2148,2,2,5,0.46870423,5,-0.698430296,1.396453885,-1.378978484,95,45,50,1,-1.296426786,-1.36558398,-1.170500555,-0.922937925,0.298435968,0.298435968,-1.170500555,-1.36558398,1,0,1
2999,13,120,37,69,80,1,5039.556,34,1635.914,LESS,2484,2152,4636,4,2,11,1.031149307,11,0.349215148,-1.857419244,-0.258182833,149,69,80,1,-0.219395302,-0.429183537,0,1.863289774,2.701872788,2.701872788,0,-0.429183537,0,1,1
3000,13,121,48,128,110,0,5230.636,64,2170.737,MORE,-480,2278,1798,2,1,-18,-1.687335229,18,1.571468165,0.094904633,-0.03088401,238,128,110,1,1.555712144,1.872800887,1.170500555,-0.922937925,-0.580978241,0.580978241,1.170500555,1.872800887,1,0,0
3001,13,122,8,50,58,1,5874.714,64,1909.032,MORE,-2,2618,2616,3,2,8,0.749926769,8,-0.174607574,0.094904633,0.735277656,108,50,58,0,-1.037141429,-1.170500555,-0.858367073,0.470175924,-0.051557596,0.051557596,-0.858367073,-1.170500555,0,1,0
3002,13,123,4,54,50,0,3882.513,60,2870.913,MORE,918,2038,2956,2,2,-4,-0.374963384,4,-0.87303787,-0.165405217,-1.634540966,104,54,50,1,-1.116921539,-1.014433814,-1.170500555,-0.922937925,0.967411009,0.967411009,-1.170500555,-1.014433814,0,0,1
3003,13,124,37,80,69,1,5160.128,64,1233.857,MORE,-1126,2920,1794,3,2,-11,-1.031149307,11,0.349215148,0.094904633,-0.114756658,149,80,69,1,-0.219395302,0,-0.429183537,0.470175924,-1.296471415,1.296471415,-0.429183537,0,1,1,0
3004,13,125,52,105,110,1,5214.65,74,1596.591,MORE,-22,2714,2692,3,2,5,0.46870423,5,-0.698430296,0.745679259,-0.049900124,215,105,110,0,1.096976512,0.975417129,1.170500555,0.470175924,-0.073709088,0.073709088,1.170500555,0.975417129,1,1,0
3005,13,126,5,55,50,1,6416.168,44,1659.612,MORE,-1554,3686,2132,3,2,-5,-0.46870423,5,-0.698430296,-1.206644619,1.379363154,105,55,50,1,-1.096976512,-0.975417129,-1.170500555,0.470175924,-1.770513331,1.770513331,-1.170500555,-0.975417129,0,1,0
3006,13,127,30,96,80,0,5839.816,74,1315.911,MORE,530,2908,3438,2,2,-16,-1.499853537,16,1.222253018,0.745679259,0.693764812,176,96,80,1,0.31912044,0.624266962,0,-0.922937925,0.537672076,0.537672076,0,0.624266962,1,0,1
3007,13,128,33,80,75,0,5462.825,64,1537.463,MORE,-106,2574,2468,2,2,-5,-0.46870423,5,-0.698430296,0.094904633,0.245315939,155,80,75,1,-0.099725137,0,-0.195083426,-0.922937925,-0.166745352,0.166745352,-0.195083426,0,1,0,0
3008,13,129,48,110,128,1,5443.724,84,1499.652,MORE,618,2894,3512,3,2,18,1.687335229,18,1.571468165,1.396453885,0.222594384,238,110,128,0,1.555712144,1.170500555,1.872800887,0.470175924,0.635138638,0.635138638,1.872800887,1.170500555,1,1,1
3009,13,130,9,59,50,0,4849.737,54,1525.615,MORE,-1306,2862,1556,2,1,-9,-0.843667615,9,0,-0.555869993,-0.483981636,109,59,50,1,-1.017196402,-0.819350388,-1.170500555,-0.922937925,-1.495834837,1.495834837,-1.170500555,-0.819350388,0,0,0
3010,13,131,44,110,119,1,6404.263,84,1395.516,MORE,498,3256,3754,3,2,9,0.843667615,9,0,1.396453885,1.365201585,229,110,119,0,1.376206896,1.170500555,1.521650721,0.470175924,0.502229689,0.502229689,1.521650721,1.170500555,1,1,1
3011,13,132,2,52,50,1,4603.016,44,2099.725,MORE,-678,2320,1642,3,2,-2,-0.187481692,2,-1.222253018,-1.206644619,-0.777468097,102,52,50,1,-1.156811594,-1.092467184,-1.170500555,0.470175924,-0.800278007,0.800278007,-1.170500555,-1.092467184,0,1,0
3012,13,133,8,58,50,0,5106.066,64,1982.875,MORE,-608,2740,2132,4,2,-8,-0.749926769,8,-0.174607574,0.094904633,-0.179065999,108,58,50,1,-1.037141429,-0.858367073,-1.170500555,1.863289774,-0.722747787,0.722747787,-1.170500555,-0.858367073,0,1,0
3013,13,134,44,119,110,1,6099.702,64,1391.982,MORE,140,2634,2774,3,2,-9,-0.843667615,9,0,0.094904633,1.002911671,229,119,110,1,1.376206896,1.521650721,1.170500555,0.470175924,0.105717993,0.105717993,1.170500555,1.521650721,1,1,1
3014,13,135,34,74,80,1,5255.903,54,1348.012,MORE,-472,2534,2062,3,2,6,0.562445076,6,-0.523822722,-0.555869993,-0.000827702,154,74,80,0,-0.119670165,-0.234100111,0,0.470175924,-0.572117645,0.572117645,0,-0.234100111,0,1,0
3015,13,136,24,86,80,1,5245.326,44,1546.528,MORE,-1500,3154,1654,3,2,-6,-0.562445076,6,-0.523822722,-1.206644619,-0.013409551,166,86,80,1,0.119670165,0.234100111,0,0.470175924,-1.710704304,1.710704304,0,0.234100111,0,1,0
3016,13,137,39,66,80,1,5599.875,64,1510.37,MORE,-14,3134,3120,3,2,14,1.312371845,14,0.87303787,0.094904633,0.408343486,146,66,80,0,-0.279230385,-0.546233592,0,0.470175924,-0.064848491,0.064848491,0,-0.546233592,0,1,0
3017,13,138,9,50,59,1,5294.956,64,2314.586,MORE,-108,2698,2590,3,2,9,0.843667615,9,0,0.094904633,0.045627714,109,50,59,0,-1.017196402,-1.170500555,-0.819350388,0.470175924,-0.168960501,0.168960501,-0.819350388,-1.170500555,0,1,0
3018,13,139,57,94,110,1,5642.69,74,1388.143,MORE,870,2634,3504,2,2,16,1.499853537,16,1.222253018,0.745679259,0.459273982,204,94,110,0,0.877581209,0.546233592,1.170500555,-0.922937925,0.91424743,0.91424743,1.170500555,0.546233592,1,0,1
3019,13,140,60,110,87,0,4226.286,74,1452.776,MORE,-222,2184,1962,2,2,-23,-2.15603946,23,2.444506035,0.745679259,-1.225606497,197,110,87,1,0.737966017,1.170500555,0.273116796,-0.922937925,-0.295224002,0.295224002,0.273116796,1.170500555,1,0,0
3020,13,141,33,75,80,1,5756.546,54,1190.274,MORE,-520,2852,2332,3,2,5,0.46870423,5,-0.698430296,-0.555869993,0.594711154,155,75,80,0,-0.099725137,-0.195083426,0,0.470175924,-0.625281224,0.625281224,0,-0.195083426,0,1,0
3021,13,142,15,50,45,0,4965.766,54,2253.955,MORE,106,2036,2142,2,2,-5,-0.46870423,5,-0.698430296,-0.555869993,-0.345959577,95,50,45,1,-1.296426786,-1.170500555,-1.36558398,-0.922937925,0.068060457,0.068060457,-1.36558398,-1.170500555,0,0,1
3022,13,143,59,89,110,1,7015.627,54,2358.691,MORE,-1332,3882,2550,3,2,21,1.968557767,21,2.095290887,-0.555869993,2.09244838,199,89,110,0,0.777856072,0.351150166,1.170500555,0.470175924,-1.524631776,1.524631776,1.170500555,0.351150166,0,1,0
3023,13,144,29,80,94,1,5160.893,64,1304.751,MORE,616,2486,3102,3,2,14,1.312371845,14,0.87303787,0.094904633,-0.113846653,174,80,94,0,0.279230385,0,0.546233592,0.470175924,0.632923489,0.632923489,0.546233592,0,0,1,1
3024,13,145,55,110,98,0,4337.33,44,1394.949,MORE,-774,2216,1442,2,1,-12,-1.124890153,12,0.523822722,-1.206644619,-1.093514334,208,110,98,1,0.957361319,1.170500555,0.702300333,-0.922937925,-0.906605165,0.906605165,0.702300333,1.170500555,0,0,0
3025,13,146,29,94,80,0,6132.947,64,1543.653,MORE,-1444,3306,1862,2,1,-14,-1.312371845,14,0.87303787,0.094904633,1.042458193,174,94,80,1,0.279230385,0.546233592,0,-0.922937925,-1.648680128,1.648680128,0,0.546233592,0,0,0
3026,13,147,57,110,94,0,4912.862,64,2002.521,MORE,-356,2414,2058,2,2,-16,-1.499853537,16,1.222253018,0.094904633,-0.408891422,204,110,94,1,0.877581209,1.170500555,0.546233592,-0.922937925,-0.443638995,0.443638995,0.546233592,1.170500555,0,0,0
3027,13,148,39,80,66,0,4969.93,64,1508.438,MORE,-424,2410,1986,2,1,-14,-1.312371845,14,0.87303787,0.094904633,-0.341006299,146,80,66,1,-0.279230385,0,-0.546233592,-0.922937925,-0.518954065,0.518954065,-0.546233592,0,0,0,0
3028,13,149,4,50,54,1,5976.24,74,2930.43,MORE,1594,2714,4308,3,2,4,0.374963384,4,-0.87303787,0.745679259,0.856047702,104,50,54,0,-1.116921539,-1.170500555,-1.014433814,0.470175924,1.71613142,1.71613142,-1.014433814,-1.170500555,1,1,1
3029,13,150,55,98,110,1,4317.682,64,1194.705,MORE,422,1950,2372,3,2,12,1.124890153,12,0.523822722,0.094904633,-1.116886573,208,98,110,0,0.957361319,0.702300333,1.170500555,0.470175924,0.418054022,0.418054022,1.170500555,0.702300333,0,1,1
3030,13,151,2,50,52,1,5316.243,74,1685.309,MORE,628,2154,2782,3,2,2,0.187481692,2,-1.222253018,0.745679259,0.070949621,102,50,52,0,-1.156811594,-1.170500555,-1.092467184,0.470175924,0.646214384,0.646214384,-1.092467184,-1.170500555,1,1,1
3031,13,152,59,110,89,0,4742.574,74,1810.522,MORE,-84,2042,1958,2,2,-21,-1.968557767,21,2.095290887,0.745679259,-0.611457164,199,110,89,1,0.777856072,1.170500555,0.351150166,-0.922937925,-0.142378711,0.142378711,0.351150166,1.170500555,1,0,0
3032,13,153,60,87,110,1,3871.821,94,2302.663,MORE,574,2110,2684,1,2,23,2.15603946,23,2.444506035,2.04722851,-1.647259612,197,87,110,0,0.737966017,0.273116796,1.170500555,-2.316051775,0.586405357,0.586405357,1.170500555,0.273116796,1,0,1
3033,13,154,52,110,105,0,4601.964,64,2037.184,MORE,-524,2242,1718,2,1,-5,-0.46870423,5,-0.698430296,0.094904633,-0.778719501,215,110,105,1,1.096976512,1.170500555,0.975417129,-0.922937925,-0.629711523,0.629711523,0.975417129,1.170500555,0,0,0
3034,13,155,30,80,96,1,4808.78,84,1931.458,MORE,1258,2140,3398,3,2,16,1.499853537,16,1.222253018,1.396453885,-0.532701952,176,80,96,0,0.31912044,0,0.624266962,0.470175924,1.343986364,1.343986364,0.624266962,0,1,1,1
3035,13,156,24,80,86,1,5201.617,44,1764.048,MORE,-568,2550,1982,3,2,6,0.562445076,6,-0.523822722,-1.206644619,-0.065403503,166,80,86,0,0.119670165,0,0.234100111,0.470175924,-0.678444804,0.678444804,0.234100111,0,0,1,0
3036,13,157,5,50,55,0,4275.368,74,1223.091,MORE,710,1860,2570,2,2,5,0.46870423,5,-0.698430296,0.745679259,-1.167221105,105,50,55,0,-1.096976512,-1.170500555,-0.975417129,-0.922937925,0.737035499,0.737035499,-0.975417129,-1.170500555,1,0,1
3037,13,158,34,80,74,1,5999.5,54,1620.001,MORE,-808,3170,2362,2,2,-6,-0.562445076,6,-0.523822722,-0.555869993,0.883716587,154,80,74,1,-0.119670165,0,-0.234100111,-0.922937925,-0.944262701,0.944262701,-0.234100111,0,0,0,0
3038,13,159,15,45,50,1,5505.031,54,1463.288,MORE,-374,2632,2258,3,2,5,0.46870423,5,-0.698430296,-0.555869993,0.295522,95,45,50,0,-1.296426786,-1.36558398,-1.170500555,0.470175924,-0.463575337,0.463575337,-1.170500555,-1.36558398,0,1,0
3039,13,160,37,69,80,0,4913.246,64,2075.104,MORE,-1616,3010,1394,2,2,11,1.031149307,11,0.349215148,0.094904633,-0.408434635,149,69,80,0,-0.219395302,-0.429183537,0,-0.922937925,-1.839182955,1.839182955,0,-0.429183537,0,0,0
3040,13,161,3,50,53,0,4714.41,54,1648.891,LESS,-1100,2572,1472,2,1,3,0.281222538,3,-1.047645444,-0.555869993,-0.644959592,103,50,53,1,-1.136866566,-1.170500555,-1.053450499,-0.922937925,-1.267674476,1.267674476,-1.053450499,-1.170500555,0,0,0
3041,13,162,20,50,40,1,5761.402,74,1661.414,LESS,48,3254,3302,3,2,-10,-0.937408461,10,0.174607574,0.745679259,0.600487598,90,50,40,0,-1.396151924,-1.170500555,-1.560667406,0.470175924,0.003821132,0.003821132,-1.560667406,-1.170500555,1,0,0
3042,13,163,25,80,88,1,5739.582,64,1699.285,LESS,1502,2296,3798,3,2,8,0.749926769,8,-0.174607574,0.094904633,0.574531662,168,80,88,1,0.15956022,0,0.312133481,0.470175924,1.614234559,1.614234559,0.312133481,0,1,0,1
3043,13,164,42,115,110,1,5124.369,64,1160.848,LESS,208,2020,2228,3,2,-5,-0.46870423,5,-0.698430296,0.094904633,-0.157293703,225,115,110,0,1.296426786,1.36558398,1.170500555,0.470175924,0.181033064,0.181033064,1.170500555,1.36558398,0,0,1
3044,13,165,53,103,110,0,4688.827,64,1651.576,LESS,-66,2270,2204,2,2,7,0.656185922,7,-0.349215148,0.094904633,-0.675391797,213,103,110,1,1.057086457,0.897383758,1.170500555,-0.922937925,-0.122442369,0.122442369,1.170500555,0.897383758,0,0,0
3045,13,166,26,90,80,0,5598.042,64,2203.556,LESS,778,2484,3262,3,2,-10,-0.937408461,10,0.174607574,0.094904633,0.406163045,170,90,80,0,0.199450275,0.390166852,0,0.470175924,0.812350569,0.812350569,0,0.390166852,0,0,1
3046,13,167,35,80,72,1,4835.591,64,1718.126,LESS,-162,2054,1892,3,2,-8,-0.749926769,8,-0.174607574,0.094904633,-0.500808982,152,80,72,0,-0.15956022,0,-0.312133481,0.470175924,-0.228769528,0.228769528,-0.312133481,0,0,0,0
3047,13,168,28,93,80,1,5643.044,54,1789.828,LESS,-524,2670,2146,3,2,-13,-1.218630999,13,0.698430296,-0.555869993,0.459695082,173,93,80,0,0.259285357,0.507216907,0,0.470175924,-0.629711523,0.629711523,0,0.507216907,0,0,0
3048,13,169,26,80,90,0,3939.683,84,1650.283,LESS,744,1938,2682,2,2,10,0.937408461,10,0.174607574,1.396453885,-1.566534509,170,80,90,1,0.199450275,0,0.390166852,-0.922937925,0.774693034,0.774693034,0.390166852,0,1,0,1
3049,13,170,25,88,80,1,5921.881,44,1979.976,LESS,-1344,3324,1980,2,1,-8,-0.749926769,8,-0.174607574,-1.206644619,0.791385064,168,88,80,0,0.15956022,0.312133481,0,-0.922937925,-1.537922671,1.537922671,0,0.312133481,0,0,0
3050,13,171,36,80,70,0,6611.578,34,1536.308,LESS,-886,3382,2496,3,2,-10,-0.937408461,10,0.174607574,-1.857419244,1.611812719,150,80,70,0,-0.199450275,0,-0.390166852,0.470175924,-1.030653517,1.030653517,-0.390166852,0,0,1,0
3051,13,172,28,80,93,0,5733.983,74,1396,LESS,500,2686,3186,2,2,13,1.218630999,13,0.698430296,0.745679259,0.567871383,173,80,93,1,0.259285357,0,0.507216907,-0.922937925,0.504444839,0.504444839,0.507216907,0,1,0,1
3052,13,173,21,82,80,0,5016.054,54,1877.974,LESS,-1224,2808,1584,2,1,-2,-0.187481692,2,-1.222253018,-0.555869993,-0.286139589,162,82,80,0,0.039890055,0.07803337,0,-0.922937925,-1.405013723,1.405013723,0,0.07803337,0,0,0
3053,13,174,19,50,41,1,6418.795,54,1918.822,LESS,-1738,3476,1738,3,2,-9,-0.843667615,9,0,-0.555869993,1.382488096,91,50,41,0,-1.376206896,-1.170500555,-1.521650721,0.470175924,-1.974307052,1.974307052,-1.521650721,-1.170500555,0,1,0
3054,13,175,56,96,110,1,5317.248,54,1488.406,LESS,470,1912,2382,3,2,14,1.312371845,14,0.87303787,-0.555869993,0.072145117,206,96,110,1,0.917471264,0.624266962,1.170500555,0.470175924,0.471217601,0.471217601,1.170500555,0.624266962,0,0,1
3055,13,176,23,80,85,1,6311.401,44,3335.15,LESS,-104,3012,2908,1,2,5,0.46870423,5,-0.698430296,-1.206644619,1.254737783,165,80,85,1,0.099725137,0,0.195083426,-2.316051775,-0.164530203,0.164530203,0.195083426,0,0,0,0
3056,13,177,10,60,50,1,3751.359,54,2485.533,LESS,542,1656,2198,3,2,-10,-0.937408461,10,0.174607574,-0.555869993,-1.790554938,110,60,50,0,-0.997251374,-0.780333703,-1.170500555,0.470175924,0.550962971,0.550962971,-1.170500555,-0.780333703,0,1,1
3057,13,178,19,41,50,0,4003.975,64,2326.715,LESS,458,1948,2406,2,2,9,0.843667615,9,0,0.094904633,-1.490056092,91,41,50,1,-1.376206896,-1.521650721,-1.170500555,-0.922937925,0.457926707,0.457926707,-1.170500555,-1.521650721,0,0,1
3058,13,179,56,110,96,1,4861.518,74,1943.61,LESS,404,2240,2644,3,2,-14,-1.312371845,14,0.87303787,0.745679259,-0.469967572,206,110,96,0,0.917471264,1.170500555,0.624266962,0.470175924,0.39811768,0.39811768,0.624266962,1.170500555,1,1,1
3059,13,180,35,72,80,1,4678.906,64,2302.421,LESS,2098,1786,3884,3,2,8,0.749926769,8,-0.174607574,0.094904633,-0.687193303,152,72,80,1,-0.15956022,-0.312133481,0,0.470175924,2.274349004,2.274349004,0,-0.312133481,0,0,1
3060,13,181,11,49,50,1,4940.484,50,2495.171,LESS,-906,2336,1430,3,2,1,0.093740846,1,-1.396860592,-0.816179843,-0.376033728,99,49,50,1,-1.216646676,-1.20951724,-1.170500555,0.470175924,-1.052805009,1.052805009,-1.170500555,-1.20951724,0,0,0
3061,13,182,17,43,50,0,4362.497,44,2099.821,LESS,1188,1364,2552,1,1,7,0.656185922,7,-0.349215148,-1.206644619,-1.063576981,93,43,50,1,-1.336316841,-1.443617351,-1.170500555,-2.316051775,1.266456144,1.266456144,-1.170500555,-1.443617351,0,0,1
3062,13,183,1,51,50,1,5849.717,64,1883.844,LESS,-390,2914,2524,3,2,-1,-0.093740846,1,-1.396860592,0.094904633,0.705542526,101,51,50,0,-1.176756621,-1.131483869,-1.170500555,0.470175924,-0.48129653,0.48129653,-1.170500555,-1.131483869,1,0,0
3063,13,184,41,112,110,0,4097.076,54,1794.611,LESS,-1062,2010,948,2,1,-2,-0.187481692,2,-1.222253018,-0.555869993,-1.379307988,222,112,110,0,1.236591704,1.248533925,1.170500555,-0.922937925,-1.225586642,1.225586642,1.170500555,1.248533925,0,0,0
3064,13,185,20,40,50,0,9022.497,64,1361.191,LESS,-1910,3540,1630,2,2,10,0.937408461,10,0.174607574,0.094904633,4.479716481,90,40,50,1,-1.396151924,-1.560667406,-1.170500555,-0.922937925,-2.164809879,2.164809879,-1.170500555,-1.560667406,1,0,0
3065,13,186,1,50,51,0,6600.863,84,1757.731,LESS,542,3070,3612,2,2,1,0.093740846,1,-1.396860592,1.396453885,1.599066713,101,50,51,1,-1.176756621,-1.170500555,-1.131483869,-0.922937925,0.550962971,0.550962971,-1.131483869,-1.170500555,1,0,1
3066,13,187,23,85,80,1,5722.523,64,1558.421,LESS,636,2452,3088,3,2,-5,-0.46870423,5,-0.698430296,0.094904633,0.554239164,165,85,80,0,0.099725137,0.195083426,0,0.470175924,0.65507498,0.65507498,0,0.195083426,1,0,1
3067,13,188,11,50,49,0,4758.612,54,1385.23,LESS,-1024,2380,1356,2,1,-1,-0.093740846,1,-1.396860592,-0.555869993,-0.592379194,99,50,49,0,-1.216646676,-1.170500555,-1.20951724,-0.922937925,-1.183498808,1.183498808,-1.20951724,-1.170500555,0,0,0
3068,13,189,17,50,43,1,6095.176,74,1513.686,LESS,-218,3128,2910,3,2,-7,-0.656185922,7,-0.349215148,0.745679259,0.997527777,93,50,43,0,-1.336316841,-1.170500555,-1.443617351,0.470175924,-0.290793704,0.290793704,-1.443617351,-1.170500555,1,0,0
3069,13,190,21,80,82,0,4348.855,64,1505.407,LESS,104,1836,1940,4,2,2,0.187481692,2,-1.222253018,0.094904633,-1.079804794,162,80,82,1,0.039890055,0,0.07803337,1.863289774,0.065845308,0.065845308,0.07803337,0,1,1,1
3070,13,191,10,50,60,0,4764.225,64,2446.999,LESS,-1342,2814,1472,2,1,10,0.937408461,10,0.174607574,0.094904633,-0.585702261,110,50,60,1,-0.997251374,-1.170500555,-0.780333703,-0.922937925,-1.535707522,1.535707522,-0.780333703,-1.170500555,1,0,0
3071,13,192,3,53,50,0,5247.296,64,1880.316,LESS,-520,2532,2012,3,2,-3,-0.281222538,3,-1.047645444,0.094904633,-0.011066142,103,53,50,0,-1.136866566,-1.053450499,-1.170500555,0.470175924,-0.625281224,0.625281224,-1.170500555,-1.053450499,1,0,0
3072,13,193,45,122,110,1,4770.371,34,1733.178,LESS,60,2172,2232,3,2,-12,-1.124890153,12,0.523822722,-1.857419244,-0.578391299,232,122,110,0,1.436041979,1.638700776,1.170500555,0.470175924,0.017112027,0.017112027,1.170500555,1.638700776,0,0,0
3073,13,194,38,67,80,0,4668.312,64,2120.897,LESS,-892,2498,1606,1,1,13,1.218630999,13,0.698430296,0.094904633,-0.699795374,147,67,80,1,-0.259285357,-0.507216907,0,-2.316051775,-1.037298965,1.037298965,0,-0.507216907,1,0,0
3074,13,195,38,80,67,1,4745.915,64,1491.841,LESS,560,2130,2690,3,2,-13,-1.218630999,13,0.698430296,0.094904633,-0.607482884,147,80,67,0,-0.259285357,0,-0.507216907,0.470175924,0.570899313,0.570899313,-0.507216907,0,1,0,1
3075,13,196,36,70,80,1,4392.422,44,2212.503,LESS,494,2102,2596,3,2,10,0.937408461,10,0.174607574,-1.206644619,-1.027979759,150,70,80,1,-0.199450275,-0.390166852,0,0.470175924,0.497799391,0.497799391,0,-0.390166852,0,0,1
3076,13,197,45,110,122,0,4845.454,64,2166.355,LESS,698,2236,2934,2,2,12,1.124890153,12,0.523822722,0.094904633,-0.48907647,232,110,122,1,1.436041979,1.170500555,1.638700776,-0.922937925,0.723744604,0.723744604,1.638700776,1.170500555,1,0,1
3077,13,198,42,110,115,1,5804.678,54,2728.635,LESS,-152,2430,2278,2,2,5,0.46870423,5,-0.698430296,-0.555869993,0.651966476,225,110,115,1,1.296426786,1.170500555,1.36558398,-0.922937925,-0.217693782,0.217693782,1.36558398,1.170500555,0,0,0
3078,13,199,41,110,112,0,4870.245,74,1522.717,LESS,-352,2332,1980,2,2,2,0.187481692,2,-1.222253018,0.745679259,-0.459586387,222,110,112,1,1.236591704,1.170500555,1.248533925,-0.922937925,-0.439208696,0.439208696,1.248533925,1.170500555,1,0,0
3079,13,200,53,110,103,0,5993.969,64,2178.255,LESS,724,2282,3006,4,2,-7,-0.656185922,7,-0.349215148,0.094904633,0.877137197,213,110,103,0,1.057086457,1.170500555,0.897383758,1.863289774,0.752541543,0.752541543,0.897383758,1.170500555,0,1,1
3080,13,201,3,50,53,1,4816.592,74,1271.817,MORE,-1320,2702,1382,2,2,3,0.281222538,3,-1.047645444,0.745679259,-0.523409203,103,50,53,0,-1.136866566,-1.170500555,-1.053450499,-0.922937925,-1.511340881,1.511340881,-1.053450499,-1.170500555,1,0,0
3081,13,202,20,50,40,0,3511.801,64,2048.345,MORE,1194,1554,2748,2,2,-10,-0.937408461,10,0.174607574,0.094904633,-2.075520667,90,50,40,1,-1.396151924,-1.170500555,-1.560667406,-0.922937925,1.273101591,1.273101591,-1.560667406,-1.170500555,1,0,1
3082,13,203,25,80,88,1,5224.515,84,1656.998,MORE,148,3002,3150,3,2,8,0.749926769,8,-0.174607574,1.396453885,-0.038165233,168,80,88,0,0.15956022,0,0.312133481,0.470175924,0.114578589,0.114578589,0.312133481,0,1,0,1
3083,13,204,42,115,110,0,4567.46,84,1180.641,MORE,372,2128,2500,3,2,-5,-0.46870423,5,-0.698430296,1.396453885,-0.819763664,225,115,110,1,1.296426786,1.36558398,1.170500555,0.470175924,0.362675293,0.362675293,1.170500555,1.36558398,1,0,1
3084,13,205,53,103,110,0,6081.765,64,2005.158,MORE,-1078,3298,2220,3,2,7,0.656185922,7,-0.349215148,0.094904633,0.981574749,213,103,110,0,1.057086457,0.897383758,1.170500555,0.470175924,-1.243307835,1.243307835,1.170500555,0.897383758,0,0,0
3085,13,206,26,90,80,1,4722.791,64,1721.39,MORE,-110,2262,2152,3,2,-10,-0.937408461,10,0.174607574,0.094904633,-0.634989991,170,90,80,1,0.199450275,0.390166852,0,0.470175924,-0.17117565,0.17117565,0,0.390166852,0,0,0
3086,13,207,35,80,72,0,4314.562,64,1440.768,MORE,-546,2158,1612,2,1,-8,-0.749926769,8,-0.174607574,0.094904633,-1.120597962,152,80,72,1,-0.15956022,0,-0.312133481,-0.922937925,-0.654078163,0.654078163,-0.312133481,0,0,0,0
3087,13,208,28,93,80,1,6493.06,64,2007.97,MORE,-194,3592,3398,3,2,-13,-1.218630999,13,0.698430296,0.094904633,1.470829875,173,93,80,1,0.259285357,0.507216907,0,0.470175924,-0.264211914,0.264211914,0,0.507216907,0,0,0
3088,13,209,26,80,90,1,5079.54,54,1699.976,MORE,-804,2698,1894,3,2,10,0.937408461,10,0.174607574,-0.555869993,-0.210619948,170,80,90,0,0.199450275,0,0.390166852,0.470175924,-0.939832403,0.939832403,0.390166852,0,0,0,0
3089,13,210,25,88,80,1,4872.122,44,1583.84,MORE,-24,2216,2192,3,2,-8,-0.749926769,8,-0.174607574,-1.206644619,-0.457353605,168,88,80,1,0.15956022,0.312133481,0,0.470175924,-0.075924237,0.075924237,0,0.312133481,0,0,0
3090,13,211,36,80,70,0,5923.554,34,1767.921,MORE,-1656,3256,1600,3,2,-10,-0.937408461,10,0.174607574,-1.857419244,0.793375178,150,80,70,1,-0.199450275,0,-0.390166852,0.470175924,-1.883485937,1.883485937,-0.390166852,0,0,0,0
3091,13,212,28,80,93,0,5739.702,64,1569.946,MORE,-844,3042,2198,2,2,13,1.218630999,13,0.698430296,0.094904633,0.574674408,173,80,93,0,0.259285357,0,0.507216907,-0.922937925,-0.984135385,0.984135385,0.507216907,0,0,0,0
3092,13,213,21,82,80,0,3609.935,74,1731.466,MORE,-370,1866,1496,0,2,-2,-0.187481692,2,-1.222253018,0.745679259,-1.958785568,162,82,80,1,0.039890055,0.07803337,0,-3.709165625,-0.459145039,0.459145039,0,0.07803337,1,0,0
3093,13,214,19,50,41,0,4718.206,60,2437.859,MORE,-166,2904,2738,2,2,-9,-0.843667615,9,0,-0.165405217,-0.640444068,91,50,41,1,-1.376206896,-1.170500555,-1.521650721,-0.922937925,-0.233199826,0.233199826,-1.521650721,-1.170500555,0,0,0
3094,13,215,56,96,110,1,5102.42,64,1592.006,MORE,354,2452,2806,3,2,14,1.312371845,14,0.87303787,0.094904633,-0.183403091,206,96,110,0,0.917471264,0.624266962,1.170500555,0.470175924,0.342738951,0.342738951,1.170500555,0.624266962,1,0,1
3095,13,216,23,80,85,1,7662.148,54,1566.158,MORE,-1590,4162,2572,3,2,5,0.46870423,5,-0.698430296,-0.555869993,2.861516112,165,80,85,0,0.099725137,0,0.195083426,0.470175924,-1.810386016,1.810386016,0.195083426,0,0,0,0
3096,13,217,10,60,50,1,4659.4,64,1602.468,MORE,-2186,2912,726,1,2,-10,-0.937408461,10,0.174607574,0.094904633,-0.710396625,110,60,50,1,-0.997251374,-0.780333703,-1.170500555,-2.316051775,-2.47050046,2.47050046,-1.170500555,-0.780333703,1,0,0
3097,13,218,19,41,50,1,4809.091,64,1891.063,MORE,1074,1866,2940,2,2,9,0.843667615,9,0,0.094904633,-0.532332002,91,41,50,0,-1.376206896,-1.521650721,-1.170500555,-0.922937925,1.140192643,1.140192643,-1.170500555,-1.521650721,1,0,1
3098,13,219,56,110,96,1,7848.312,64,1441.21,MORE,536,3408,3944,3,2,-14,-1.312371845,14,0.87303787,0.094904633,3.082967117,206,110,96,1,0.917471264,1.170500555,0.624266962,0.470175924,0.544317523,0.544317523,0.624266962,1.170500555,1,1,1
3099,13,220,35,72,80,1,4250.151,54,1748.633,MORE,-406,2000,1594,2,1,8,0.749926769,8,-0.174607574,-0.555869993,-1.197217935,152,72,80,0,-0.15956022,-0.312133481,0,-0.922937925,-0.499017723,0.499017723,0,-0.312133481,0,0,0
3100,13,221,11,49,50,1,5007.031,64,1758.633,MORE,40,2170,2210,3,2,1,0.093740846,1,-1.396860592,0.094904633,-0.296872881,99,49,50,0,-1.216646676,-1.20951724,-1.170500555,0.470175924,-0.005039464,0.005039464,-1.170500555,-1.20951724,1,1,1
3101,13,222,17,43,50,0,4118.45,44,2027.419,MORE,-854,2148,1294,2,1,7,0.656185922,7,-0.349215148,-1.206644619,-1.35388259,93,43,50,0,-1.336316841,-1.443617351,-1.170500555,-0.922937925,-0.995211131,0.995211131,-1.170500555,-1.443617351,0,0,0
3102,13,223,1,51,50,0,5158.058,44,2255.909,MORE,8,2488,2496,2,2,-1,-0.093740846,1,-1.396860592,-1.206644619,-0.117219022,101,51,50,1,-1.176756621,-1.131483869,-1.170500555,-0.922937925,-0.040481851,0.040481851,-1.170500555,-1.131483869,0,0,1
3103,13,224,41,112,110,0,6182.178,44,2259.906,MORE,-1676,3020,1344,1,1,-2,-0.187481692,2,-1.222253018,-1.206644619,1.101020828,222,112,110,1,1.236591704,1.248533925,1.170500555,-2.316051775,-1.905637429,1.905637429,1.170500555,1.248533925,0,0,0
3104,13,225,20,40,50,1,4159.415,84,1870.659,MORE,404,2424,2828,2,2,10,0.937408461,10,0.174607574,1.396453885,-1.305152758,90,40,50,0,-1.396151924,-1.560667406,-1.170500555,-0.922937925,0.39811768,0.39811768,-1.170500555,-1.560667406,1,0,1
3105,13,226,1,50,51,1,4275.996,54,2357.777,MORE,-498,2198,1700,3,2,1,0.093740846,1,-1.396860592,-0.555869993,-1.166474069,101,50,51,0,-1.176756621,-1.170500555,-1.131483869,0.470175924,-0.600914584,0.600914584,-1.131483869,-1.170500555,0,1,0
3106,13,227,23,85,80,1,5795.236,64,2317.316,MORE,-502,2964,2462,3,2,-5,-0.46870423,5,-0.698430296,0.094904633,0.640734764,165,85,80,1,0.099725137,0.195083426,0,0.470175924,-0.605344882,0.605344882,0,0.195083426,1,1,0
3107,13,228,11,50,49,1,6365.796,54,1851.985,MORE,-1684,3554,1870,3,2,-1,-0.093740846,1,-1.396860592,-0.555869993,1.319443244,99,50,49,1,-1.216646676,-1.170500555,-1.20951724,0.470175924,-1.914498025,1.914498025,-1.20951724,-1.170500555,0,1,0
3108,13,229,17,50,43,0,5776.521,54,1963.756,MORE,716,2236,2952,2,2,-7,-0.656185922,7,-0.349215148,-0.555869993,0.618472374,93,50,43,1,-1.336316841,-1.170500555,-1.443617351,-0.922937925,0.743680946,0.743680946,-1.443617351,-1.170500555,0,0,1
3109,13,230,21,80,82,1,5259.883,74,3137.558,MORE,584,2966,3550,2,2,2,0.187481692,2,-1.222253018,0.745679259,0.003906699,162,80,82,0,0.039890055,0,0.07803337,-0.922937925,0.597481103,0.597481103,0.07803337,0,1,0,1
3110,13,231,10,50,60,1,4087.283,74,1572.575,MORE,742,2026,2768,3,2,10,0.937408461,10,0.174607574,0.745679259,-1.390957231,110,50,60,0,-0.997251374,-1.170500555,-0.780333703,0.470175924,0.772477885,0.772477885,-0.780333703,-1.170500555,1,1,1
3111,13,232,3,53,50,0,5729.785,54,2802.549,MORE,-516,2792,2276,2,1,-3,-0.281222538,3,-1.047645444,-0.555869993,0.562877661,103,53,50,1,-1.136866566,-1.053450499,-1.170500555,-0.922937925,-0.620850926,0.620850926,-1.170500555,-1.053450499,0,0,0
3112,13,233,45,122,110,0,5653.554,64,1589.888,MORE,-374,2690,2316,3,2,-12,-1.124890153,12,0.523822722,0.094904633,0.472197231,232,122,110,1,1.436041979,1.638700776,1.170500555,0.470175924,-0.463575337,0.463575337,1.170500555,1.638700776,1,1,0
3113,13,234,38,67,80,1,4699.603,44,2194.309,MORE,694,1872,2566,3,2,13,1.218630999,13,0.698430296,-1.206644619,-0.662573229,147,67,80,0,-0.259285357,-0.507216907,0,0.470175924,0.719314305,0.719314305,0,-0.507216907,0,1,1
3114,13,235,38,80,67,0,5410.811,64,2013.735,MORE,168,2286,2454,2,2,-13,-1.218630999,13,0.698430296,0.094904633,0.183442792,147,80,67,1,-0.259285357,0,-0.507216907,-0.922937925,0.136730081,0.136730081,-0.507216907,0,0,0,1
3115,13,236,36,70,80,1,5424.203,60,2207.366,MORE,1002,2850,3852,3,2,10,0.937408461,10,0.174607574,-0.165405217,0.199373218,150,70,80,0,-0.199450275,-0.390166852,0,0.470175924,1.060447273,1.060447273,0,-0.390166852,0,1,1
3116,13,237,45,110,122,1,4785.365,44,2445.317,MORE,-774,2446,1672,2,2,12,1.124890153,12,0.523822722,-1.206644619,-0.560555217,232,110,122,0,1.436041979,1.170500555,1.638700776,-0.922937925,-0.906605165,0.906605165,1.638700776,1.170500555,0,0,0
3117,13,238,42,110,115,0,3572.615,74,2394.636,MORE,320,1986,2306,2,2,5,0.46870423,5,-0.698430296,0.745679259,-2.003179497,225,110,115,0,1.296426786,1.170500555,1.36558398,-0.922937925,0.305081416,0.305081416,1.36558398,1.170500555,1,0,1
3118,13,239,41,110,112,1,5652.393,34,1632.441,MORE,-618,2832,2214,3,2,2,0.187481692,2,-1.222253018,-1.857419244,0.470816166,222,110,112,0,1.236591704,1.170500555,1.248533925,0.470175924,-0.733823532,0.733823532,1.248533925,1.170500555,0,1,0
3119,13,240,53,110,103,0,4758.971,74,1922.081,MORE,28,2394,2422,2,2,-7,-0.656185922,7,-0.349215148,0.745679259,-0.591952146,213,110,103,1,1.057086457,1.170500555,0.897383758,-0.922937925,-0.018330359,0.018330359,0.897383758,1.170500555,1,0,1
3120,14,1,49,110,131,1,2411.837,80,854.618,MORE,10,1150,1160,3,2,21,1.968557767,21,2.095290887,1.049123911,-0.343643207,241,110,131,0,1.615547226,1.170500555,1.989850943,-0.190561955,0.238498142,0.238498142,1.989850943,1.170500555,1,1,1
3121,14,2,13,47,50,0,2699.638,80,1141.175,MORE,-210,1264,1054,4,1,3,0.281222538,3,-1.047645444,1.049123911,-0.186301246,97,47,50,0,-1.256536731,-1.28755061,-1.170500555,0.403397384,-0.011030291,0.011030291,-1.170500555,-1.28755061,1,1,1
3122,14,3,16,50,44,0,5223.695,70,1276.617,MORE,-330,2550,2220,6,1,-6,-0.562445076,6,-0.523822722,0.642355351,1.193610838,94,50,44,1,-1.316371814,-1.170500555,-1.404600665,1.591316063,-0.147136709,0.147136709,-1.404600665,-1.170500555,1,1,0
3123,14,4,7,57,50,0,4476.188,80,1002.49,MORE,-874,2368,1494,6,1,-7,-0.656185922,7,-0.349215148,1.049123911,0.784945763,107,57,50,1,-1.057086457,-0.897383758,-1.170500555,1.591316063,-0.764152469,0.764152469,-1.170500555,-0.897383758,1,1,0
3124,14,5,18,42,50,1,2077.934,60,587.698,MORE,-146,1072,926,4,1,8,0.749926769,8,-0.174607574,0.235586791,-0.526189316,92,42,50,0,-1.356261869,-1.482634036,-1.170500555,0.403397384,0.061559799,0.061559799,-1.170500555,-1.482634036,1,1,1
3125,14,6,51,108,110,1,7788.119,50,1538.083,MORE,-528,3986,3458,9,1,2,0.187481692,2,-1.222253018,-0.171181769,2.595591722,218,108,110,0,1.156811594,1.092467184,1.170500555,3.37319408,-0.371712298,0.371712298,1.170500555,1.092467184,0,1,0
3126,14,7,31,78,80,0,4302.3,40,1273.833,MORE,-238,2098,1860,6,1,2,0.187481692,2,-1.222253018,-0.577950329,0.689880496,158,78,80,0,-0.039890055,-0.07803337,0,1.591316063,-0.042788455,0.042788455,0,-0.07803337,0,1,1
3127,14,8,58,110,92,0,1526.463,80,235.314,MORE,-398,952,554,2,1,-18,-1.687335229,18,1.571468165,1.049123911,-0.827680723,202,110,92,1,0.837691154,1.170500555,0.468200222,-0.784521294,-0.224263679,0.224263679,0.468200222,1.170500555,1,0,0
3128,14,9,12,50,48,0,3183.118,30,1552.093,MORE,-364,1596,1232,4,1,-2,-0.187481692,2,-1.222253018,-0.984718889,0.078019209,98,50,48,1,-1.236591704,-1.170500555,-1.248533925,0.403397384,-0.185700194,0.185700194,-1.248533925,-1.170500555,0,1,0
3129,14,10,54,110,101,0,3205.175,50,951.677,MORE,-446,1714,1268,2,1,-9,-0.843667615,9,0,-0.171181769,0.090077859,211,110,101,1,1.017196402,1.170500555,0.819350388,-0.784521294,-0.278706246,0.278706246,0.819350388,1.170500555,0,0,0
3130,14,11,14,46,50,1,1604.214,70,841.297,MORE,708,400,1108,1,2,4,0.374963384,4,-0.87303787,0.642355351,-0.785173939,96,46,50,0,-1.276481759,-1.326567295,-1.170500555,-1.378480633,1.030183805,1.030183805,-1.170500555,-1.326567295,1,0,1
3131,14,12,22,80,83,1,6530.474,60,1503.663,MORE,1262,2286,3548,5,2,3,0.281222538,3,-1.047645444,0.235586791,1.908032157,163,80,83,0,0.059835082,0,0.117050055,0.997356724,1.658541767,1.658541767,0.117050055,0,1,1,1
3132,14,13,6,50,56,1,1491.157,100,1636.762,MORE,1940,428,2368,1,2,6,0.562445076,6,-0.523822722,1.862661031,-0.846982654,106,50,56,0,-1.077031484,-1.170500555,-0.936400444,-1.378480633,2.427543028,2.427543028,-0.936400444,-1.170500555,1,0,1
3133,14,14,13,50,47,0,1333.873,80,982.562,MORE,-28,762,734,2,2,-3,-0.281222538,3,-1.047645444,1.049123911,-0.932970448,97,50,47,1,-1.256536731,-1.170500555,-1.28755061,-0.784521294,0.195397776,0.195397776,-1.28755061,-1.170500555,1,0,1
3134,14,15,46,110,124,0,6532.274,30,1480.169,MORE,-672,3336,2664,8,2,14,1.312371845,14,0.87303787,-0.984718889,1.909016224,234,110,124,0,1.475932034,1.170500555,1.716734147,2.779234741,-0.535039999,0.535039999,1.716734147,1.170500555,0,1,0
3135,14,16,27,91,80,0,4038.85,80,808.026,MORE,-338,2096,1758,4,2,-11,-1.031149307,11,0.349215148,1.049123911,0.545851325,171,91,80,1,0.219395302,0.429183537,0,0.403397384,-0.15621047,0.15621047,0,0.429183537,1,1,0
3136,14,17,40,64,80,1,2546.243,80,357.575,MORE,276,1028,1304,3,2,16,1.499853537,16,1.222253018,1.049123911,-0.270162907,144,64,80,0,-0.31912044,-0.624266962,0,-0.190561955,0.540200701,0.540200701,0,-0.624266962,1,0,1
3137,14,18,22,83,80,0,4194.065,30,1049.154,MORE,-1434,2920,1486,4,1,-3,-0.281222538,3,-1.047645444,-0.984718889,0.630707988,163,83,80,1,0.059835082,0.117050055,0,0.403397384,-1.399315752,1.399315752,0,0.117050055,0,1,0
3138,14,19,54,101,110,0,3940.452,0,1420.001,MORE,-984,2568,1584,4,1,9,0.843667615,9,0,-2.205024569,0.492056744,211,101,110,0,1.017196402,0.819350388,1.170500555,0.403397384,-0.888916686,0.888916686,1.170500555,0.819350388,0,1,0
3139,14,20,6,56,50,0,2702.658,30,368.866,MORE,-414,1348,934,4,1,-6,-0.562445076,6,-0.523822722,-0.984718889,-0.1846502,106,56,50,1,-1.077031484,-0.936400444,-1.170500555,0.403397384,-0.242411201,0.242411201,-1.170500555,-0.936400444,0,1,0
3140,14,21,18,50,42,0,4240.585,60,275.385,MORE,-1736,2766,1030,4,1,-8,-0.749926769,8,-0.174607574,0.235586791,0.656140658,92,50,42,1,-1.356261869,-1.170500555,-1.482634036,0.403397384,-1.741850237,1.741850237,-1.482634036,-1.170500555,1,1,0
3141,14,22,43,110,117,0,2314.874,40,1653.171,MORE,-708,1476,768,2,1,7,0.656185922,7,-0.349215148,-0.577950329,-0.396653267,227,110,117,0,1.336316841,1.170500555,1.443617351,-0.784521294,-0.575871925,0.575871925,1.443617351,1.170500555,0,0,0
3142,14,23,32,77,80,0,3636.833,50,1090.861,MORE,-1242,2158,916,2,1,3,0.281222538,3,-1.047645444,-0.171181769,0.326067019,157,77,80,0,-0.059835082,-0.117050055,0,-0.784521294,-1.181545484,1.181545484,0,-0.117050055,0,0,0
3143,14,24,27,80,91,1,1793.383,70,418.954,MORE,816,436,1252,1,2,11,1.031149307,11,0.349215148,0.642355351,-0.681754488,171,80,91,0,0.219395302,0,0.429183537,-1.378480633,1.152679581,1.152679581,0.429183537,0,1,0,1
3144,14,25,16,44,50,1,4592.348,30,493.313,MORE,-200,2152,1952,5,2,6,0.562445076,6,-0.523822722,-0.984718889,0.848450901,94,44,50,0,-1.316371814,-1.404600665,-1.170500555,0.997356724,0.000311911,0.000311911,-1.170500555,-1.404600665,0,1,1
3145,14,26,7,50,57,1,4757.369,70,2341.392,MORE,-536,2638,2102,4,1,7,0.656185922,7,-0.349215148,0.642355351,0.938668543,107,50,57,0,-1.057086457,-1.170500555,-0.897383758,0.403397384,-0.380786059,0.380786059,-0.897383758,-1.170500555,1,1,0
3146,14,27,14,50,46,0,8235.293,20,2586.734,MORE,-2564,5006,2442,4,1,-4,-0.374963384,4,-0.87303787,-1.391487449,2.840063541,96,50,46,1,-1.276481759,-1.170500555,-1.326567295,0.403397384,-2.68098452,2.68098452,-1.326567295,-1.170500555,0,1,0
3147,14,28,51,110,108,1,6841.092,40,1083.22,MORE,954,2304,3258,7,2,-2,-0.187481692,2,-1.222253018,-0.577950329,2.077848263,218,110,108,1,1.156811594,1.170500555,1.092467184,2.185275402,1.309201962,1.309201962,1.092467184,1.170500555,0,1,1
3148,14,29,50,133,110,0,2101.964,40,1176.744,MORE,-924,1536,612,2,1,-23,-2.15603946,23,2.444506035,-0.577950329,-0.513052018,243,133,110,1,1.655437281,2.067884313,1.170500555,-0.784521294,-0.820863477,0.820863477,1.170500555,2.067884313,0,0,0
3149,14,30,49,131,110,0,1568.791,70,189.699,MORE,-290,762,472,2,1,-21,-1.968557767,21,2.095290887,0.642355351,-0.804539835,241,131,110,1,1.615547226,1.989850943,1.170500555,-0.784521294,-0.101767903,0.101767903,1.170500555,1.989850943,1,0,0
3150,14,31,47,126,110,0,2712.183,60,967.443,MORE,-60,1312,1252,2,1,-16,-1.499853537,16,1.222253018,0.235586791,-0.179442844,236,126,110,1,1.515822089,1.794767517,1.170500555,-0.784521294,0.159102731,0.159102731,1.170500555,1.794767517,1,0,1
3151,14,32,50,110,133,1,5973.21,40,1221.074,MORE,560,2452,3012,4,2,23,2.15603946,23,2.444506035,-0.577950329,1.603373694,243,110,133,0,1.655437281,1.170500555,2.067884313,0.403397384,0.862319223,0.862319223,2.067884313,1.170500555,0,1,1
3152,14,33,47,110,126,1,3141.054,80,1902.409,MORE,402,1196,1598,5,2,16,1.499853537,16,1.222253018,1.049123911,0.055022652,236,110,126,0,1.515822089,1.170500555,1.794767517,0.997356724,0.68311244,0.68311244,1.794767517,1.170500555,1,1,1
3153,14,34,12,48,50,1,1848.953,10,2070.248,MORE,-692,1618,926,3,1,2,0.187481692,2,-1.222253018,-1.798256009,-0.651374147,98,48,50,0,-1.236591704,-1.248533925,-1.170500555,-0.190561955,-0.557724402,0.557724402,-1.170500555,-1.248533925,0,1,0
3154,14,35,32,80,77,0,2688.136,70,843.391,MORE,-212,1268,1056,4,1,-3,-0.281222538,3,-1.047645444,0.642355351,-0.192589435,157,80,77,1,-0.059835082,0,-0.117050055,0.403397384,-0.013298731,0.013298731,-0.117050055,0,1,1,1
3155,14,36,43,117,110,0,6172.306,30,1392.712,MORE,-1922,3952,2030,8,1,-7,-0.656185922,7,-0.349215148,-0.984718889,1.712220275,227,117,110,1,1.336316841,1.443617351,1.170500555,2.779234741,-1.952815185,1.952815185,1.170500555,1.443617351,0,1,0
3156,14,37,40,80,64,0,3677.141,80,904.659,MORE,-1306,2256,950,4,1,-16,-1.499853537,16,1.222253018,1.049123911,0.348103564,144,80,64,1,-0.31912044,0,-0.624266962,0.403397384,-1.254135573,1.254135573,-0.624266962,0,1,1,0
3157,14,38,31,80,78,0,5200.268,10,1319.979,MORE,328,2562,2890,4,1,-2,-0.187481692,2,-1.222253018,-1.798256009,1.180803203,158,80,78,1,-0.039890055,0,-0.07803337,0.403397384,0.599180149,0.599180149,-0.07803337,0,0,1,1
3158,14,39,46,124,110,0,2072.589,40,1176.386,MORE,-576,1092,516,2,1,-14,-1.312371845,14,0.87303787,-0.577950329,-0.529111449,234,124,110,1,1.475932034,1.716734147,1.170500555,-0.784521294,-0.426154865,0.426154865,1.170500555,1.716734147,0,0,0
3159,14,40,58,92,110,1,4900.079,50,884.218,MORE,-468,2418,1950,7,2,18,1.687335229,18,1.571468165,-0.171181769,1.016688673,202,92,110,0,0.837691154,0.468200222,1.170500555,2.185275402,-0.303659089,0.303659089,1.170500555,0.468200222,0,1,0
3160,14,41,49,110,131,0,3324.308,20,710.031,LESS,-976,2104,1128,4,1,21,1.968557767,21,2.095290887,-1.391487449,0.155208348,241,110,131,1,1.615547226,1.170500555,1.989850943,0.403397384,-0.879842925,0.879842925,1.989850943,1.170500555,0,1,0
3161,14,42,13,47,50,1,4480.32,70,1175.852,LESS,846,1584,2430,4,2,3,0.281222538,3,-1.047645444,0.642355351,0.787204744,97,47,50,1,-1.256536731,-1.28755061,-1.170500555,0.403397384,1.186706186,1.186706186,-1.170500555,-1.28755061,1,1,1
3162,14,43,16,50,44,1,2523.038,40,1102.599,LESS,472,830,1302,3,2,-6,-0.562445076,6,-0.523822722,-0.577950329,-0.282849174,94,50,44,0,-1.316371814,-1.170500555,-1.404600665,-0.190561955,0.76250785,0.76250785,-1.404600665,-1.170500555,0,0,1
3163,14,44,7,57,50,1,2791.339,30,401.058,LESS,582,998,1580,3,2,-7,-0.656185922,7,-0.349215148,-0.984718889,-0.136167941,107,57,50,0,-1.057086457,-0.897383758,-1.170500555,-0.190561955,0.887272066,0.887272066,-1.170500555,-0.897383758,0,0,1
3164,14,45,18,42,50,0,6684.934,50,2013.367,LESS,648,2968,3616,8,2,8,0.749926769,8,-0.174607574,-0.171181769,1.992476058,92,42,50,1,-1.356261869,-1.482634036,-1.170500555,2.779234741,0.962130596,0.962130596,-1.170500555,-1.482634036,0,1,1
3165,14,46,51,108,110,0,4055.65,20,1971.936,LESS,-436,2266,1830,4,2,2,0.187481692,2,-1.222253018,-1.391487449,0.555035952,218,108,110,1,1.156811594,1.092467184,1.170500555,0.403397384,-0.267364044,0.267364044,1.170500555,1.092467184,0,1,0
3166,14,47,31,78,80,0,3286.518,20,1907.924,LESS,148,1514,1662,4,2,2,0.187481692,2,-1.222253018,-1.391487449,0.134548404,158,78,80,1,-0.039890055,-0.07803337,0,0.403397384,0.395020522,0.395020522,0,-0.07803337,0,1,1
3167,14,48,58,110,92,1,2964.972,30,1269,LESS,664,1032,1696,3,2,-18,-1.687335229,18,1.571468165,-0.984718889,-0.041242084,202,110,92,0,0.837691154,1.170500555,0.468200222,-0.190561955,0.980278119,0.980278119,0.468200222,1.170500555,0,0,1
3168,14,49,12,50,48,0,5929.486,30,1371.025,LESS,410,2526,2936,4,1,-2,-0.187481692,2,-1.222253018,-0.984718889,1.579469607,98,50,48,0,-1.236591704,-1.170500555,-1.248533925,0.403397384,0.692186201,0.692186201,-1.248533925,-1.170500555,0,1,1
3169,14,50,54,110,101,1,1761.845,70,1709.992,LESS,970,364,1334,1,2,-9,-0.843667615,9,0,0.642355351,-0.698996439,211,110,101,0,1.017196402,1.170500555,0.819350388,-1.378480633,1.327349484,1.327349484,0.819350388,1.170500555,1,0,1
3170,14,51,14,46,50,0,1419.557,10,257.402,LESS,-340,788,448,2,1,4,0.374963384,4,-0.87303787,-1.798256009,-0.886126662,96,46,50,1,-1.276481759,-1.326567295,-1.170500555,-0.784521294,-0.15847891,0.15847891,-1.170500555,-1.326567295,0,0,0
3171,14,52,22,80,83,0,1643.956,10,932.18,LESS,-656,1444,788,4,1,3,0.281222538,3,-1.047645444,-1.798256009,-0.763446828,163,80,83,1,0.059835082,0,0.117050055,0.403397384,-0.516892477,0.516892477,0.117050055,0,0,1,0
3172,14,53,6,50,56,0,1249.042,40,164.52,LESS,-264,668,404,2,1,6,0.562445076,6,-0.523822722,-0.577950329,-0.979347896,106,50,56,1,-1.077031484,-1.170500555,-0.936400444,-0.784521294,-0.072278179,0.072278179,-0.936400444,-1.170500555,0,0,0
3173,14,54,13,50,47,0,1372.969,90,1010.681,LESS,-46,768,722,2,2,-3,-0.281222538,3,-1.047645444,1.455892471,-0.911596508,97,50,47,0,-1.256536731,-1.170500555,-1.28755061,-0.784521294,0.174981813,0.174981813,-1.28755061,-1.170500555,1,0,1
3174,14,55,46,110,124,0,2401.027,20,1514.342,LESS,-556,1468,912,4,1,14,1.312371845,14,0.87303787,-1.391487449,-0.349553077,234,110,124,1,1.475932034,1.170500555,1.716734147,0.403397384,-0.403470462,0.403470462,1.716734147,1.170500555,0,1,0
3175,14,56,27,91,80,0,1245.098,60,1177.377,LESS,-326,720,394,2,1,-11,-1.031149307,11,0.349215148,0.235586791,-0.981504096,171,91,80,0,0.219395302,0.429183537,0,-0.784521294,-0.142599828,0.142599828,0,0.429183537,0,0,0
3176,14,57,40,64,80,0,1233.281,70,884.681,LESS,-384,762,378,2,1,16,1.499853537,16,1.222253018,0.642355351,-0.987964498,144,64,80,1,-0.31912044,-0.624266962,0,-0.784521294,-0.208384597,0.208384597,0,-0.624266962,1,0,0
3177,14,58,22,83,80,0,1342.216,20,381.341,LESS,-470,884,414,2,1,-3,-0.281222538,3,-1.047645444,-1.391487449,-0.928409296,163,83,80,0,0.059835082,0.117050055,0,-0.784521294,-0.305927529,0.305927529,0,0.117050055,0,0,0
3178,14,59,54,101,110,0,1259.717,50,935.216,LESS,-326,714,388,2,1,9,0.843667615,9,0,-0.171181769,-0.973511831,211,101,110,1,1.017196402,0.819350388,1.170500555,-0.784521294,-0.142599828,0.142599828,1.170500555,0.819350388,0,0,0
3179,14,60,6,56,50,1,2073.05,80,299.835,LESS,442,778,1220,3,2,-6,-0.562445076,6,-0.523822722,1.049123911,-0.528859418,106,56,50,0,-1.077031484,-0.936400444,-1.170500555,-0.190561955,0.728481246,0.728481246,-1.170500555,-0.936400444,1,1,1
3180,14,61,18,50,42,1,3773.646,50,1578.817,LESS,1704,858,2562,3,2,-8,-0.749926769,8,-0.174607574,-0.171181769,0.400863235,92,50,42,0,-1.356261869,-1.170500555,-1.482634036,-0.190561955,2.159867073,2.159867073,-1.482634036,-1.170500555,0,1,1
3181,14,62,43,110,117,0,1497.685,80,1411.414,LESS,-440,970,530,2,2,7,0.656185922,7,-0.349215148,1.049123911,-0.843413771,227,110,117,1,1.336316841,1.170500555,1.443617351,-0.784521294,-0.271900925,0.271900925,1.443617351,1.170500555,1,0,0
3182,14,63,32,77,80,1,2165.322,20,1446.074,LESS,-812,1910,1098,4,1,3,0.281222538,3,-1.047645444,-1.391487449,-0.478413946,157,77,80,1,-0.059835082,-0.117050055,0,0.403397384,-0.69383082,0.69383082,0,-0.117050055,0,1,0
3183,14,64,27,80,91,0,1272.365,50,963.232,LESS,-312,686,374,2,1,11,1.031149307,11,0.349215148,-0.171181769,-0.966597118,171,80,91,1,0.219395302,0,0.429183537,-0.784521294,-0.126720746,0.126720746,0.429183537,0,0,0,0
3184,14,65,16,44,50,0,1367.841,20,875.872,LESS,-922,1342,420,2,1,6,0.562445076,6,-0.523822722,-1.391487449,-0.914400006,94,44,50,1,-1.316371814,-1.404600665,-1.170500555,-0.784521294,-0.818595037,0.818595037,-1.170500555,-1.404600665,0,0,0
3185,14,66,7,50,57,0,2336.13,80,696.736,LESS,-68,1114,1046,4,2,7,0.656185922,7,-0.349215148,1.049123911,-0.385032527,107,50,57,1,-1.057086457,-1.170500555,-0.897383758,0.403397384,0.15002897,0.15002897,-0.897383758,-1.170500555,1,1,0
3186,14,67,14,50,46,1,2073.203,50,1167.084,LESS,388,760,1148,3,2,-4,-0.374963384,4,-0.87303787,-0.171181769,-0.528775772,96,50,46,0,-1.276481759,-1.170500555,-1.326567295,-0.190561955,0.667233358,0.667233358,-1.326567295,-1.170500555,0,0,1
3187,14,68,51,110,108,1,2271.048,0,1011.375,LESS,-680,1806,1126,4,1,-2,-0.187481692,2,-1.222253018,-2.205024569,-0.420613117,218,110,108,0,1.156811594,1.170500555,1.092467184,0.403397384,-0.544113761,0.544113761,1.092467184,1.170500555,0,1,0
3188,14,69,50,133,110,1,1945.156,20,1763.843,LESS,336,718,1054,3,1,-23,-2.15603946,23,2.444506035,-1.391487449,-0.598779581,243,133,110,0,1.655437281,2.067884313,1.170500555,-0.190561955,0.60825391,0.60825391,1.170500555,2.067884313,0,1,1
3189,14,70,49,131,110,1,8341.024,50,1587.032,LESS,2288,2732,5020,7,2,-21,-1.968557767,21,2.095290887,-0.171181769,2.897867102,241,131,110,0,1.615547226,1.989850943,1.170500555,2.185275402,2.822251639,2.822251639,1.170500555,1.989850943,0,1,1
3190,14,71,47,126,110,1,1665.83,40,315.821,LESS,862,320,1182,1,2,-16,-1.499853537,16,1.222253018,-0.577950329,-0.751488225,236,126,110,0,1.515822089,1.794767517,1.170500555,-1.378480633,1.204853708,1.204853708,1.170500555,1.794767517,0,0,1
3191,14,72,50,110,133,0,1219.089,70,623.507,LESS,-302,668,366,2,1,23,2.15603946,23,2.444506035,0.642355351,-0.995723321,243,110,133,1,1.655437281,1.170500555,2.067884313,-0.784521294,-0.115378545,0.115378545,2.067884313,1.170500555,1,0,0
3192,14,73,47,110,126,0,1168.573,70,648.031,LESS,-234,588,354,2,1,16,1.499853537,16,1.222253018,0.642355351,-1.023340621,236,110,126,1,1.515822089,1.170500555,1.794767517,-0.784521294,-0.038251575,0.038251575,1.794767517,1.170500555,1,0,0
3193,14,74,12,48,50,0,1321.304,80,1268.104,LESS,-18,728,710,2,2,2,0.187481692,2,-1.222253018,1.049123911,-0.939841971,98,48,50,1,-1.236591704,-1.248533925,-1.170500555,-0.784521294,0.206739978,0.206739978,-1.170500555,-1.248533925,1,0,1
3194,14,75,32,80,77,0,1316.62,10,1253.907,LESS,-682,1056,374,2,1,-3,-0.281222538,3,-1.047645444,-1.798256009,-0.942402732,157,80,77,0,-0.059835082,0,-0.117050055,-0.784521294,-0.546382201,0.546382201,-0.117050055,0,0,0,0
3195,14,76,43,117,110,0,1399.691,70,251.379,LESS,-596,1006,410,2,1,-7,-0.656185922,7,-0.349215148,0.642355351,-0.896987483,227,117,110,0,1.336316841,1.443617351,1.170500555,-0.784521294,-0.448839268,0.448839268,1.170500555,1.443617351,1,0,0
3196,14,77,40,80,64,1,2336.324,60,1328.116,LESS,376,1074,1450,4,1,-16,-1.499853537,16,1.222253018,0.235586791,-0.384926466,144,80,64,0,-0.31912044,0,-0.624266962,0.403397384,0.653622716,0.653622716,-0.624266962,0,0,1,1
3197,14,78,31,80,78,0,1289.006,30,1303.604,LESS,-692,1032,340,2,1,-2,-0.187481692,2,-1.222253018,-0.984718889,-0.957499417,158,80,78,0,-0.039890055,0,-0.07803337,-0.784521294,-0.557724402,0.557724402,-0.07803337,0,0,0,0
3198,14,79,46,124,110,1,2602.567,40,1234.995,LESS,178,1072,1250,5,2,-14,-1.312371845,14,0.87303787,-0.577950329,-0.239370351,234,124,110,0,1.475932034,1.716734147,1.170500555,0.997356724,0.429047127,0.429047127,1.170500555,1.716734147,0,1,1
3199,14,80,58,92,110,0,1337.46,70,696.517,LESS,-318,746,428,2,2,18,1.687335229,18,1.571468165,0.642355351,-0.931009421,202,92,110,1,0.837691154,0.468200222,1.170500555,-0.784521294,-0.133526067,0.133526067,1.170500555,0.468200222,1,0,0
3200,14,81,48,128,110,0,5015.075,30,1107.934,MORE,-1460,3046,1586,6,1,-18,-1.687335229,18,1.571468165,-0.984718889,1.079557447,238,128,110,1,1.555712144,1.872800887,1.170500555,1.591316063,-1.428805476,1.428805476,1.170500555,1.872800887,0,1,0
3201,14,82,8,50,58,1,1367.363,20,634.343,MORE,656,310,966,1,2,8,0.749926769,8,-0.174607574,-1.391487449,-0.914661331,108,50,58,0,-1.037141429,-1.170500555,-0.858367073,-1.378480633,0.971204357,0.971204357,-0.858367073,-1.170500555,0,0,1
3202,14,83,4,54,50,0,2077.351,70,1452.631,MORE,-98,1336,1238,2,2,-4,-0.374963384,4,-0.87303787,0.642355351,-0.526508044,104,54,50,1,-1.116921539,-1.014433814,-1.170500555,-0.784521294,0.116002366,0.116002366,-1.170500555,-1.014433814,1,0,1
3203,14,84,37,80,69,0,3691.81,50,1071.171,MORE,208,1468,1676,2,1,-11,-1.031149307,11,0.349215148,-0.171181769,0.356123165,149,80,69,1,-0.219395302,0,-0.429183537,-0.784521294,0.463073731,0.463073731,-0.429183537,0,0,0,1
3204,14,85,52,105,110,0,2172.653,40,1316.531,MORE,-1438,2166,728,2,1,5,0.46870423,5,-0.698430296,-0.577950329,-0.474406058,215,105,110,0,1.096976512,0.975417129,1.170500555,-0.784521294,-1.403852633,1.403852633,1.170500555,0.975417129,0,0,0
3205,14,86,5,55,50,0,3391.115,30,1689.287,MORE,-108,1482,1374,4,1,-5,-0.46870423,5,-0.698430296,-0.984718889,0.191732003,105,55,50,1,-1.096976512,-0.975417129,-1.170500555,0.403397384,0.104660164,0.104660164,-1.170500555,-0.975417129,0,1,1
3206,14,87,30,96,80,0,2218.531,100,1542.059,MORE,-258,1578,1320,2,2,-16,-1.499853537,16,1.222253018,1.862661031,-0.449324372,176,96,80,1,0.31912044,0.624266962,0,-0.784521294,-0.065472858,0.065472858,0,0.624266962,1,0,0
3207,14,88,33,80,75,1,2659.04,30,1375.041,MORE,460,716,1176,3,2,-5,-0.46870423,5,-0.698430296,-0.984718889,-0.208496335,155,80,75,1,-0.099725137,0,-0.195083426,-0.190561955,0.748897208,0.748897208,-0.195083426,0,0,1,1
3208,14,89,48,110,128,1,2667.889,70,1515.914,MORE,38,1208,1246,4,1,18,1.687335229,18,1.571468165,0.642355351,-0.203658551,238,110,128,0,1.555712144,1.170500555,1.872800887,0.403397384,0.270256306,0.270256306,1.872800887,1.170500555,1,1,1
3209,14,90,9,59,50,0,6196.985,20,413.549,MORE,-1460,3560,2100,6,1,-9,-0.843667615,9,0,-1.391487449,1.725712383,109,59,50,1,-1.017196402,-0.819350388,-1.170500555,1.591316063,-1.428805476,1.428805476,-1.170500555,-0.819350388,0,1,0
3210,14,91,44,110,119,1,5425.233,10,776.627,MORE,-378,2798,2420,8,1,9,0.843667615,9,0,-1.798256009,1.30379247,229,110,119,0,1.376206896,1.170500555,1.521650721,2.779234741,-0.201579276,0.201579276,1.521650721,1.170500555,0,1,0
3211,14,92,2,52,50,0,2724.346,40,1933.971,MORE,-1874,2504,630,2,1,-2,-0.187481692,2,-1.222253018,-0.577950329,-0.172793283,102,52,50,1,-1.156811594,-1.092467184,-1.170500555,-0.784521294,-1.898372618,1.898372618,-1.170500555,-1.092467184,0,0,0
3212,14,93,8,58,50,0,3105.605,60,1115.963,MORE,-468,1910,1442,4,2,-8,-0.749926769,8,-0.174607574,0.235586791,0.035642541,108,58,50,1,-1.037141429,-0.858367073,-1.170500555,0.403397384,-0.303659089,0.303659089,-1.170500555,-0.858367073,1,1,0
3213,14,94,44,119,110,0,10200.481,30,955.796,MORE,-4352,6796,2444,3,1,-9,-0.843667615,9,0,-0.984718889,3.914439701,229,119,110,1,1.376206896,1.521650721,1.170500555,-0.190561955,-4.708970145,4.708970145,1.170500555,1.521650721,0,1,0
3214,14,95,34,74,80,1,1216.532,60,1285.047,MORE,558,292,850,2,1,6,0.562445076,6,-0.523822722,0.235586791,-0.997121243,154,74,80,0,-0.119670165,-0.234100111,0,-0.784521294,0.860050783,0.860050783,0,-0.234100111,1,0,1
3215,14,96,24,86,80,0,2016.147,30,1005.393,MORE,-1292,1854,562,2,1,-6,-0.562445076,6,-0.523822722,-0.984718889,-0.559968516,166,86,80,1,0.119670165,0.234100111,0,-0.784521294,-1.238256491,1.238256491,0,0.234100111,0,0,0
3216,14,97,39,66,80,1,1319.821,60,1464.62,MORE,-46,708,662,3,2,14,1.312371845,14,0.87303787,0.235586791,-0.940652733,146,66,80,0,-0.279230385,-0.546233592,0,-0.190561955,0.174981813,0.174981813,0,-0.546233592,1,1,1
3217,14,98,9,50,59,1,2841.325,60,888.738,MORE,332,930,1262,3,2,9,0.843667615,9,0,0.235586791,-0.108840395,109,50,59,0,-1.017196402,-1.170500555,-0.819350388,-0.190561955,0.603717029,0.603717029,-0.819350388,-1.170500555,1,1,1
3218,14,99,57,94,110,1,3073.944,50,1631.664,MORE,316,1356,1672,4,1,16,1.499853537,16,1.222253018,-0.171181769,0.018333345,204,94,110,0,0.877581209,0.546233592,1.170500555,0.403397384,0.585569507,0.585569507,1.170500555,0.546233592,0,1,1
3219,14,100,60,110,87,0,1385.729,60,981.131,MORE,264,720,984,2,2,-23,-2.15603946,23,2.444506035,0.235586791,-0.904620565,197,110,87,1,0.737966017,1.170500555,0.273116796,-0.784521294,0.526590059,0.526590059,0.273116796,1.170500555,1,0,1
3220,14,101,33,75,80,0,3229.698,20,1078.341,MORE,-1586,2630,1044,4,1,5,0.46870423,5,-0.698430296,-1.391487449,0.103484682,155,75,80,0,-0.099725137,-0.195083426,0,0.403397384,-1.571717215,1.571717215,0,-0.195083426,0,1,0
3221,14,102,15,50,45,0,1760.556,30,1171.994,MORE,-1332,1870,538,2,1,-5,-0.46870423,5,-0.698430296,-0.984718889,-0.699701141,95,50,45,1,-1.296426786,-1.170500555,-1.36558398,-0.784521294,-1.283625297,1.283625297,-1.36558398,-1.170500555,0,0,0
3222,14,103,59,89,110,1,3067.113,60,1039.627,MORE,460,1174,1634,3,2,21,1.968557767,21,2.095290887,0.235586791,0.01459881,199,89,110,0,0.777856072,0.351150166,1.170500555,-0.190561955,0.748897208,0.748897208,1.170500555,0.351150166,1,0,1
3223,14,104,29,80,94,1,1504.947,60,1325.863,MORE,566,416,982,1,2,14,1.312371845,14,0.87303787,0.235586791,-0.839443606,174,80,94,0,0.279230385,0,0.546233592,-1.378480633,0.869124544,0.869124544,0.546233592,0,1,0,1
3224,14,105,55,110,98,0,4153.062,90,623.856,MORE,-292,2178,1886,6,2,-12,-1.124890153,12,0.523822722,1.455892471,0.608291483,208,110,98,1,0.957361319,1.170500555,0.702300333,1.591316063,-0.104036343,0.104036343,0.702300333,1.170500555,1,1,0
3225,14,106,29,94,80,0,1590.977,70,726.71,MORE,-534,996,462,2,1,-14,-1.312371845,14,0.87303787,0.642355351,-0.79241066,174,94,80,1,0.279230385,0.546233592,0,-0.784521294,-0.378517619,0.378517619,0,0.546233592,1,0,0
3226,14,107,57,110,94,0,4050.696,80,635.756,MORE,-1834,2870,1036,4,2,-16,-1.499853537,16,1.222253018,1.049123911,0.552327581,204,110,94,1,0.877581209,1.170500555,0.546233592,0.403397384,-1.853003812,1.853003812,0.546233592,1.170500555,1,1,0
3227,14,108,39,80,66,0,1998.507,30,632.698,MORE,-1076,1416,340,2,1,-14,-1.312371845,14,0.87303787,-0.984718889,-0.569612375,146,80,66,1,-0.279230385,0,-0.546233592,-0.784521294,-0.993264939,0.993264939,-0.546233592,0,0,0,0
3228,14,109,4,50,54,0,1634.169,20,773.178,MORE,-1158,1558,400,2,1,4,0.374963384,4,-0.87303787,-1.391487449,-0.768797421,104,50,54,0,-1.116921539,-1.170500555,-1.014433814,-0.784521294,-1.086270992,1.086270992,-1.014433814,-1.170500555,0,0,0
3229,14,110,55,98,110,1,2040.699,30,688.595,MORE,224,800,1024,3,2,12,1.124890153,12,0.523822722,-0.984718889,-0.546545839,208,98,110,0,0.957361319,0.702300333,1.170500555,-0.190561955,0.481221253,0.481221253,1.170500555,0.702300333,0,0,1
3230,14,111,2,50,52,1,1735.603,90,1224.678,MORE,544,810,1354,3,2,2,0.187481692,2,-1.222253018,1.455892471,-0.713343046,102,50,52,0,-1.156811594,-1.170500555,-1.092467184,-0.190561955,0.844171701,0.844171701,-1.092467184,-1.170500555,1,0,1
3231,14,112,59,110,89,0,3426.046,50,1296.811,MORE,40,1516,1556,4,1,-21,-1.968557767,21,2.095290887,-0.171181769,0.210828921,199,110,89,1,0.777856072,1.170500555,0.351150166,0.403397384,0.272524746,0.272524746,0.351150166,1.170500555,1,1,1
3232,14,113,60,87,110,1,1302.233,90,957.051,MORE,458,378,836,1,2,23,2.15603946,23,2.444506035,1.455892471,-0.950268163,197,87,110,0,0.737966017,0.273116796,1.170500555,-1.378480633,0.746628768,0.746628768,1.170500555,0.273116796,1,0,1
3233,14,114,52,110,105,0,1644.208,40,857.47,MORE,-416,952,536,2,1,-5,-0.46870423,5,-0.698430296,-0.577950329,-0.763309059,215,110,105,1,1.096976512,1.170500555,0.975417129,-0.784521294,-0.244679641,0.244679641,0.975417129,1.170500555,0,0,0
3234,14,115,30,80,96,1,2063.859,50,1366.314,MORE,182,832,1014,3,2,16,1.499853537,16,1.222253018,-0.171181769,-0.533884175,176,80,96,0,0.31912044,0,0.624266962,-0.190561955,0.433584007,0.433584007,0.624266962,0,0,0,1
3235,14,116,24,80,86,1,4972.136,40,743.574,MORE,372,1918,2290,4,2,6,0.562445076,6,-0.523822722,-0.577950329,1.056082524,166,80,86,0,0.119670165,0,0.234100111,0.403397384,0.649085835,0.649085835,0.234100111,0,0,1,1
3236,14,117,5,50,55,1,1493.973,10,275.216,MORE,606,362,968,1,2,5,0.46870423,5,-0.698430296,-1.798256009,-0.845443136,105,50,55,0,-1.096976512,-1.170500555,-0.975417129,-1.378480633,0.91449335,0.91449335,-0.975417129,-1.170500555,0,0,1
3237,14,118,34,80,74,0,9061.277,40,912.156,MORE,-3278,5534,2256,6,1,-6,-0.562445076,6,-0.523822722,-0.577950329,3.291632306,154,80,74,1,-0.119670165,0,-0.234100111,1.591316063,-3.490817706,3.490817706,-0.234100111,0,0,1,0
3238,14,119,15,45,50,1,4308.776,40,1197.242,MORE,288,1812,2100,5,2,5,0.46870423,5,-0.698430296,-0.577950329,0.693420951,95,45,50,0,-1.296426786,-1.36558398,-1.170500555,0.997356724,0.553811343,0.553811343,-1.170500555,-1.36558398,0,1,1
3239,14,120,37,69,80,1,1492.819,30,237.614,MORE,566,408,974,1,2,11,1.031149307,11,0.349215148,-0.984718889,-0.846074032,149,69,80,0,-0.219395302,-0.429183537,0,-1.378480633,0.869124544,0.869124544,0,-0.429183537,0,0,1
3240,14,121,48,128,110,1,3034.393,80,2119.352,LESS,632,1152,1784,3,2,-18,-1.687335229,18,1.571468165,1.049123911,-0.003289345,238,128,110,0,1.555712144,1.872800887,1.170500555,-0.190561955,0.943983074,0.943983074,1.170500555,1.872800887,1,1,1
3241,14,122,8,50,58,0,1726.455,10,1312.313,LESS,-1730,2180,450,2,1,8,0.749926769,8,-0.174607574,-1.798256009,-0.718344294,108,50,58,1,-1.037141429,-1.170500555,-0.858367073,-0.784521294,-1.735044916,1.735044916,-0.858367073,-1.170500555,0,0,0
3242,14,123,4,54,50,0,3010.505,90,2494.686,LESS,608,1570,2178,4,2,-4,-0.374963384,4,-0.87303787,1.455892471,-0.01634901,104,54,50,0,-1.116921539,-1.014433814,-1.170500555,0.403397384,0.91676179,0.91676179,-1.170500555,-1.014433814,1,1,1
3243,14,124,37,80,69,1,3630.022,80,2372.027,LESS,842,986,1828,4,1,-11,-1.031149307,11,0.349215148,1.049123911,0.322343418,149,80,69,0,-0.219395302,0,-0.429183537,0.403397384,1.182169305,1.182169305,-0.429183537,0,1,1,1
3244,14,125,52,105,110,0,10180.83,50,1725.924,LESS,-2238,5980,3742,9,1,5,0.46870423,5,-0.698430296,-0.171181769,3.90369642,215,105,110,1,1.096976512,0.975417129,1.170500555,3.37319408,-2.311228752,2.311228752,1.170500555,0.975417129,0,1,0
3245,14,126,5,55,50,1,5383.872,60,1036.423,LESS,-826,3062,2236,6,1,-5,-0.46870423,5,-0.698430296,0.235586791,1.281180246,105,55,50,0,-1.096976512,-0.975417129,-1.170500555,1.591316063,-0.709709902,0.709709902,-1.170500555,-0.975417129,0,1,0
3246,14,127,30,96,80,0,4386.342,30,1991.747,LESS,-1884,3806,1922,4,1,-16,-1.499853537,16,1.222253018,-0.984718889,0.735826595,176,96,80,0,0.31912044,0.624266962,0,0.403397384,-1.909714819,1.909714819,0,0.624266962,0,1,0
3247,14,128,33,80,75,1,7293.022,40,943.692,LESS,-790,3804,3014,5,2,-5,-0.46870423,5,-0.698430296,-0.577950329,2.324920206,155,80,75,0,-0.099725137,0,-0.195083426,0.997356724,-0.668877977,0.668877977,-0.195083426,0,0,1,0
3248,14,129,48,110,128,0,2719.974,70,1090.121,LESS,-426,1432,1006,4,1,18,1.687335229,18,1.571468165,0.642355351,-0.175183473,238,110,128,1,1.555712144,1.170500555,1.872800887,0.403397384,-0.256021843,0.256021843,1.872800887,1.170500555,1,1,0
3249,14,130,9,59,50,1,5170.829,80,1493.81,LESS,-914,2006,1092,3,1,-9,-0.843667615,9,0,1.049123911,1.164708783,109,59,50,0,-1.017196402,-0.819350388,-1.170500555,-0.190561955,-0.809521275,0.809521275,-1.170500555,-0.819350388,1,1,0
3250,14,131,44,110,119,0,8635.108,60,1591.065,LESS,1386,3058,4444,7,2,9,0.843667615,9,0,0.235586791,3.058644004,229,110,119,1,1.376206896,1.170500555,1.521650721,2.185275402,1.799185066,1.799185066,1.521650721,1.170500555,0,1,1
3251,14,132,2,52,50,1,5570.065,30,1182.306,LESS,154,2500,2654,5,2,-2,-0.187481692,2,-1.222253018,-0.984718889,1.382972706,102,52,50,0,-1.156811594,-1.092467184,-1.170500555,0.997356724,0.401825843,0.401825843,-1.170500555,-1.092467184,0,1,1
3252,14,133,8,58,50,0,3089.839,70,764.533,LESS,-1150,2092,942,3,2,-8,-0.749926769,8,-0.174607574,0.642355351,0.027023206,108,58,50,0,-1.037141429,-0.858367073,-1.170500555,-0.190561955,-1.07719723,1.07719723,-1.170500555,-0.858367073,1,1,0
3253,14,134,44,119,110,1,2183.526,50,1093.075,LESS,342,782,1124,3,2,-9,-0.843667615,9,0,-0.171181769,-0.468461746,229,119,110,0,1.376206896,1.521650721,1.170500555,-0.190561955,0.615059231,0.615059231,1.170500555,1.521650721,0,1,1
3254,14,135,34,74,80,0,2594.473,60,1299.751,LESS,32,1310,1342,2,1,6,0.562445076,6,-0.523822722,0.235586791,-0.243795373,154,74,80,1,-0.119670165,-0.234100111,0,-0.784521294,0.263450985,0.263450985,0,-0.234100111,1,0,1
3255,14,136,24,86,80,1,3695.539,70,2358.74,LESS,-280,2192,1912,6,1,-6,-0.562445076,6,-0.523822722,0.642355351,0.358161824,166,86,80,0,0.119670165,0.234100111,0,1.591316063,-0.090425701,0.090425701,0,0.234100111,1,1,0
3256,14,137,39,66,80,0,3132.579,80,1146.349,LESS,-1482,2350,868,2,2,14,1.312371845,14,0.87303787,1.049123911,0.050389335,146,66,80,1,-0.279230385,-0.546233592,0,-0.784521294,-1.45375832,1.45375832,0,-0.546233592,1,0,0
3257,14,138,9,50,59,0,1289.791,90,929.998,LESS,210,652,862,2,2,9,0.843667615,9,0,1.455892471,-0.957070254,109,50,59,1,-1.017196402,-1.170500555,-0.819350388,-0.784521294,0.465342171,0.465342171,-0.819350388,-1.170500555,1,0,1
3258,14,139,57,94,110,0,5681.577,70,1051.014,LESS,-1716,3236,1520,4,1,16,1.499853537,16,1.222253018,0.642355351,1.443936763,204,94,110,1,0.877581209,0.546233592,1.170500555,0.403397384,-1.719165834,1.719165834,1.170500555,0.546233592,1,1,0
3259,14,140,60,110,87,1,3496.864,70,945.837,LESS,370,1452,1822,4,2,-23,-2.15603946,23,2.444506035,0.642355351,0.249545405,197,110,87,0,0.737966017,1.170500555,0.273116796,0.403397384,0.646817395,0.646817395,0.273116796,1.170500555,1,1,1
3260,14,141,33,75,80,0,1519.027,70,1188.873,LESS,-402,890,488,2,1,5,0.46870423,5,-0.698430296,0.642355351,-0.831746014,155,75,80,1,-0.099725137,-0.195083426,0,-0.784521294,-0.228800559,0.228800559,0,-0.195083426,1,0,0
3261,14,142,15,50,45,1,4598.014,30,1540.826,LESS,1330,1414,2744,6,1,-5,-0.46870423,5,-0.698430296,-0.984718889,0.851548526,95,50,45,0,-1.296426786,-1.170500555,-1.36558398,1.591316063,1.735668737,1.735668737,-1.36558398,-1.170500555,0,1,1
3262,14,143,59,89,110,0,2953.836,40,729.108,LESS,-774,1696,922,4,1,21,1.968557767,21,2.095290887,-0.577950329,-0.04733018,199,89,110,1,0.777856072,0.351150166,1.170500555,0.403397384,-0.650730455,0.650730455,1.170500555,0.351150166,0,1,0
3263,14,144,29,80,94,0,3660.782,100,697.503,LESS,1306,1358,2664,2,2,14,1.312371845,14,0.87303787,1.862661031,0.339160033,174,80,94,1,0.279230385,0,0.546233592,-0.784521294,1.708447454,1.708447454,0.546233592,0,1,0,1
3264,14,145,55,110,98,1,6895.45,80,1461.822,LESS,688,2502,3190,5,2,-12,-1.124890153,12,0.523822722,1.049123911,2.107566,208,110,98,0,0.957361319,1.170500555,0.702300333,0.997356724,1.007499402,1.007499402,0.702300333,1.170500555,1,1,1
3265,14,146,29,94,80,1,2595.649,40,1792.379,LESS,-232,1716,1484,4,1,-14,-1.312371845,14,0.87303787,-0.577950329,-0.243152449,174,94,80,0,0.279230385,0.546233592,0,0.403397384,-0.035983134,0.035983134,0,0.546233592,0,1,0
3266,14,147,57,110,94,1,2868.746,80,1701.704,LESS,620,1428,2048,5,2,-16,-1.499853537,16,1.222253018,1.049123911,-0.093849224,204,110,94,0,0.877581209,1.170500555,0.546233592,0.997356724,0.930372432,0.930372432,0.546233592,1.170500555,1,1,1
3267,14,148,39,80,66,1,3832.444,50,1009.092,LESS,-32,1808,1776,6,1,-14,-1.312371845,14,0.87303787,-0.171181769,0.433008337,146,80,66,0,-0.279230385,0,-0.546233592,1.591316063,0.190860895,0.190860895,-0.546233592,0,0,1,1
3268,14,149,4,50,54,0,2633.974,50,1280.672,LESS,-1624,2248,624,2,1,4,0.374963384,4,-0.87303787,-0.171181769,-0.222200018,104,50,54,1,-1.116921539,-1.170500555,-1.014433814,-0.784521294,-1.614817581,1.614817581,-1.014433814,-1.170500555,0,0,0
3269,14,150,55,98,110,0,5024.522,40,1111.933,LESS,-768,2784,2016,6,1,12,1.124890153,12,0.523822722,-0.577950329,1.08472216,208,98,110,1,0.957361319,0.702300333,1.170500555,1.591316063,-0.643925134,0.643925134,1.170500555,0.702300333,0,1,0
3270,14,151,2,50,52,0,1779.915,80,732.659,LESS,-392,1170,778,2,2,2,0.187481692,2,-1.222253018,1.049123911,-0.689117498,102,50,52,1,-1.156811594,-1.170500555,-1.092467184,-0.784521294,-0.217458358,0.217458358,-1.092467184,-1.170500555,1,0,0
3271,14,152,59,110,89,1,4224.099,70,1360.895,LESS,1304,1366,2670,3,1,-21,-1.968557767,21,2.095290887,0.642355351,0.647127696,199,110,89,0,0.777856072,1.170500555,0.351150166,-0.190561955,1.706179014,1.706179014,0.351150166,1.170500555,1,0,1
3272,14,153,60,87,110,0,1386.497,70,2527.199,LESS,-482,930,448,2,1,23,2.15603946,23,2.444506035,0.642355351,-0.904200696,197,87,110,1,0.737966017,0.273116796,1.170500555,-0.784521294,-0.319538171,0.319538171,1.170500555,0.273116796,1,0,0
3273,14,154,52,110,105,0,4284.96,70,2761.369,LESS,-294,2202,1908,8,1,-5,-0.46870423,5,-0.698430296,0.642355351,0.680400649,215,110,105,0,1.096976512,1.170500555,0.975417129,2.779234741,-0.106304783,0.106304783,0.975417129,1.170500555,1,1,0
3274,14,155,30,80,96,0,4919.425,50,1536.806,LESS,-2286,3484,1198,4,2,16,1.499853537,16,1.222253018,-0.171181769,1.027265208,176,80,96,1,0.31912044,0,0.624266962,0.403397384,-2.365671319,2.365671319,0.624266962,0,0,1,0
3275,14,156,24,80,86,0,4094.346,100,2419.833,LESS,868,1836,2704,4,2,6,0.562445076,6,-0.523822722,1.862661031,0.576191211,166,80,86,1,0.119670165,0,0.234100111,0.403397384,1.211659029,1.211659029,0.234100111,0,1,1,1
3276,14,157,5,50,55,0,8258.419,70,2336.388,LESS,86,3700,3786,10,1,5,0.46870423,5,-0.698430296,0.642355351,2.852706618,105,50,55,1,-1.096976512,-1.170500555,-0.975417129,3.967153419,0.324698873,0.324698873,-0.975417129,-1.170500555,1,1,1
3277,14,158,34,80,74,0,6018.197,40,1730.244,LESS,604,2374,2978,3,1,-6,-0.562445076,6,-0.523822722,-0.577950329,1.627968267,154,80,74,0,-0.119670165,0,-0.234100111,-0.190561955,0.91222491,0.91222491,-0.234100111,0,0,0,1
3278,14,159,15,45,50,0,4584.38,80,1051.047,LESS,544,1868,2412,4,2,5,0.46870423,5,-0.698430296,1.049123911,0.844094763,95,45,50,1,-1.296426786,-1.36558398,-1.170500555,0.403397384,0.844171701,0.844171701,-1.170500555,-1.36558398,1,1,1
3279,14,160,37,69,80,0,5677.403,80,1734.052,LESS,-2308,4032,1724,2,1,11,1.031149307,11,0.349215148,1.049123911,1.441654821,149,69,80,1,-0.219395302,-0.429183537,0,-0.784521294,-2.390624162,2.390624162,0,-0.429183537,1,0,0
3280,14,161,3,50,53,0,7810.219,20,1733.68,MORE,-1378,4450,3072,4,1,3,0.281222538,3,-1.047645444,-1.391487449,2.60767388,103,50,53,0,-1.136866566,-1.170500555,-1.053450499,0.403397384,-1.335799424,1.335799424,-1.053450499,-1.170500555,0,1,0
3281,14,162,20,50,40,0,4358.031,50,1909.785,MORE,-708,2504,1796,2,1,-10,-0.937408461,10,0.174607574,-0.171181769,0.720348857,90,50,40,1,-1.396151924,-1.170500555,-1.560667406,-0.784521294,-0.575871925,0.575871925,-1.560667406,-1.170500555,0,0,0
3282,14,163,25,80,88,0,2082.529,0,1788.029,MORE,-1468,2022,554,2,1,8,0.749926769,8,-0.174607574,-2.205024569,-0.523677211,168,80,88,0,0.15956022,0,0.312133481,-0.784521294,-1.437879237,1.437879237,0.312133481,0,0,0,0
3283,14,164,42,115,110,0,4631.005,100,2153.569,MORE,1894,1480,3374,2,2,-5,-0.46870423,5,-0.698430296,1.862661031,0.869584838,225,115,110,1,1.296426786,1.36558398,1.170500555,-0.784521294,2.375368901,2.375368901,1.170500555,1.36558398,1,0,1
3284,14,165,53,103,110,0,3551.473,50,1191.662,MORE,1400,1056,2456,2,1,7,0.656185922,7,-0.349215148,-0.171181769,0.279400365,213,103,110,0,1.057086457,0.897383758,1.170500555,-0.784521294,1.815064148,1.815064148,1.170500555,0.897383758,1,0,1
3285,14,166,26,90,80,0,5933.998,30,446.536,MORE,-1162,3328,2166,2,1,-10,-0.937408461,10,0.174607574,-0.984718889,1.581936336,170,90,80,1,0.199450275,0.390166852,0,-0.784521294,-1.090807872,1.090807872,0,0.390166852,0,0,0
3286,14,167,35,80,72,0,3048.616,70,1827,MORE,240,1304,1544,2,1,-8,-0.749926769,8,-0.174607574,0.642355351,0.004486426,152,80,72,1,-0.15956022,0,-0.312133481,-0.784521294,0.499368776,0.499368776,-0.312133481,0,1,0,1
3287,14,168,28,93,80,0,2389.491,50,1547.364,MORE,-842,1312,470,2,1,-13,-1.218630999,13,0.698430296,-0.171181769,-0.355859854,173,93,80,1,0.259285357,0.507216907,0,-0.784521294,-0.727857425,0.727857425,0,0.507216907,1,0,0
3288,14,169,26,80,90,1,4955.968,70,1899.677,MORE,-1298,2904,1606,3,2,10,0.937408461,10,0.174607574,0.642355351,1.047243413,170,80,90,0,0.199450275,0,0.390166852,-0.190561955,-1.245061812,1.245061812,0.390166852,0,1,0,0
3289,14,170,25,88,80,1,2224.953,60,1297.925,MORE,260,810,1070,3,2,-8,-0.749926769,8,-0.174607574,0.235586791,-0.445813439,168,88,80,1,0.15956022,0.312133481,0,-0.190561955,0.522053179,0.522053179,0,0.312133481,1,0,1
3290,14,171,36,80,70,0,6152.037,30,1072.674,MORE,-658,3166,2508,4,1,-10,-0.937408461,10,0.174607574,-0.984718889,1.701139132,150,80,70,1,-0.199450275,0,-0.390166852,0.403397384,-0.519160917,0.519160917,-0.390166852,0,0,1,0
3291,14,172,28,80,93,1,1813.711,60,1368.489,MORE,332,668,1000,3,2,13,1.218630999,13,0.698430296,0.235586791,-0.670641089,173,80,93,0,0.259285357,0,0.507216907,-0.190561955,0.603717029,0.603717029,0.507216907,0,1,1,1
3292,14,173,21,82,80,0,3622.56,60,1386.666,MORE,-644,2208,1564,6,1,-2,-0.187481692,2,-1.222253018,0.235586791,0.318263913,162,82,80,1,0.039890055,0.07803337,0,1.591316063,-0.503281835,0.503281835,0,0.07803337,1,1,0
3293,14,174,19,50,41,0,2720.344,90,913.1,MORE,-52,1446,1394,4,2,-9,-0.843667615,9,0,1.455892471,-0.174981193,91,50,41,1,-1.376206896,-1.170500555,-1.521650721,0.403397384,0.168176492,0.168176492,-1.521650721,-1.170500555,1,1,1
3294,14,175,56,96,110,1,2245.708,10,1310.193,MORE,-802,1898,1096,4,1,14,1.312371845,14,0.87303787,-1.798256009,-0.434466597,206,96,110,0,0.917471264,0.624266962,1.170500555,0.403397384,-0.682488619,0.682488619,1.170500555,0.624266962,0,1,0
3295,14,176,23,80,85,1,3785.487,100,832.188,MORE,1872,1004,2876,3,2,5,0.46870423,5,-0.698430296,1.862661031,0.407336757,165,80,85,0,0.099725137,0,0.195083426,-0.190561955,2.350416058,2.350416058,0.195083426,0,1,0,1
3296,14,177,10,60,50,1,3213.752,80,1219.299,MORE,572,1150,1722,3,2,-10,-0.937408461,10,0.174607574,1.049123911,0.09476694,110,60,50,1,-0.997251374,-0.780333703,-1.170500555,-0.190561955,0.875929865,0.875929865,-1.170500555,-0.780333703,1,0,1
3297,14,178,19,41,50,1,1167.823,50,356.559,MORE,504,294,798,1,2,9,0.843667615,9,0,-0.171181769,-1.023750649,91,41,50,0,-1.376206896,-1.521650721,-1.170500555,-1.378480633,0.798802895,0.798802895,-1.170500555,-1.521650721,0,0,1
3298,14,179,56,110,96,0,1525.374,90,828.164,MORE,-18,836,818,2,2,-14,-1.312371845,14,0.87303787,1.455892471,-0.828276083,206,110,96,1,0.917471264,1.170500555,0.624266962,-0.784521294,0.206739978,0.206739978,0.624266962,1.170500555,1,0,1
3299,14,180,35,72,80,1,3431.149,50,460.387,MORE,446,1316,1762,5,2,8,0.749926769,8,-0.174607574,-0.171181769,0.213618751,152,72,80,0,-0.15956022,-0.312133481,0,0.997356724,0.733018126,0.733018126,0,-0.312133481,0,1,1
3300,14,181,11,49,50,0,2443.191,20,1987.299,MORE,-202,1316,1114,2,1,1,0.093740846,1,-1.396860592,-1.391487449,-0.326501849,99,49,50,0,-1.216646676,-1.20951724,-1.170500555,-0.784521294,-0.00195653,0.00195653,-1.170500555,-1.20951724,0,0,1
3301,14,182,17,43,50,1,2221.091,50,1066.841,MORE,48,1074,1122,4,1,7,0.656185922,7,-0.349215148,-0.171181769,-0.44792481,93,43,50,0,-1.336316841,-1.443617351,-1.170500555,0.403397384,0.281598507,0.281598507,-1.170500555,-1.443617351,1,1,1
3302,14,183,1,51,50,0,2935.902,60,1144.497,MORE,-346,1544,1198,2,1,-1,-0.093740846,1,-1.396860592,0.235586791,-0.05713477,101,51,50,1,-1.176756621,-1.131483869,-1.170500555,-0.784521294,-0.165284231,0.165284231,-1.170500555,-1.131483869,1,0,0
3303,14,184,41,112,110,0,1651.364,50,1739.199,MORE,-346,1070,724,2,1,-2,-0.187481692,2,-1.222253018,-0.171181769,-0.759396845,222,112,110,1,1.236591704,1.248533925,1.170500555,-0.784521294,-0.165284231,0.165284231,1.170500555,1.248533925,1,0,0
3304,14,185,20,40,50,1,1982.287,70,1103.292,MORE,894,654,1548,3,2,10,0.937408461,10,0.174607574,0.642355351,-0.578479914,90,40,50,0,-1.396151924,-1.560667406,-1.170500555,-0.190561955,1.241148753,1.241148753,-1.170500555,-1.560667406,1,0,1
3305,14,186,1,50,51,0,2313.609,30,1784.65,MORE,-624,1222,598,1,1,1,0.093740846,1,-1.396860592,-0.984718889,-0.397344848,101,50,51,0,-1.176756621,-1.170500555,-1.131483869,-1.378480633,-0.480597432,0.480597432,-1.131483869,-1.170500555,0,0,0
3306,14,187,23,85,80,0,1456.456,90,1026.878,MORE,-682,1152,470,2,2,-5,-0.46870423,5,-0.698430296,1.455892471,-0.86595383,165,85,80,1,0.099725137,0.195083426,0,-0.784521294,-0.546382201,0.546382201,0,0.195083426,1,0,0
3307,14,188,11,50,49,0,1619.36,20,1358.471,MORE,-1386,1806,420,2,1,-1,-0.093740846,1,-1.396860592,-1.391487449,-0.77689356,99,50,49,1,-1.216646676,-1.170500555,-1.20951724,-0.784521294,-1.344873185,1.344873185,-1.20951724,-1.170500555,0,0,0
3308,14,189,17,50,43,0,1573.163,70,1495.241,MORE,-612,1116,504,2,1,-7,-0.656185922,7,-0.349215148,0.642355351,-0.802149645,93,50,43,1,-1.336316841,-1.170500555,-1.443617351,-0.784521294,-0.466986791,0.466986791,-1.443617351,-1.170500555,1,0,0
3309,14,190,21,80,82,1,1486.638,20,783.722,MORE,-248,1018,770,4,1,2,0.187481692,2,-1.222253018,-1.391487449,-0.84945321,162,80,82,0,0.039890055,0,0.07803337,0.403397384,-0.054130657,0.054130657,0.07803337,0,0,1,1
3310,14,191,10,50,60,1,1062.845,80,1729.784,MORE,814,424,1238,2,2,10,0.937408461,10,0.174607574,1.049123911,-1.081142542,110,50,60,0,-0.997251374,-1.170500555,-0.780333703,-0.784521294,1.150411141,1.150411141,-0.780333703,-1.170500555,1,0,1
3311,14,192,3,53,50,0,3646.101,50,1133.322,MORE,-646,1946,1300,6,1,-3,-0.281222538,3,-1.047645444,-0.171181769,0.331133872,103,53,50,1,-1.136866566,-1.053450499,-1.170500555,1.591316063,-0.505550276,0.505550276,-1.170500555,-1.053450499,1,1,0
3312,14,193,45,122,110,0,1232.637,90,1102.624,MORE,-126,832,706,2,2,-12,-1.124890153,12,0.523822722,1.455892471,-0.988316575,232,122,110,1,1.436041979,1.638700776,1.170500555,-0.784521294,0.084244202,0.084244202,1.170500555,1.638700776,1,0,1
3313,14,194,38,67,80,1,2411.8,40,178.847,MORE,202,1124,1326,5,2,13,1.218630999,13,0.698430296,-0.577950329,-0.343663435,147,67,80,0,-0.259285357,-0.507216907,0,0.997356724,0.45626841,0.45626841,0,-0.507216907,0,1,1
3314,14,195,38,80,67,0,4659.356,90,989.437,MORE,-744,2822,2078,4,2,-13,-1.218630999,13,0.698430296,1.455892471,0.885084443,147,80,67,1,-0.259285357,0,-0.507216907,0.403397384,-0.61670385,0.61670385,-0.507216907,0,1,1,0
3315,14,196,36,70,80,1,1656.365,60,1172.111,MORE,158,696,854,3,2,10,0.937408461,10,0.174607574,0.235586791,-0.756662778,150,70,80,0,-0.199450275,-0.390166852,0,-0.190561955,0.406362724,0.406362724,0,-0.390166852,1,0,1
3316,14,197,45,110,122,0,2788.233,40,1239.218,MORE,-1074,2026,952,4,1,12,1.124890153,12,0.523822722,-0.577950329,-0.137866004,232,110,122,0,1.436041979,1.170500555,1.638700776,0.403397384,-0.990996499,0.990996499,1.638700776,1.170500555,0,1,0
3317,14,198,42,110,115,1,3271.608,50,911.298,MORE,152,1518,1670,3,2,5,0.46870423,5,-0.698430296,-0.171181769,0.126397047,225,110,115,0,1.296426786,1.170500555,1.36558398,-0.190561955,0.399557403,0.399557403,1.36558398,1.170500555,0,1,1
3318,14,199,41,110,112,1,2808.27,70,1714.144,MORE,624,1332,1956,4,1,2,0.187481692,2,-1.222253018,0.642355351,-0.126911696,222,110,112,0,1.236591704,1.170500555,1.248533925,0.403397384,0.934909313,0.934909313,1.248533925,1.170500555,1,1,1
3319,14,200,53,110,103,0,1766.714,20,1512.758,MORE,-670,1906,1236,2,2,-7,-0.656185922,7,-0.349215148,-1.391487449,-0.696334538,213,110,103,1,1.057086457,1.170500555,0.897383758,-0.784521294,-0.532771559,0.532771559,0.897383758,1.170500555,0,0,0
3320,14,201,3,50,53,1,4022.289,30,1526.406,LESS,172,1344,1516,3,2,3,0.281222538,3,-1.047645444,-0.984718889,0.53679736,103,50,53,1,-1.136866566,-1.170500555,-1.053450499,-0.190561955,0.422241806,0.422241806,-1.053450499,-1.170500555,0,1,1
3321,14,202,20,50,40,1,3577.684,70,913.426,LESS,598,1342,1940,5,2,-10,-0.937408461,10,0.174607574,0.642355351,0.293730023,90,50,40,0,-1.396151924,-1.170500555,-1.560667406,0.997356724,0.905419589,0.905419589,-1.560667406,-1.170500555,1,1,1
3322,14,203,25,80,88,1,2419.418,70,1156.697,LESS,674,980,1654,4,2,8,0.749926769,8,-0.174607574,0.642355351,-0.339498643,168,80,88,1,0.15956022,0,0.312133481,0.403397384,0.99162032,0.99162032,0.312133481,0,1,1,1
3323,14,204,42,115,110,1,2636.488,50,1103.276,LESS,1054,644,1698,3,2,-5,-0.46870423,5,-0.698430296,-0.171181769,-0.220825604,225,115,110,0,1.296426786,1.36558398,1.170500555,-0.190561955,1.422623976,1.422623976,1.170500555,1.36558398,0,0,1
3324,14,205,53,103,110,0,1578.246,50,751.583,LESS,-300,802,502,2,1,7,0.656185922,7,-0.349215148,-0.171181769,-0.799370749,213,103,110,1,1.057086457,0.897383758,1.170500555,-0.784521294,-0.113110104,0.113110104,1.170500555,0.897383758,0,0,0
3325,14,206,26,90,80,1,1717.583,50,1854.464,LESS,506,498,1004,3,2,-10,-0.937408461,10,0.174607574,-0.171181769,-0.723194652,170,90,80,0,0.199450275,0.390166852,0,-0.190561955,0.801071335,0.801071335,0,0.390166852,0,0,1
3326,14,207,35,80,72,1,1695.674,50,569.991,LESS,-38,880,842,4,1,-8,-0.749926769,8,-0.174607574,-0.171181769,-0.73517239,152,80,72,0,-0.15956022,0,-0.312133481,0.403397384,0.184055575,0.184055575,-0.312133481,0,0,1,1
3327,14,208,28,93,80,1,1706.779,50,791.015,LESS,10,830,840,4,1,-13,-1.218630999,13,0.698430296,-0.171181769,-0.729101242,173,93,80,0,0.259285357,0.507216907,0,0.403397384,0.238498142,0.238498142,0,0.507216907,0,1,1
3328,14,209,26,80,90,0,2530.383,80,821.617,LESS,-668,1558,890,2,2,10,0.937408461,10,0.174607574,1.049123911,-0.278833633,170,80,90,1,0.199450275,0,0.390166852,-0.784521294,-0.530503119,0.530503119,0.390166852,0,1,0,0
3329,14,210,25,88,80,1,1934.216,30,904.701,LESS,132,954,1086,3,1,-8,-0.749926769,8,-0.174607574,-0.984718889,-0.604760523,168,88,80,0,0.15956022,0.312133481,0,-0.190561955,0.376873,0.376873,0,0.312133481,0,0,1
3330,14,211,36,80,70,0,1507.17,20,1165.772,LESS,-46,778,732,3,2,-10,-0.937408461,10,0.174607574,-1.391487449,-0.838228283,150,80,70,0,-0.199450275,0,-0.390166852,-0.190561955,0.174981813,0.174981813,-0.390166852,0,0,0,1
3331,14,212,28,80,93,0,1112.674,90,1388.022,LESS,146,826,972,2,2,13,1.218630999,13,0.698430296,1.455892471,-1.053900828,173,80,93,1,0.259285357,0,0.507216907,-0.784521294,0.392752082,0.392752082,0.507216907,0,1,0,1
3332,14,213,21,82,80,0,1033.302,70,630.781,LESS,-318,680,362,2,1,-2,-0.187481692,2,-1.222253018,0.642355351,-1.097293819,162,82,80,0,0.039890055,0.07803337,0,-0.784521294,-0.133526067,0.133526067,0,0.07803337,1,0,0
3333,14,214,19,50,41,1,1911.303,80,685.487,LESS,954,700,1654,3,2,-9,-0.843667615,9,0,1.049123911,-0.617287151,91,50,41,0,-1.376206896,-1.170500555,-1.521650721,-0.190561955,1.309201962,1.309201962,-1.521650721,-1.170500555,1,1,1
3334,14,215,56,96,110,0,2970.806,80,828.698,LESS,198,1496,1694,4,2,14,1.312371845,14,0.87303787,1.049123911,-0.038052613,206,96,110,1,0.917471264,0.624266962,1.170500555,0.403397384,0.45173153,0.45173153,1.170500555,0.624266962,1,1,1
3335,14,216,23,80,85,0,3411.277,70,857.166,LESS,-854,1972,1118,4,1,5,0.46870423,5,-0.698430296,0.642355351,0.202754649,165,80,85,1,0.099725137,0,0.195083426,0.403397384,-0.741468066,0.741468066,0.195083426,0,1,1,0
3336,14,217,10,60,50,1,2324.178,60,1438.591,LESS,458,780,1238,4,1,-10,-0.937408461,10,0.174607574,0.235586791,-0.391566733,110,60,50,0,-0.997251374,-0.780333703,-1.170500555,0.403397384,0.746628768,0.746628768,-1.170500555,-0.780333703,0,1,1
3337,14,218,19,41,50,0,1555.319,80,1284.249,LESS,-118,954,836,3,2,9,0.843667615,9,0,1.049123911,-0.811905032,91,41,50,1,-1.376206896,-1.521650721,-1.170500555,-0.190561955,0.093317963,0.093317963,-1.170500555,-1.521650721,1,1,0
3338,14,219,56,110,96,1,1295.527,70,730.52,LESS,1264,294,1558,1,2,-14,-1.312371845,14,0.87303787,0.642355351,-0.95393436,206,110,96,0,0.917471264,1.170500555,0.624266962,-1.378480633,1.660810208,1.660810208,0.624266962,1.170500555,1,0,1
3339,14,220,35,72,80,0,1378.195,80,643.91,LESS,-390,958,568,1,1,8,0.749926769,8,-0.174607574,1.049123911,-0.908739433,152,72,80,1,-0.15956022,-0.312133481,0,-1.378480633,-0.215189918,0.215189918,0,-0.312133481,1,0,0
3340,14,221,11,49,50,1,3603.538,70,1060.642,LESS,34,1282,1316,3,2,1,0.093740846,1,-1.396860592,0.642355351,0.307864509,99,49,50,1,-1.216646676,-1.20951724,-1.170500555,-0.190561955,0.265719425,0.265719425,-1.170500555,-1.20951724,1,1,1
3341,14,222,17,43,50,0,1417.078,90,1265.831,LESS,204,752,956,2,2,7,0.656185922,7,-0.349215148,1.455892471,-0.887481941,93,43,50,1,-1.336316841,-1.443617351,-1.170500555,-0.784521294,0.45853685,0.45853685,-1.170500555,-1.443617351,1,0,1
3342,14,223,1,51,50,0,1493.379,80,561.548,LESS,-418,1094,676,2,2,-1,-0.093740846,1,-1.396860592,1.049123911,-0.845767878,101,51,50,0,-1.176756621,-1.131483869,-1.170500555,-0.784521294,-0.246948082,0.246948082,-1.170500555,-1.131483869,1,0,0
3343,14,224,41,112,110,0,1204.389,10,821.69,LESS,-692,1068,376,2,1,-2,-0.187481692,2,-1.222253018,-1.798256009,-1.00375987,222,112,110,0,1.236591704,1.248533925,1.170500555,-0.784521294,-0.557724402,0.557724402,1.170500555,1.248533925,0,0,0
3344,14,225,20,40,50,0,1120.662,80,191.071,LESS,-562,904,342,2,1,10,0.937408461,10,0.174607574,1.049123911,-1.049533757,90,40,50,1,-1.396151924,-1.560667406,-1.170500555,-0.784521294,-0.410275783,0.410275783,-1.170500555,-1.560667406,1,0,0
3345,14,226,1,50,51,1,1066.639,40,535.245,LESS,664,292,956,1,2,1,0.093740846,1,-1.396860592,-0.577950329,-1.079068347,101,50,51,1,-1.176756621,-1.170500555,-1.131483869,-1.378480633,0.980278119,0.980278119,-1.131483869,-1.170500555,0,0,1
3346,14,227,23,85,80,0,1047.298,20,692.788,LESS,-316,720,404,2,1,-5,-0.46870423,5,-0.698430296,-1.391487449,-1.08964215,165,85,80,0,0.099725137,0.195083426,0,-0.784521294,-0.131257627,0.131257627,0,0.195083426,0,0,0
3347,14,228,11,50,49,0,1080.82,100,640.144,LESS,-50,826,776,2,2,-1,-0.093740846,1,-1.396860592,1.862661031,-1.071315538,99,50,49,0,-1.216646676,-1.170500555,-1.20951724,-0.784521294,0.170444933,0.170444933,-1.20951724,-1.170500555,1,0,0
3348,14,229,17,50,43,0,2406.61,40,665.669,LESS,-1062,1424,362,2,1,-7,-0.656185922,7,-0.349215148,-0.577950329,-0.346500828,93,50,43,0,-1.336316841,-1.170500555,-1.443617351,-0.784521294,-0.977385857,0.977385857,-1.443617351,-1.170500555,0,0,0
3349,14,230,21,80,82,0,1064.427,90,619.777,LESS,82,724,806,2,2,2,0.187481692,2,-1.222253018,1.455892471,-1.080277657,162,80,82,1,0.039890055,0,0.07803337,-0.784521294,0.320161992,0.320161992,0.07803337,0,1,0,1
3350,14,231,10,50,60,0,1104.734,100,689.04,LESS,182,584,766,2,2,10,0.937408461,10,0.174607574,1.862661031,-1.058241658,110,50,60,1,-0.997251374,-1.170500555,-0.780333703,-0.784521294,0.433584007,0.433584007,-0.780333703,-1.170500555,1,0,1
3351,14,232,3,53,50,0,1927.102,70,1532.467,LESS,-690,1236,546,2,1,-3,-0.281222538,3,-1.047645444,0.642355351,-0.608649775,103,53,50,0,-1.136866566,-1.053450499,-1.170500555,-0.784521294,-0.555455962,0.555455962,-1.170500555,-1.053450499,1,0,0
3352,14,233,45,122,110,1,4370.941,70,1026.58,LESS,1190,1498,2688,7,2,-12,-1.124890153,12,0.523822722,0.642355351,0.727406806,232,122,110,0,1.436041979,1.638700776,1.170500555,2.185275402,1.576877917,1.576877917,1.170500555,1.638700776,1,1,1
3353,14,234,38,67,80,0,1375.695,30,871.617,LESS,-478,874,396,2,1,13,1.218630999,13,0.698430296,-0.984718889,-0.910106193,147,67,80,1,-0.259285357,-0.507216907,0,-0.784521294,-0.315001291,0.315001291,0,-0.507216907,0,0,0
3354,14,235,38,80,67,0,1286.488,20,814.804,LESS,-126,728,602,4,1,-13,-1.218630999,13,0.698430296,-1.391487449,-0.958876017,147,80,67,0,-0.259285357,0,-0.507216907,0.403397384,0.084244202,0.084244202,-0.507216907,0,0,1,0
3355,14,236,36,70,80,0,2458.285,70,780.396,LESS,-690,1348,658,2,1,10,0.937408461,10,0.174607574,0.642355351,-0.318249899,150,70,80,1,-0.199450275,-0.390166852,0,-0.784521294,-0.555455962,0.555455962,0,-0.390166852,1,0,0
3356,14,237,45,110,122,0,3166.419,70,1960.481,LESS,-1276,2338,1062,4,1,12,1.124890153,12,0.523822722,0.642355351,0.068889799,232,110,122,1,1.436041979,1.170500555,1.638700776,0.403397384,-1.220108969,1.220108969,1.638700776,1.170500555,1,1,0
3357,14,238,42,110,115,0,1586.569,80,586.256,LESS,74,858,932,2,2,5,0.46870423,5,-0.698430296,1.049123911,-0.794820531,225,110,115,1,1.296426786,1.170500555,1.36558398,-0.784521294,0.311088231,0.311088231,1.36558398,1.170500555,1,0,1
3358,14,239,41,110,112,1,2434.474,20,627.926,LESS,476,844,1320,3,2,2,0.187481692,2,-1.222253018,-1.391487449,-0.331267468,222,110,112,1,1.236591704,1.170500555,1.248533925,-0.190561955,0.767044731,0.767044731,1.248533925,1.170500555,0,1,1
3359,14,240,53,110,103,0,1479.644,90,605.244,LESS,108,754,862,2,2,-7,-0.656185922,7,-0.349215148,1.455892471,-0.853276858,213,110,103,0,1.057086457,1.170500555,0.897383758,-0.784521294,0.349651716,0.349651716,0.897383758,1.170500555,1,0,1
3360,15,1,49,110,131,1,2542.247,50,1525.443,MORE,154,1062,1216,3,2,21,1.968557767,21,2.095290887,0.642882936,-0.537144502,241,110,131,0,1.615547226,1.170500555,1.989850943,0.125283438,0.957378222,0.957378222,1.989850943,1.170500555,1,1,1
3361,15,2,13,47,50,1,8627.313,40,1848.251,MORE,528,3726,4254,6,1,3,0.281222538,3,-1.047645444,0.182310086,1.972469589,97,47,50,0,-1.256536731,-1.28755061,-1.170500555,2.175376058,1.335483561,1.335483561,-1.170500555,-1.28755061,0,1,1
3362,15,3,16,50,44,0,6442.393,30,1888.01,MORE,234,2794,3028,5,1,-6,-0.562445076,6,-0.523822722,-0.278262763,1.071360871,94,50,44,1,-1.316371814,-1.170500555,-1.404600665,1.492011851,1.038256369,1.038256369,-1.404600665,-1.170500555,0,1,1
3363,15,4,7,57,50,0,2761.314,70,3198.033,MORE,-84,1348,1264,1,1,-7,-0.656185922,7,-0.349215148,1.564028636,-0.446796488,107,57,50,1,-1.057086457,-0.897383758,-1.170500555,-1.241444975,0.716765733,0.716765733,-1.170500555,-0.897383758,1,0,1
3364,15,5,18,42,50,0,8024.03,20,2275.13,MORE,2866,2842,5708,3,1,8,0.749926769,8,-0.174607574,-0.738835613,1.723662506,92,42,50,0,-1.356261869,-1.482634036,-1.170500555,0.125283438,3.699147423,3.699147423,-1.170500555,-1.482634036,0,1,1
3365,15,6,51,108,110,0,9336.779,30,1535.384,MORE,-434,4458,4024,5,1,2,0.187481692,2,-1.222253018,-0.278262763,2.265068859,218,108,110,0,1.156811594,1.092467184,1.170500555,1.492011851,0.362923837,0.362923837,1.170500555,1.092467184,0,1,1
3366,15,7,31,78,80,0,9932.804,30,1489.525,MORE,-10,4416,4406,7,1,2,0.187481692,2,-1.222253018,-0.278262763,2.510882584,158,78,80,0,-0.039890055,-0.07803337,0,2.858740265,0.791578019,0.791578019,0,-0.07803337,0,1,1
3367,15,8,58,110,92,0,5285.785,40,2767.736,MORE,-1246,2948,1702,4,1,-18,-1.687335229,18,1.571468165,0.182310086,0.594350477,202,110,92,1,0.837691154,1.170500555,0.468200222,0.808647645,-0.45798936,0.45798936,0.468200222,1.170500555,0,1,0
3368,15,9,12,50,48,0,7635.335,60,2366.269,MORE,-1614,4078,2464,5,1,-2,-0.187481692,2,-1.222253018,1.103455786,1.563356201,98,50,48,1,-1.236591704,-1.170500555,-1.248533925,1.492011851,-0.830028839,0.830028839,-1.248533925,-1.170500555,1,1,0
3369,15,10,54,110,101,0,9593.819,40,1902.163,MORE,-3134,6026,2892,4,1,-9,-0.843667615,9,0,0.182310086,2.371077768,211,110,101,1,1.017196402,1.170500555,0.819350388,0.808647645,-2.366713642,2.366713642,0.819350388,1.170500555,0,1,0
3370,15,11,14,46,50,1,4161.977,80,1148.823,MORE,-450,2168,1718,3,2,4,0.374963384,4,-0.87303787,2.024601486,0.130867518,96,46,50,0,-1.276481759,-1.326567295,-1.170500555,0.125283438,0.346748208,0.346748208,-1.170500555,-1.326567295,1,1,1
3371,15,12,22,80,83,1,14553.385,20,1363.056,MORE,-844,7216,6372,6,1,3,0.281222538,3,-1.047645444,-0.738835613,4.416511083,163,80,83,0,0.059835082,0,0.117050055,2.175376058,-0.051576669,0.051576669,0.117050055,0,0,1,0
3372,15,13,6,50,56,0,5162.842,30,1169.515,MORE,-114,2410,2296,3,1,6,0.562445076,6,-0.523822722,-0.278262763,0.543646099,106,50,56,0,-1.077031484,-1.170500555,-0.936400444,0.125283438,0.686436428,0.686436428,-0.936400444,-1.170500555,0,1,1
3373,15,14,13,50,47,1,8179.39,60,2638.831,MORE,-890,4496,3606,5,1,-3,-0.281222538,3,-1.047645444,1.103455786,1.787736363,97,50,47,1,-1.256536731,-1.170500555,-1.28755061,1.492011851,-0.098081603,0.098081603,-1.28755061,-1.170500555,1,1,0
3374,15,15,46,110,124,1,3542.087,70,1688.966,MORE,-504,1672,1168,1,2,14,1.312371845,14,0.87303787,1.564028636,-0.124788654,234,110,124,0,1.475932034,1.170500555,1.716734147,-1.241444975,0.292155458,0.292155458,1.716734147,1.170500555,1,0,1
3375,15,16,27,91,80,0,13076.186,40,1220.639,MORE,-1624,6840,5216,6,1,-11,-1.031149307,11,0.349215148,0.182310086,3.807281959,171,91,80,1,0.219395302,0.429183537,0,2.175376058,-0.840138607,0.840138607,0,0.429183537,1,1,0
3376,15,17,40,64,80,1,8313.158,20,1041.43,MORE,-2758,5178,2420,3,2,16,1.499853537,16,1.222253018,-0.738835613,1.842905207,144,64,80,0,-0.31912044,-0.624266962,0,0.125283438,-1.986586348,1.986586348,0,-0.624266962,0,1,0
3377,15,18,22,83,80,1,8153.101,40,1757.368,MORE,-1698,4802,3104,5,1,-3,-0.281222538,3,-1.047645444,0.182310086,1.776894205,163,83,80,1,0.059835082,0.117050055,0,1.492011851,-0.914950893,0.914950893,0,0.117050055,0,1,0
3378,15,19,54,101,110,1,3705.626,50,1354.987,MORE,-1174,2344,1170,1,1,9,0.843667615,9,0,0.642882936,-0.057341599,211,101,110,0,1.017196402,0.819350388,1.170500555,-1.241444975,-0.385199027,0.385199027,1.170500555,0.819350388,1,0,0
3379,15,20,6,56,50,0,8992.614,60,1714.653,MORE,-4126,6222,2096,4,1,-6,-0.562445076,6,-0.523822722,1.103455786,2.123127698,106,56,50,1,-1.077031484,-0.936400444,-1.170500555,0.808647645,-3.369602671,3.369602671,-1.170500555,-0.936400444,1,1,0
3380,15,21,18,50,42,0,9472.059,20,1133.545,MORE,-604,5030,4426,4,1,-8,-0.749926769,8,-0.174607574,-0.738835613,2.320861285,92,50,42,1,-1.356261869,-1.170500555,-1.482634036,0.808647645,0.191057774,0.191057774,-1.482634036,-1.170500555,0,1,0
3381,15,22,43,110,117,1,8236.17,30,1255.539,MORE,-2828,5516,2688,3,1,7,0.656185922,7,-0.349215148,-0.278262763,1.811153675,227,110,117,0,1.336316841,1.170500555,1.443617351,0.125283438,-2.057354727,2.057354727,1.443617351,1.170500555,0,1,0
3382,15,23,32,77,80,0,15938.463,30,1313.052,MORE,-5850,10718,4868,4,1,3,0.281222538,3,-1.047645444,-0.278262763,4.987747494,157,77,80,0,-0.059835082,-0.117050055,0,0.808647645,-5.11252675,5.11252675,0,-0.117050055,0,1,0
3383,15,24,27,80,91,1,4239.218,70,2087.778,MORE,-1818,2984,1166,1,2,11,1.031149307,11,0.349215148,1.564028636,0.162723393,171,80,91,0,0.219395302,0,0.429183537,-1.241444975,-1.036268115,1.036268115,0.429183537,0,1,0,0
3384,15,25,16,44,50,1,5746.953,20,1211.642,MORE,-570,2996,2426,3,1,6,0.562445076,6,-0.523822722,-0.738835613,0.78454623,94,44,50,0,-1.316371814,-1.404600665,-1.170500555,0.125283438,0.225430987,0.225430987,-1.170500555,-1.404600665,0,1,1
3385,15,26,7,50,57,1,9532.568,30,965.135,MORE,-2670,5822,3152,5,2,7,0.656185922,7,-0.349215148,-0.278262763,2.345816518,107,50,57,0,-1.057086457,-1.170500555,-0.897383758,1.492011851,-1.897620386,1.897620386,-0.897383758,-1.170500555,0,1,0
3386,15,27,14,50,46,1,4722.124,10,2298.998,MORE,-3702,4978,1276,2,1,-4,-0.374963384,4,-0.87303787,-1.199408463,0.361884372,96,50,46,1,-1.276481759,-1.170500555,-1.326567295,-0.558080769,-2.940948489,2.940948489,-1.326567295,-1.170500555,0,0,0
3387,15,28,51,110,108,1,15369.211,30,966.335,MORE,-1346,7984,6638,5,2,-2,-0.187481692,2,-1.222253018,-0.278262763,4.752975539,218,110,108,1,1.156811594,1.170500555,1.092467184,1.492011851,-0.559087044,0.559087044,1.092467184,1.170500555,0,1,0
3388,15,29,50,133,110,0,7385.411,60,1128.231,MORE,-322,3694,3372,2,1,-23,-2.15603946,23,2.444506035,1.103455786,1.460282086,243,133,110,1,1.655437281,2.067884313,1.170500555,-0.558080769,0.476153244,0.476153244,1.170500555,2.067884313,1,0,1
3389,15,30,49,131,110,0,9895.334,40,3463.062,MORE,-3884,5854,1970,3,1,-21,-1.968557767,21,2.095290887,0.182310086,2.495429138,241,131,110,1,1.615547226,1.989850943,1.170500555,0.125283438,-3.124946275,3.124946275,1.170500555,1.989850943,1,1,0
3390,15,31,47,126,110,1,6098.063,10,1692.057,MORE,-3354,5072,1718,2,1,-16,-1.499853537,16,1.222253018,-1.199408463,0.929351661,236,126,110,1,1.515822089,1.794767517,1.170500555,-0.558080769,-2.589128547,2.589128547,1.170500555,1.794767517,0,0,0
3391,15,32,50,110,133,1,4835.46,40,982.44,MORE,-512,2444,1932,3,2,23,2.15603946,23,2.444506035,0.182310086,0.408626613,243,110,133,0,1.655437281,1.170500555,2.067884313,0.125283438,0.284067644,0.284067644,2.067884313,1.170500555,1,1,1
3392,15,33,47,110,126,1,6008.152,30,1508.818,MORE,-1990,3722,1732,3,2,16,1.499853537,16,1.222253018,-0.278262763,0.892270401,236,110,126,0,1.515822089,1.170500555,1.794767517,0.125283438,-1.210156132,1.210156132,1.794767517,1.170500555,0,1,0
3393,15,34,12,48,50,1,6182.891,50,1105.731,MORE,-216,2826,2610,5,2,2,0.187481692,2,-1.222253018,0.642882936,0.96433658,98,48,50,0,-1.236591704,-1.248533925,-1.170500555,1.492011851,0.583316789,0.583316789,-1.170500555,-1.248533925,1,1,1
3394,15,35,32,80,77,0,7349.796,70,990.448,MORE,-1632,4266,2634,4,1,-3,-0.281222538,3,-1.047645444,1.564028636,1.445593682,157,80,77,1,-0.059835082,0,-0.117050055,0.808647645,-0.848226422,0.848226422,-0.117050055,0,1,1,0
3395,15,36,43,117,110,1,10474.995,50,973.248,MORE,-1698,5750,4052,5,1,-7,-0.656185922,7,-0.349215148,0.642882936,2.734493991,227,117,110,1,1.336316841,1.443617351,1.170500555,1.492011851,-0.914950893,0.914950893,1.170500555,1.443617351,1,1,0
3396,15,37,40,80,64,0,5421.495,20,1078.382,MORE,-1094,3320,2226,4,1,-16,-1.499853537,16,1.222253018,-0.738835613,0.650320244,144,80,64,1,-0.31912044,0,-0.624266962,0.808647645,-0.30432088,0.30432088,-0.624266962,0,0,1,0
3397,15,38,31,80,78,1,3153.256,30,1689.38,MORE,-1478,2796,1318,1,1,-2,-0.187481692,2,-1.222253018,-0.278262763,-0.285151049,158,80,78,1,-0.039890055,0,-0.07803337,-1.241444975,-0.692535988,0.692535988,-0.07803337,0,0,0,0
3398,15,39,46,124,110,0,6262.733,60,2074.022,MORE,-1000,3394,2394,4,1,-14,-1.312371845,14,0.87303787,1.103455786,0.997265164,234,124,110,1,1.475932034,1.716734147,1.170500555,0.808647645,-0.209289056,0.209289056,1.170500555,1.716734147,1,1,0
3399,15,40,58,92,110,1,4944.41,30,1597.639,MORE,1828,1356,3184,2,1,18,1.687335229,18,1.571468165,-0.278262763,0.453559972,202,92,110,0,0.837691154,0.468200222,1.170500555,-0.558080769,2.649753459,2.649753459,1.170500555,0.468200222,0,0,1
3400,15,41,49,110,131,0,3213.057,20,1650.136,LESS,-2066,3054,988,4,1,21,1.968557767,21,2.095290887,-0.738835613,-0.26048781,241,110,131,1,1.615547226,1.170500555,1.989850943,0.808647645,-1.286990372,1.286990372,1.989850943,1.170500555,0,1,0
3401,15,42,13,47,50,0,1911.881,50,1214.537,LESS,-334,990,656,2,1,3,0.281222538,3,-1.047645444,0.642882936,-0.797121205,97,47,50,1,-1.256536731,-1.28755061,-1.170500555,-0.558080769,0.464021522,0.464021522,-1.170500555,-1.28755061,1,0,1
3402,15,43,16,50,44,1,3329.31,20,1248.964,LESS,104,1790,1894,3,2,-6,-0.562445076,6,-0.523822722,-0.738835613,-0.212542535,94,50,44,0,-1.316371814,-1.170500555,-1.404600665,0.125283438,0.90682938,0.90682938,-1.404600665,-1.170500555,0,1,1
3403,15,44,7,57,50,0,3117.904,10,1027.699,LESS,-1982,2754,772,2,1,-7,-0.656185922,7,-0.349215148,-1.199408463,-0.299730985,107,57,50,0,-1.057086457,-0.897383758,-1.170500555,-0.558080769,-1.202068317,1.202068317,-1.170500555,-0.897383758,0,0,0
3404,15,45,18,42,50,0,2299.119,20,1504.491,LESS,-1360,1964,604,2,1,8,0.749926769,8,-0.174607574,-0.738835613,-0.637415798,92,42,50,1,-1.356261869,-1.482634036,-1.170500555,-0.558080769,-0.57324072,0.57324072,-1.170500555,-1.482634036,0,0,0
3405,15,46,51,108,110,0,2421.203,40,1476.402,LESS,-1016,1830,814,2,1,2,0.187481692,2,-1.222253018,0.182310086,-0.587065691,218,108,110,1,1.156811594,1.092467184,1.170500555,-0.558080769,-0.225464686,0.225464686,1.170500555,1.092467184,1,0,0
3406,15,47,31,78,80,1,4847.147,30,1576.106,LESS,-1060,2772,1712,5,1,2,0.187481692,2,-1.222253018,-0.278262763,0.413446587,158,78,80,1,-0.039890055,-0.07803337,0,1.492011851,-0.269947667,0.269947667,0,-0.07803337,1,1,0
3407,15,48,58,110,92,1,5263.507,10,861.372,LESS,668,2204,2872,5,1,-18,-1.687335229,18,1.571468165,-1.199408463,0.585162543,202,110,92,0,0.837691154,1.170500555,0.468200222,1.492011851,1.47702032,1.47702032,0.468200222,1.170500555,0,1,1
3408,15,49,12,50,48,0,2595.804,0,1128.247,LESS,-1766,2432,666,2,1,-2,-0.187481692,2,-1.222253018,-1.659981313,-0.515056426,98,50,48,0,-1.236591704,-1.170500555,-1.248533925,-0.558080769,-0.983697319,0.983697319,-1.248533925,-1.170500555,0,0,0
3409,15,50,54,110,101,1,2951.027,20,1820.664,LESS,132,1524,1656,3,1,-9,-0.843667615,9,0,-0.738835613,-0.368554704,211,110,101,0,1.017196402,1.170500555,0.819350388,0.125283438,0.935136731,0.935136731,0.819350388,1.170500555,0,1,1
3410,15,51,14,46,50,0,1781.246,10,957.064,LESS,-1318,1848,530,2,1,4,0.374963384,4,-0.87303787,-1.199408463,-0.850997932,96,46,50,1,-1.276481759,-1.326567295,-1.170500555,-0.558080769,-0.530779693,0.530779693,-1.170500555,-1.326567295,0,0,0
3411,15,52,22,80,83,0,2734.038,40,961.186,LESS,-1328,1948,620,2,1,3,0.281222538,3,-1.047645444,0.182310086,-0.458045706,163,80,83,1,0.059835082,0,0.117050055,-0.558080769,-0.540889461,0.540889461,0.117050055,0,1,0,0
3412,15,53,6,50,56,0,2200.877,60,1208.63,LESS,-1114,1622,508,2,1,6,0.562445076,6,-0.523822722,1.103455786,-0.677932944,106,50,56,1,-1.077031484,-1.170500555,-0.936400444,-0.558080769,-0.324540417,0.324540417,-0.936400444,-1.170500555,1,0,0
3413,15,54,13,50,47,1,2352.41,10,1449.032,LESS,-942,1960,1018,3,1,-3,-0.281222538,3,-1.047645444,-1.199408463,-0.615437426,97,50,47,0,-1.256536731,-1.170500555,-1.28755061,0.125283438,-0.150652399,0.150652399,-1.28755061,-1.170500555,0,1,0
3414,15,55,46,110,124,0,3729.995,20,998.566,LESS,-1192,2508,1316,4,1,14,1.312371845,14,0.87303787,-0.738835613,-0.047291292,234,110,124,1,1.475932034,1.170500555,1.716734147,0.808647645,-0.40339661,0.40339661,1.716734147,1.170500555,0,1,0
3415,15,56,27,91,80,1,5162.3,10,2388.883,LESS,-2358,4240,1882,5,1,-11,-1.031149307,11,0.349215148,-1.199408463,0.543422566,171,91,80,0,0.219395302,0.429183537,0,1.492011851,-1.582195611,1.582195611,0,0.429183537,0,1,0
3416,15,57,40,64,80,0,1931.223,10,724.405,LESS,-1282,1792,510,2,1,16,1.499853537,16,1.222253018,-1.199408463,-0.789144142,144,64,80,1,-0.31912044,-0.624266962,0,-0.558080769,-0.494384526,0.494384526,0,-0.624266962,0,0,0
3417,15,58,22,83,80,1,6761.232,10,1719.041,LESS,-1528,4138,2610,7,1,-3,-0.281222538,3,-1.047645444,-1.199408463,1.202857037,163,83,80,0,0.059835082,0.117050055,0,2.858740265,-0.74308483,0.74308483,0,0.117050055,0,1,0
3418,15,59,54,101,110,0,2898.953,20,1467.836,LESS,-1976,2538,562,2,1,9,0.843667615,9,0,-0.738835613,-0.390031159,211,101,110,1,1.017196402,0.819350388,1.170500555,-0.558080769,-1.196002456,1.196002456,1.170500555,0.819350388,0,0,0
3419,15,60,6,56,50,0,7102.359,20,1503.537,LESS,-214,3282,3068,9,1,-6,-0.562445076,6,-0.523822722,-0.738835613,1.343545261,106,56,50,0,-1.077031484,-0.936400444,-1.170500555,4.225468678,0.585338743,0.585338743,-1.170500555,-0.936400444,0,1,1
3420,15,61,18,50,42,1,3027.068,30,1536.673,LESS,600,960,1560,3,2,-8,-0.749926769,8,-0.174607574,-0.278262763,-0.337193735,92,50,42,0,-1.356261869,-1.170500555,-1.482634036,0.125283438,1.408273894,1.408273894,-1.482634036,-1.170500555,1,1,1
3421,15,62,43,110,117,0,3191.786,40,1183.071,LESS,-820,1806,986,4,1,7,0.656185922,7,-0.349215148,0.182310086,-0.269260435,227,110,117,1,1.336316841,1.170500555,1.443617351,0.808647645,-0.027313224,0.027313224,1.443617351,1.170500555,1,1,1
3422,15,63,32,77,80,0,2312.661,10,1310.652,LESS,-1728,2242,514,2,1,3,0.281222538,3,-1.047645444,-1.199408463,-0.631830782,157,77,80,1,-0.059835082,-0.117050055,0,-0.558080769,-0.945280199,0.945280199,0,-0.117050055,0,0,0
3423,15,64,27,80,91,0,1751.829,60,833.751,LESS,-582,1068,486,2,1,11,1.031149307,11,0.349215148,1.103455786,-0.863130145,171,80,91,1,0.219395302,0,0.429183537,-0.558080769,0.213299264,0.213299264,0.429183537,0,1,0,1
3424,15,65,16,44,50,0,1885.989,70,904.589,LESS,-474,1016,542,2,1,6,0.562445076,6,-0.523822722,1.564028636,-0.807799631,94,44,50,1,-1.316371814,-1.404600665,-1.170500555,-0.558080769,0.322484764,0.322484764,-1.170500555,-1.404600665,1,1,1
3425,15,66,7,50,57,0,1841.842,70,1436.942,LESS,-606,1088,482,2,1,7,0.656185922,7,-0.349215148,1.564028636,-0.826006818,107,50,57,1,-1.057086457,-1.170500555,-0.897383758,-0.558080769,0.18903582,0.18903582,-0.897383758,-1.170500555,1,0,1
3426,15,67,14,50,46,1,3151.299,30,1388.675,LESS,476,1132,1608,3,2,-4,-0.374963384,4,-0.87303787,-0.278262763,-0.285958158,96,50,46,0,-1.276481759,-1.170500555,-1.326567295,0.125283438,1.282912766,1.282912766,-1.326567295,-1.170500555,1,1,1
3427,15,68,51,110,108,1,2884.346,20,999.755,LESS,-222,1582,1360,3,1,-2,-0.187481692,2,-1.222253018,-0.738835613,-0.396055405,218,110,108,0,1.156811594,1.170500555,1.092467184,0.125283438,0.577250928,0.577250928,1.092467184,1.170500555,0,1,1
3428,15,69,50,133,110,1,2756.411,50,1737.808,LESS,-206,1460,1254,3,1,-23,-2.15603946,23,2.444506035,0.642882936,-0.448818592,243,133,110,0,1.655437281,2.067884313,1.170500555,0.125283438,0.593426558,0.593426558,1.170500555,2.067884313,1,1,1
3429,15,70,49,131,110,1,2296.337,20,1158.503,LESS,-856,1736,880,1,1,-21,-1.968557767,21,2.095290887,-0.738835613,-0.638563156,241,131,110,0,1.615547226,1.989850943,1.170500555,-1.241444975,-0.063708391,0.063708391,1.170500555,1.989850943,0,0,0
3430,15,71,47,126,110,0,2620.081,10,1979.122,LESS,-1990,2548,558,2,1,-16,-1.499853537,16,1.222253018,-1.199408463,-0.505044061,236,126,110,0,1.515822089,1.794767517,1.170500555,-0.558080769,-1.210156132,1.210156132,1.170500555,1.794767517,0,0,0
3431,15,72,50,110,133,0,3754.063,10,1110.116,LESS,-1690,2840,1150,4,1,23,2.15603946,23,2.444506035,-1.199408463,-0.037365123,243,110,133,1,1.655437281,1.170500555,2.067884313,0.808647645,-0.906863079,0.906863079,2.067884313,1.170500555,0,1,0
3432,15,73,47,110,126,0,2232.07,30,1465.745,LESS,-296,1090,794,3,1,16,1.499853537,16,1.222253018,-0.278262763,-0.66506827,236,110,126,1,1.515822089,1.170500555,1.794767517,0.125283438,0.502438642,0.502438642,1.794767517,1.170500555,1,1,1
3433,15,74,12,48,50,0,4715.899,20,958.123,LESS,-2634,3888,1254,4,1,2,0.187481692,2,-1.222253018,-0.738835613,0.359317046,98,48,50,1,-1.236591704,-1.248533925,-1.170500555,0.808647645,-1.86122522,1.86122522,-1.170500555,-1.248533925,0,1,0
3434,15,75,32,80,77,0,4339.1,20,1549.136,LESS,-1632,3052,1420,4,1,-3,-0.281222538,3,-1.047645444,-0.738835613,0.203916911,157,80,77,0,-0.059835082,0,-0.117050055,0.808647645,-0.848226422,0.848226422,-0.117050055,0,0,1,0
3435,15,76,43,117,110,1,4913.117,0,1906.458,LESS,-1096,3500,2404,3,1,-7,-0.656185922,7,-0.349215148,-1.659981313,0.440654056,227,117,110,0,1.336316841,1.443617351,1.170500555,0.125283438,-0.306342833,0.306342833,1.170500555,1.443617351,0,1,0
3436,15,77,40,80,64,1,3676.601,30,1003.426,LESS,-468,1796,1328,3,2,-16,-1.499853537,16,1.222253018,-0.278262763,-0.069312143,144,80,64,0,-0.31912044,0,-0.624266962,0.125283438,0.328550625,0.328550625,-0.624266962,0,1,1,1
3437,15,78,31,80,78,0,5630.674,20,1109.927,LESS,-1182,3268,2086,6,1,-2,-0.187481692,2,-1.222253018,-0.738835613,0.736590231,158,80,78,0,-0.039890055,0,-0.07803337,2.175376058,-0.393286842,0.393286842,-0.07803337,0,1,1,0
3438,15,79,46,124,110,1,3010.181,50,1538.89,LESS,402,1128,1530,3,2,-14,-1.312371845,14,0.87303787,0.642882936,-0.344158303,234,124,110,0,1.475932034,1.716734147,1.170500555,0.125283438,1.208100479,1.208100479,1.170500555,1.716734147,1,1,1
3439,15,80,58,92,110,0,2233.943,70,1482.025,LESS,-870,1428,558,2,1,18,1.687335229,18,1.571468165,1.564028636,-0.664295804,202,92,110,1,0.837691154,0.468200222,1.170500555,-0.558080769,-0.077862067,0.077862067,1.170500555,0.468200222,1,0,0
3440,15,81,48,128,110,0,2979.25,30,1045.324,MORE,-522,1576,1054,4,1,-18,-1.687335229,18,1.571468165,-0.278262763,-0.356914923,238,128,110,1,1.555712144,1.872800887,1.170500555,0.808647645,0.273957875,0.273957875,1.170500555,1.872800887,0,1,1
3441,15,82,8,50,58,1,3156.916,10,1866.769,MORE,-342,1974,1632,3,1,8,0.749926769,8,-0.174607574,-1.199408463,-0.283641585,108,50,58,0,-1.037141429,-1.170500555,-0.858367073,0.125283438,0.455933707,0.455933707,-0.858367073,-1.170500555,0,1,1
3442,15,83,4,54,50,1,3595.586,30,1396.024,MORE,968,1154,2122,3,2,-4,-0.374963384,4,-0.87303787,-0.278262763,-0.102724498,104,54,50,1,-1.116921539,-1.014433814,-1.170500555,0.125283438,1.780313373,1.780313373,-1.170500555,-1.014433814,0,1,1
3443,15,84,37,80,69,0,3120.278,80,1598.935,MORE,-856,2102,1246,2,2,-11,-1.031149307,11,0.349215148,2.024601486,-0.298751896,149,80,69,1,-0.219395302,0,-0.429183537,-0.558080769,-0.063708391,0.063708391,-0.429183537,0,1,0,0
3444,15,85,52,105,110,1,2814.763,70,1173.585,MORE,-752,1638,886,1,2,5,0.46870423,5,-0.698430296,1.564028636,-0.424752953,215,105,110,0,1.096976512,0.975417129,1.170500555,-1.241444975,0.041433201,0.041433201,1.170500555,0.975417129,1,0,0
3445,15,86,5,55,50,0,2994.377,30,1317.903,MORE,-1868,2564,696,2,1,-5,-0.46870423,5,-0.698430296,-0.278262763,-0.350676218,105,55,50,1,-1.096976512,-0.975417129,-1.170500555,-0.558080769,-1.086816957,1.086816957,-1.170500555,-0.975417129,0,0,0
3446,15,87,30,96,80,0,3986.693,30,1294.904,MORE,-890,2332,1442,4,1,-16,-1.499853537,16,1.222253018,-0.278262763,0.058576569,176,96,80,1,0.31912044,0.624266962,0,0.808647645,-0.098081603,0.098081603,0,0.624266962,0,1,0
3447,15,88,33,80,75,0,3316.936,40,584.17,MORE,-1252,2222,970,2,1,-5,-0.46870423,5,-0.698430296,0.182310086,-0.217645843,155,80,75,1,-0.099725137,0,-0.195083426,-0.558080769,-0.464055221,0.464055221,-0.195083426,0,1,0,0
3448,15,89,48,110,128,1,3882.113,20,1263.87,MORE,16,1838,1854,3,1,18,1.687335229,18,1.571468165,-0.738835613,0.015445493,238,110,128,0,1.555712144,1.170500555,1.872800887,0.125283438,0.817863417,0.817863417,1.872800887,1.170500555,0,0,1
3449,15,90,9,59,50,0,6059.312,10,1415.92,MORE,-1310,3950,2640,4,1,-9,-0.843667615,9,0,-1.199408463,0.913369902,109,59,50,1,-1.017196402,-0.819350388,-1.170500555,0.808647645,-0.522691878,0.522691878,-1.170500555,-0.819350388,0,1,0
3450,15,91,44,110,119,1,2162.938,90,1619.147,MORE,814,880,1694,1,2,9,0.843667615,9,0,2.485174336,-0.693579816,229,110,119,0,1.376206896,1.170500555,1.521650721,-1.241444975,1.624622939,1.624622939,1.521650721,1.170500555,1,0,1
3451,15,92,2,52,50,1,2865.913,70,1225.415,MORE,-438,1386,948,1,2,-2,-0.187481692,2,-1.222253018,1.564028636,-0.403657576,102,52,50,1,-1.156811594,-1.092467184,-1.170500555,-1.241444975,0.35887993,0.35887993,-1.170500555,-1.092467184,1,0,1
3452,15,93,8,58,50,1,5206.444,30,1149.823,MORE,-546,2612,2066,3,2,-8,-0.749926769,8,-0.174607574,-0.278262763,0.561628516,108,58,50,1,-1.037141429,-0.858367073,-1.170500555,0.125283438,0.249694431,0.249694431,-1.170500555,-0.858367073,0,1,1
3453,15,94,44,119,110,0,2973.926,80,1790.998,MORE,-1100,1896,796,2,1,-9,-0.843667615,9,0,2.024601486,-0.359110657,229,119,110,1,1.376206896,1.521650721,1.170500555,-0.558080769,-0.310386741,0.310386741,1.170500555,1.521650721,1,0,0
3454,15,95,34,74,80,1,2883.09,20,1300.527,MORE,-718,1766,1048,1,1,6,0.562445076,6,-0.523822722,-0.738835613,-0.396573406,154,74,80,0,-0.119670165,-0.234100111,0,-1.241444975,0.075806414,0.075806414,0,-0.234100111,0,0,0
3455,15,96,24,86,80,1,4685.692,20,1421.919,MORE,-490,2894,2404,3,1,-6,-0.562445076,6,-0.523822722,-0.738835613,0.34685902,166,86,80,1,0.119670165,0.234100111,0,0.125283438,0.306309134,0.306309134,0,0.234100111,0,1,1
3456,15,97,39,66,80,1,3041.92,50,1913.987,MORE,-566,1600,1034,1,2,14,1.312371845,14,0.87303787,0.642882936,-0.331068446,146,66,80,0,-0.279230385,-0.546233592,0,-1.241444975,0.229474894,0.229474894,0,-0.546233592,1,0,1
3457,15,98,9,50,59,1,1800.668,60,1446.988,MORE,110,710,820,1,2,9,0.843667615,9,0,1.103455786,-0.842987875,109,50,59,0,-1.017196402,-1.170500555,-0.819350388,-1.241444975,0.912895241,0.912895241,-0.819350388,-1.170500555,1,0,1
3458,15,99,57,94,110,1,1763.589,80,1528.824,MORE,42,710,752,1,2,16,1.499853537,16,1.222253018,2.024601486,-0.858280064,204,94,110,0,0.877581209,0.546233592,1.170500555,-1.241444975,0.844148815,0.844148815,1.170500555,0.546233592,1,0,1
3459,15,100,60,110,87,0,2315.861,30,1025.151,MORE,-580,1418,838,2,1,-23,-2.15603946,23,2.444506035,-0.278262763,-0.630511032,197,110,87,1,0.737966017,1.170500555,0.273116796,-0.558080769,0.215321218,0.215321218,0.273116796,1.170500555,0,0,1
3460,15,101,33,75,80,0,2945.51,60,1461.343,MORE,-1126,1924,798,2,1,5,0.46870423,5,-0.698430296,1.103455786,-0.370830035,155,75,80,0,-0.099725137,-0.195083426,0,-0.558080769,-0.336672139,0.336672139,0,-0.195083426,1,0,0
3461,15,102,15,50,45,0,2771.265,40,3979.682,MORE,-1676,2360,684,2,1,-5,-0.46870423,5,-0.698430296,0.182310086,-0.442692478,95,50,45,1,-1.296426786,-1.170500555,-1.36558398,-0.558080769,-0.892709403,0.892709403,-1.36558398,-1.170500555,0,0,0
3462,15,103,59,89,110,1,4139.096,70,3268.832,MORE,184,1694,1878,2,1,21,1.968557767,21,2.095290887,1.564028636,0.121430894,199,89,110,0,0.777856072,0.351150166,1.170500555,-0.558080769,0.987707527,0.987707527,1.170500555,0.351150166,1,0,1
3463,15,104,29,80,94,0,2622.048,50,1083.836,MORE,-960,1666,706,2,1,14,1.312371845,14,0.87303787,0.642882936,-0.504232827,174,80,94,0,0.279230385,0,0.546233592,-0.558080769,-0.168849983,0.168849983,0.546233592,0,1,0,0
3464,15,105,55,110,98,0,3390.561,50,1417.146,MORE,-1470,2356,886,2,1,-12,-1.124890153,12,0.523822722,0.642882936,-0.187281285,208,110,98,1,0.957361319,1.170500555,0.702300333,-0.558080769,-0.684448173,0.684448173,0.702300333,1.170500555,1,0,0
3465,15,106,29,94,80,0,2481.136,10,975.505,MORE,-1492,2198,706,2,1,-14,-1.312371845,14,0.87303787,-1.199408463,-0.562348013,174,94,80,1,0.279230385,0.546233592,0,-0.558080769,-0.706689664,0.706689664,0,0.546233592,0,0,0
3466,15,107,57,110,94,1,6369.557,30,1488.032,MORE,-1192,3536,2344,5,2,-16,-1.499853537,16,1.222253018,-0.278262763,1.041321714,204,110,94,1,0.877581209,1.170500555,0.546233592,1.492011851,-0.40339661,0.40339661,0.546233592,1.170500555,0,1,0
3467,15,108,39,80,66,1,2528.916,10,1406.164,MORE,-1466,2400,934,1,1,-14,-1.312371845,14,0.87303787,-1.199408463,-0.542642498,146,80,66,1,-0.279230385,0,-0.546233592,-1.241444975,-0.680404266,0.680404266,-0.546233592,0,0,0,0
3468,15,109,4,50,54,1,3756.866,10,1061.472,MORE,-912,2362,1450,2,1,4,0.374963384,4,-0.87303787,-1.199408463,-0.036209104,104,50,54,0,-1.116921539,-1.170500555,-1.014433814,-0.558080769,-0.120323094,0.120323094,-1.014433814,-1.170500555,0,0,0
3469,15,110,55,98,110,0,4616.184,40,1001.294,MORE,-2068,3206,1138,2,1,12,1.124890153,12,0.523822722,0.182310086,0.318192403,208,98,110,0,0.957361319,0.702300333,1.170500555,-0.558080769,-1.289012326,1.289012326,1.170500555,0.702300333,0,0,0
3470,15,111,2,50,52,1,1577.296,20,1392.226,MORE,-810,1696,886,1,1,2,0.187481692,2,-1.222253018,-0.738835613,-0.935111365,102,50,52,0,-1.156811594,-1.170500555,-1.092467184,-1.241444975,-0.017203456,0.017203456,-1.092467184,-1.170500555,0,0,0
3471,15,112,59,110,89,1,1761.881,80,1000.045,MORE,300,632,932,1,2,-21,-1.968557767,21,2.095290887,2.024601486,-0.858984481,199,110,89,1,0.777856072,1.170500555,0.351150166,-1.241444975,1.104980841,1.104980841,0.351150166,1.170500555,1,0,1
3472,15,113,60,87,110,1,3794.42,30,1840.005,MORE,-216,1980,1764,3,2,23,2.15603946,23,2.444506035,-0.278262763,-0.020721015,197,87,110,0,0.737966017,0.273116796,1.170500555,0.125283438,0.583316789,0.583316789,1.170500555,0.273116796,0,1,1
3473,15,114,52,110,105,1,2456.939,30,1577.961,MORE,126,1020,1146,1,2,-5,-0.46870423,5,-0.698430296,-0.278262763,-0.572327384,215,110,105,1,1.096976512,1.170500555,0.975417129,-1.241444975,0.92907087,0.92907087,0.975417129,1.170500555,0,0,1
3474,15,115,30,80,96,1,3026.124,20,858.459,MORE,-128,1514,1386,3,2,16,1.499853537,16,1.222253018,-0.738835613,-0.337583062,176,80,96,0,0.31912044,0,0.624266962,0.125283438,0.672282752,0.672282752,0.624266962,0,0,1,1
3475,15,116,24,80,86,1,2286.223,80,1147.499,MORE,224,816,1040,1,2,6,0.562445076,6,-0.523822722,2.024601486,-0.64273439,166,80,86,0,0.119670165,0,0.234100111,-1.241444975,1.028146601,1.028146601,0.234100111,0,1,0,1
3476,15,117,5,50,55,1,7993.306,20,2178.183,MORE,2512,2176,4688,4,1,5,0.46870423,5,-0.698430296,-0.738835613,1.710991258,105,50,55,0,-1.096976512,-1.170500555,-0.975417129,0.808647645,3.34126162,3.34126162,-0.975417129,-1.170500555,0,1,1
3477,15,118,34,80,74,1,5194.652,20,1771.913,MORE,-188,2636,2448,3,1,-6,-0.562445076,6,-0.523822722,-0.738835613,0.556765237,154,80,74,1,-0.119670165,0,-0.234100111,0.125283438,0.611624141,0.611624141,-0.234100111,0,0,1,1
3478,15,119,15,45,50,1,2514.565,70,1196.401,MORE,136,1010,1146,3,2,5,0.46870423,5,-0.698430296,1.564028636,-0.548561163,95,45,50,0,-1.296426786,-1.36558398,-1.170500555,0.125283438,0.939180639,0.939180639,-1.170500555,-1.36558398,1,0,1
3479,15,120,37,69,80,1,2769.315,50,1418.169,MORE,-956,1774,818,3,2,11,1.031149307,11,0.349215148,0.642882936,-0.443496701,149,69,80,0,-0.219395302,-0.429183537,0,0.125283438,-0.164806075,0.164806075,0,-0.429183537,1,0,0
3480,15,121,48,128,110,1,2718.708,10,970.494,LESS,-130,1686,1556,3,1,-18,-1.687335229,18,1.571468165,-1.199408463,-0.464368133,238,128,110,0,1.555712144,1.872800887,1.170500555,0.125283438,0.670260798,0.670260798,1.170500555,1.872800887,0,1,1
3481,15,122,8,50,58,0,1756.919,70,1854.072,LESS,-330,952,622,2,1,8,0.749926769,8,-0.174607574,1.564028636,-0.861030918,108,50,58,1,-1.037141429,-1.170500555,-0.858367073,-0.558080769,0.468065429,0.468065429,-0.858367073,-1.170500555,1,0,1
3482,15,123,4,54,50,0,1910.429,30,2294.681,LESS,-1426,1990,564,2,1,-4,-0.374963384,4,-0.87303787,-0.278262763,-0.797720042,104,54,50,0,-1.116921539,-1.014433814,-1.170500555,-0.558080769,-0.639965192,0.639965192,-1.170500555,-1.014433814,1,0,0
3483,15,124,37,80,69,0,1606.328,0,1568.33,LESS,-1600,2046,446,2,1,-11,-1.031149307,11,0.349215148,-1.659981313,-0.923137934,149,80,69,0,-0.219395302,0,-0.429183537,-0.558080769,-0.815875163,0.815875163,-0.429183537,0,0,0,0
3484,15,125,52,105,110,1,4621.395,10,1619.626,LESS,-1048,3080,2032,5,1,5,0.46870423,5,-0.698430296,-1.199408463,0.320341533,215,105,110,1,1.096976512,0.975417129,1.170500555,1.492011851,-0.257815945,0.257815945,1.170500555,0.975417129,0,1,0
3485,15,126,5,55,50,1,6781.861,10,1948.877,LESS,-810,3884,3074,5,1,-5,-0.46870423,5,-0.698430296,-1.199408463,1.211364887,105,55,50,0,-1.096976512,-0.975417129,-1.170500555,1.492011851,-0.017203456,0.017203456,-1.170500555,-0.975417129,0,1,1
3486,15,127,30,96,80,0,4229.285,10,1864.734,LESS,-1244,3052,1808,4,1,-16,-1.499853537,16,1.222253018,-1.199408463,0.158626807,176,96,80,0,0.31912044,0.624266962,0,0.808647645,-0.455967406,0.455967406,0,0.624266962,0,1,0
3487,15,128,33,80,75,1,3837.949,20,1306.814,LESS,88,1816,1904,3,1,-5,-0.46870423,5,-0.698430296,-0.738835613,-0.002768705,155,80,75,0,-0.099725137,0,-0.195083426,0.125283438,0.89065375,0.89065375,-0.195083426,0,0,1,1
3488,15,129,48,110,128,0,1884.373,60,1359.03,LESS,-622,1146,524,2,1,18,1.687335229,18,1.571468165,1.103455786,-0.808466105,238,110,128,1,1.555712144,1.170500555,1.872800887,-0.558080769,0.172860191,0.172860191,1.872800887,1.170500555,1,0,1
3489,15,130,9,59,50,1,3025.372,10,843.864,LESS,42,1520,1562,3,1,-9,-0.843667615,9,0,-1.199408463,-0.337893203,109,59,50,0,-1.017196402,-0.819350388,-1.170500555,0.125283438,0.844148815,0.844148815,-1.170500555,-0.819350388,0,1,1
3490,15,131,44,110,119,0,1598.082,40,987.718,LESS,-660,1078,418,2,1,9,0.843667615,9,0,0.182310086,-0.926538765,229,110,119,1,1.376206896,1.170500555,1.521650721,-0.558080769,0.134443071,0.134443071,1.521650721,1.170500555,1,0,1
3491,15,132,2,52,50,1,4371.913,20,1458.082,LESS,68,1888,1956,5,2,-2,-0.187481692,2,-1.222253018,-0.738835613,0.217449709,102,52,50,0,-1.156811594,-1.092467184,-1.170500555,1.492011851,0.870434213,0.870434213,-1.170500555,-1.092467184,0,1,1
3492,15,133,8,58,50,1,2226.644,20,2023.209,LESS,-760,1884,1124,1,1,-8,-0.749926769,8,-0.174607574,-0.738835613,-0.667306071,108,58,50,0,-1.037141429,-0.858367073,-1.170500555,-1.241444975,0.033345386,0.033345386,-1.170500555,-0.858367073,0,0,1
3493,15,134,44,119,110,1,2362.153,10,1622.187,LESS,-450,1652,1202,3,1,-9,-0.843667615,9,0,-1.199408463,-0.6114192,229,119,110,0,1.376206896,1.521650721,1.170500555,0.125283438,0.346748208,0.346748208,1.170500555,1.521650721,0,1,1
3494,15,135,34,74,80,0,3672.313,10,2710.729,LESS,-752,2228,1476,4,1,6,0.562445076,6,-0.523822722,-1.199408463,-0.071080608,154,74,80,1,-0.119670165,-0.234100111,0,0.808647645,0.041433201,0.041433201,0,-0.234100111,0,1,1
3495,15,136,24,86,80,0,3397.714,40,1373.921,LESS,-900,2094,1194,4,1,-6,-0.562445076,6,-0.523822722,0.182310086,-0.184331232,166,86,80,0,0.119670165,0.234100111,0,0.808647645,-0.108191372,0.108191372,0,0.234100111,1,1,0
3496,15,137,39,66,80,0,2572.407,10,747.646,LESS,-1804,2390,586,2,1,14,1.312371845,14,0.87303787,-1.199408463,-0.52470586,146,66,80,1,-0.279230385,-0.546233592,0,-0.558080769,-1.022114439,1.022114439,0,-0.546233592,0,0,0
3497,15,138,9,50,59,0,1822.967,80,1336.512,LESS,-336,1036,700,2,2,9,0.843667615,9,0,2.024601486,-0.83379128,109,50,59,1,-1.017196402,-1.170500555,-0.819350388,-0.558080769,0.461999568,0.461999568,-0.819350388,-1.170500555,1,0,1
3498,15,139,57,94,110,0,2926.668,20,1902.098,LESS,-1886,2422,536,2,1,16,1.499853537,16,1.222253018,-0.738835613,-0.378600888,204,94,110,1,0.877581209,0.546233592,1.170500555,-0.558080769,-1.10501454,1.10501454,1.170500555,0.546233592,0,0,0
3499,15,140,60,110,87,1,3288.899,20,1123.347,LESS,218,1372,1590,3,1,-23,-2.15603946,23,2.444506035,-0.738835613,-0.229208914,197,110,87,0,0.737966017,1.170500555,0.273116796,0.125283438,1.02208074,1.02208074,0.273116796,1.170500555,0,1,1
3500,15,141,33,75,80,0,1954.916,80,1535.434,LESS,-608,1192,584,2,1,5,0.46870423,5,-0.698430296,2.024601486,-0.779372631,155,75,80,1,-0.099725137,-0.195083426,0,-0.558080769,0.187013867,0.187013867,0,-0.195083426,1,0,1
3501,15,142,15,50,45,1,3543.855,30,910.905,LESS,372,1228,1600,3,2,-5,-0.46870423,5,-0.698430296,-0.278262763,-0.124059492,95,50,45,0,-1.296426786,-1.170500555,-1.36558398,0.125283438,1.177771174,1.177771174,-1.36558398,-1.170500555,1,1,1
3502,15,143,59,89,110,0,2000.4,30,1164.033,LESS,-812,1354,542,2,1,21,1.968557767,21,2.095290887,-0.278262763,-0.760614037,199,89,110,1,0.777856072,0.351150166,1.170500555,-0.558080769,-0.01922541,0.01922541,1.170500555,0.351150166,1,0,1
3503,15,144,29,80,94,0,1725.147,30,1687.694,LESS,-478,964,486,2,1,14,1.312371845,14,0.87303787,-0.278262763,-0.874134384,174,80,94,1,0.279230385,0,0.546233592,-0.558080769,0.318440856,0.318440856,0.546233592,0,1,0,1
3504,15,145,55,110,98,1,2511.125,50,1266.927,LESS,178,1000,1178,3,2,-12,-1.124890153,12,0.523822722,0.642882936,-0.549979895,208,110,98,0,0.957361319,1.170500555,0.702300333,0.125283438,0.981641666,0.981641666,0.702300333,1.170500555,1,1,1
3505,15,146,29,94,80,1,2649.541,50,1243.713,LESS,-32,1160,1128,3,2,-14,-1.312371845,14,0.87303787,0.642882936,-0.492894114,174,94,80,0,0.279230385,0.546233592,0,0.125283438,0.769336529,0.769336529,0,0.546233592,1,1,1
3506,15,147,57,110,94,1,2566.174,0,940.815,LESS,-854,1904,1050,3,1,-16,-1.499853537,16,1.222253018,-1.659981313,-0.527276485,204,110,94,0,0.877581209,1.170500555,0.546233592,0.125283438,-0.061686437,0.061686437,0.546233592,1.170500555,0,1,1
3507,15,148,39,80,66,1,4575.964,30,976.431,LESS,-304,2176,1872,5,2,-14,-1.312371845,14,0.87303787,-0.278262763,0.301604797,146,80,66,0,-0.279230385,0,-0.546233592,1.492011851,0.494350827,0.494350827,-0.546233592,0,1,1,1
3508,15,149,4,50,54,0,5647.967,20,2019.155,LESS,-1374,3232,1858,4,1,4,0.374963384,4,-0.87303787,-0.738835613,0.743722242,104,50,54,1,-1.116921539,-1.170500555,-1.014433814,0.808647645,-0.587394396,0.587394396,-1.014433814,-1.170500555,0,1,0
3509,15,150,55,98,110,0,3817.8,30,813.954,LESS,-2186,2796,610,2,1,12,1.124890153,12,0.523822722,-0.278262763,-0.011078592,208,98,110,1,0.957361319,0.702300333,1.170500555,-0.558080769,-1.408307593,1.408307593,1.170500555,0.702300333,1,0,0
3510,15,151,2,50,52,0,1913.333,40,1198.711,LESS,-374,1004,630,2,1,2,0.187481692,2,-1.222253018,0.182310086,-0.796522369,102,50,52,1,-1.156811594,-1.170500555,-1.092467184,-0.558080769,0.423582448,0.423582448,-1.092467184,-1.170500555,1,0,1
3511,15,152,59,110,89,1,2582.84,20,1205.908,LESS,-40,1332,1292,3,1,-21,-1.968557767,21,2.095290887,-0.738835613,-0.520403063,199,110,89,0,0.777856072,1.170500555,0.351150166,0.125283438,0.761248714,0.761248714,0.351150166,1.170500555,0,1,1
3512,15,153,60,87,110,0,2610.201,30,2349.741,LESS,-1100,1916,816,2,1,23,2.15603946,23,2.444506035,-0.278262763,-0.509118789,197,87,110,1,0.737966017,0.273116796,1.170500555,-0.558080769,-0.310386741,0.310386741,1.170500555,0.273116796,1,0,0
3513,15,154,52,110,105,1,1888.47,30,878.89,LESS,500,554,1054,1,2,-5,-0.46870423,5,-0.698430296,-0.278262763,-0.806776413,215,110,105,0,1.096976512,1.170500555,0.975417129,-1.241444975,1.30717621,1.30717621,0.975417129,1.170500555,1,0,1
3514,15,155,30,80,96,0,1708.715,30,1101.262,LESS,-1184,1656,472,2,1,16,1.499853537,16,1.222253018,-0.278262763,-0.8809113,176,80,96,1,0.31912044,0,0.624266962,-0.558080769,-0.395308796,0.395308796,0.624266962,0,1,0,0
3515,15,156,24,80,86,0,2612.92,30,1092.713,LESS,-1516,2162,646,2,1,6,0.562445076,6,-0.523822722,-0.278262763,-0.507997414,166,80,86,1,0.119670165,0,0.234100111,-0.558080769,-0.730953108,0.730953108,0.234100111,0,1,0,0
3516,15,157,5,50,55,1,2526.137,40,1126.655,LESS,-106,1154,1048,3,2,5,0.46870423,5,-0.698430296,0.182310086,-0.543788618,105,50,55,1,-1.096976512,-1.170500555,-0.975417129,0.125283438,0.694524242,0.694524242,-0.975417129,-1.170500555,1,1,1
3517,15,158,34,80,74,1,2436.881,30,1097.605,LESS,-238,1246,1008,1,2,-6,-0.562445076,6,-0.523822722,-0.278262763,-0.580599741,154,80,74,0,-0.119670165,0,-0.234100111,-1.241444975,0.561075299,0.561075299,-0.234100111,0,1,0,1
3518,15,159,15,45,50,0,2371.353,60,1171.803,LESS,-754,1376,622,2,1,5,0.46870423,5,-0.698430296,1.103455786,-0.607624919,95,45,50,1,-1.296426786,-1.36558398,-1.170500555,-0.558080769,0.039411247,0.039411247,-1.170500555,-1.36558398,1,0,1
3519,15,160,37,69,80,0,1880.462,40,1193.452,LESS,-870,1326,456,2,1,11,1.031149307,11,0.349215148,0.182310086,-0.810079087,149,69,80,1,-0.219395302,-0.429183537,0,-0.558080769,-0.077862067,0.077862067,0,-0.429183537,1,0,0
3520,15,161,3,50,53,0,2780.69,10,643.166,MORE,-1118,1970,852,4,1,3,0.281222538,3,-1.047645444,-1.199408463,-0.438805402,103,50,53,0,-1.136866566,-1.170500555,-1.053450499,0.808647645,-0.328584324,0.328584324,-1.053450499,-1.170500555,0,1,0
3521,15,162,20,50,40,0,1750.459,60,1901.483,MORE,-362,1300,938,2,1,-10,-0.937408461,10,0.174607574,1.103455786,-0.863695163,90,50,40,1,-1.396151924,-1.170500555,-1.560667406,-0.558080769,0.43571417,0.43571417,-1.560667406,-1.170500555,1,0,1
3522,15,163,25,80,88,1,1840.353,90,1946.307,MORE,1826,636,2462,1,2,8,0.749926769,8,-0.174607574,2.485174336,-0.826620914,168,80,88,0,0.15956022,0,0.312133481,-1.241444975,2.647731505,2.647731505,0.312133481,0,1,0,1
3523,15,164,42,115,110,0,3000.427,70,1977.12,MORE,-1206,2018,812,2,1,-5,-0.46870423,5,-0.698430296,1.564028636,-0.348181065,225,115,110,1,1.296426786,1.36558398,1.170500555,-0.558080769,-0.417550286,0.417550286,1.170500555,1.36558398,1,0,0
3524,15,165,53,103,110,1,4711.282,30,843.777,MORE,-820,2548,1728,3,2,7,0.656185922,7,-0.349215148,-0.278262763,0.357412895,213,103,110,0,1.057086457,0.897383758,1.170500555,0.125283438,-0.027313224,0.027313224,1.170500555,0.897383758,0,1,0
3525,15,166,26,90,80,0,6119.472,40,1156.499,MORE,-916,3166,2250,6,1,-10,-0.937408461,10,0.174607574,0.182310086,0.9381812,170,90,80,1,0.199450275,0.390166852,0,2.175376058,-0.124367001,0.124367001,0,0.390166852,1,1,0
3526,15,167,35,80,72,1,6086.817,40,1196.823,MORE,602,1670,2272,3,2,-8,-0.749926769,8,-0.174607574,0.182310086,0.924713565,152,80,72,1,-0.15956022,0,-0.312133481,0.125283438,1.410295848,1.410295848,-0.312133481,0,1,1,1
3527,15,168,28,93,80,0,2073.7,60,1188.879,MORE,-574,1258,684,2,1,-13,-1.218630999,13,0.698430296,1.103455786,-0.730383516,173,93,80,1,0.259285357,0.507216907,0,-0.558080769,0.221387079,0.221387079,0,0.507216907,1,0,1
3528,15,169,26,80,90,1,1919.815,90,1106.355,MORE,444,976,1420,1,2,10,0.937408461,10,0.174607574,2.485174336,-0.79384905,170,80,90,0,0.199450275,0,0.390166852,-1.241444975,1.250561506,1.250561506,0.390166852,0,1,0,1
3529,15,170,25,88,80,0,1859.665,40,1074.775,MORE,-740,1220,480,2,1,-8,-0.749926769,8,-0.174607574,0.182310086,-0.818656224,168,88,80,1,0.15956022,0.312133481,0,-0.558080769,0.053564923,0.053564923,0,0.312133481,1,0,0
3530,15,171,36,80,70,1,3829.803,20,1845.452,MORE,-632,2232,1600,3,1,-10,-0.937408461,10,0.174607574,-0.738835613,-0.006128293,150,80,70,1,-0.199450275,0,-0.390166852,0.125283438,0.162750422,0.162750422,-0.390166852,0,0,1,0
3531,15,172,28,80,93,1,2262.893,70,1016.848,MORE,442,744,1186,3,2,13,1.218630999,13,0.698430296,1.564028636,-0.652356192,173,80,93,0,0.259285357,0,0.507216907,0.125283438,1.248539553,1.248539553,0.507216907,0,1,1,1
3532,15,173,21,82,80,0,2561.397,80,879.95,MORE,-722,1498,776,2,1,-2,-0.187481692,2,-1.222253018,2.024601486,-0.529246624,162,82,80,1,0.039890055,0.07803337,0,-0.558080769,0.071762506,0.071762506,0,0.07803337,1,0,0
3533,15,174,19,50,41,0,2966.97,20,1612.913,MORE,-488,1716,1228,4,1,-9,-0.843667615,9,0,-0.738835613,-0.361979463,91,50,41,1,-1.376206896,-1.170500555,-1.521650721,0.808647645,0.308331088,0.308331088,-1.521650721,-1.170500555,0,1,1
3534,15,175,56,96,110,1,1997.931,60,1218.879,MORE,-82,912,830,1,2,14,1.312371845,14,0.87303787,1.103455786,-0.761632306,206,96,110,0,0.917471264,0.624266962,1.170500555,-1.241444975,0.718787687,0.718787687,1.170500555,0.624266962,1,0,1
3535,15,176,23,80,85,1,2338.831,70,1062.985,MORE,-542,1352,810,1,2,5,0.46870423,5,-0.698430296,1.564028636,-0.621037702,165,80,85,0,0.099725137,0,0.195083426,-1.241444975,0.253738338,0.253738338,0.195083426,0,1,0,1
3536,15,177,10,60,50,0,5661.196,60,1594.703,MORE,-1836,3620,1784,4,1,-10,-0.937408461,10,0.174607574,1.103455786,0.74917817,110,60,50,1,-0.997251374,-0.780333703,-1.170500555,0.808647645,-1.054465698,1.054465698,-1.170500555,-0.780333703,1,1,0
3537,15,178,19,41,50,1,2959.739,30,705.434,MORE,-100,1344,1244,2,2,9,0.843667615,9,0,-0.278262763,-0.364961685,91,41,50,0,-1.376206896,-1.521650721,-1.170500555,-0.558080769,0.700590103,0.700590103,-1.170500555,-1.521650721,0,0,1
3538,15,179,56,110,96,0,2422.732,70,1460.987,MORE,-914,1596,682,2,1,-14,-1.312371845,14,0.87303787,1.564028636,-0.586435098,206,110,96,1,0.917471264,1.170500555,0.624266962,-0.558080769,-0.122345048,0.122345048,0.624266962,1.170500555,1,0,0
3539,15,180,35,72,80,1,3826.993,50,1292.109,MORE,-770,2130,1360,3,2,8,0.749926769,8,-0.174607574,0.642882936,-0.007287198,152,72,80,0,-0.15956022,-0.312133481,0,0.125283438,0.023235618,0.023235618,0,-0.312133481,1,1,0
3540,15,181,11,49,50,1,1758.854,60,728.36,MORE,308,674,982,1,2,1,0.093740846,1,-1.396860592,1.103455786,-0.860232881,99,49,50,0,-1.216646676,-1.20951724,-1.170500555,-1.241444975,1.113068656,1.113068656,-1.170500555,-1.20951724,1,0,1
3541,15,182,17,43,50,1,3028.583,30,971.556,MORE,-340,1522,1182,3,2,7,0.656185922,7,-0.349215148,-0.278262763,-0.336568916,93,43,50,0,-1.336316841,-1.443617351,-1.170500555,0.125283438,0.457955661,0.457955661,-1.170500555,-1.443617351,0,1,1
3542,15,183,1,51,50,1,2697.374,50,991.139,MORE,-462,1414,952,1,2,-1,-0.093740846,1,-1.396860592,0.642882936,-0.47316674,101,51,50,1,-1.176756621,-1.131483869,-1.170500555,-1.241444975,0.334616486,0.334616486,-1.170500555,-1.131483869,1,0,1
3543,15,184,41,112,110,1,4102.764,30,1237.243,MORE,108,2052,2160,3,1,-2,-0.187481692,2,-1.222253018,-0.278262763,0.106446784,222,112,110,1,1.236591704,1.248533925,1.170500555,0.125283438,0.910873287,0.910873287,1.170500555,1.248533925,0,1,1
3544,15,185,20,40,50,1,1756.352,40,925.087,MORE,-126,960,834,1,1,10,0.937408461,10,0.174607574,0.182310086,-0.861264761,90,40,50,0,-1.396151924,-1.560667406,-1.170500555,-1.241444975,0.674304705,0.674304705,-1.170500555,-1.560667406,1,0,1
3545,15,186,1,50,51,1,2397.228,40,1185.806,MORE,-492,1364,872,1,2,1,0.093740846,1,-1.396860592,0.182310086,-0.596953504,101,50,51,0,-1.176756621,-1.170500555,-1.131483869,-1.241444975,0.30428718,0.30428718,-1.131483869,-1.170500555,1,0,1
3546,15,187,23,85,80,0,2173.729,60,1624.302,MORE,-998,1610,612,2,1,-5,-0.46870423,5,-0.698430296,1.103455786,-0.689129372,165,85,80,1,0.099725137,0.195083426,0,-0.558080769,-0.207267103,0.207267103,0,0.195083426,1,0,0
3547,15,188,11,50,49,0,3967.911,10,2268.212,MORE,-1936,3436,1500,4,1,-1,-0.093740846,1,-1.396860592,-1.199408463,0.050830462,99,50,49,1,-1.216646676,-1.170500555,-1.20951724,0.808647645,-1.155563382,1.155563382,-1.20951724,-1.170500555,0,1,0
3548,15,189,17,50,43,0,3741.914,30,1515.162,MORE,-626,1954,1328,4,1,-7,-0.656185922,7,-0.349215148,-0.278262763,-0.042375636,93,50,43,1,-1.336316841,-1.170500555,-1.443617351,0.808647645,0.168816283,0.168816283,-1.443617351,-1.170500555,0,1,0
3549,15,190,21,80,82,1,3889.217,10,1881.65,MORE,-1336,2746,1410,3,1,2,0.187481692,2,-1.222253018,-1.199408463,0.018375338,162,80,82,0,0.039890055,0,0.07803337,0.125283438,-0.548977276,0.548977276,0.07803337,0,0,1,0
3550,15,191,10,50,60,1,1520.499,60,1256.078,MORE,180,608,788,1,2,10,0.937408461,10,0.174607574,1.103455786,-0.958535688,110,50,60,0,-0.997251374,-1.170500555,-0.780333703,-1.241444975,0.98366362,0.98366362,-0.780333703,-1.170500555,1,0,1
3551,15,192,3,53,50,1,1762.876,60,1810.368,MORE,306,804,1110,1,2,-3,-0.281222538,3,-1.047645444,1.103455786,-0.858574121,103,53,50,1,-1.136866566,-1.053450499,-1.170500555,-1.241444975,1.111046702,1.111046702,-1.170500555,-1.053450499,1,0,1
3552,15,193,45,122,110,0,1924.224,70,717.16,MORE,-882,1486,604,2,1,-12,-1.124890153,12,0.523822722,1.564028636,-0.792030682,232,122,110,1,1.436041979,1.638700776,1.170500555,-0.558080769,-0.089993789,0.089993789,1.170500555,1.638700776,1,0,0
3553,15,194,38,67,80,1,3361.83,50,1561.008,MORE,-896,1968,1072,1,2,13,1.218630999,13,0.698430296,0.642882936,-0.199130577,147,67,80,0,-0.259285357,-0.507216907,0,-1.241444975,-0.104147465,0.104147465,0,-0.507216907,1,0,0
3554,15,195,38,80,67,0,3701.003,30,1426.845,MORE,-480,1894,1414,4,1,-13,-1.218630999,13,0.698430296,-0.278262763,-0.059248225,147,80,67,1,-0.259285357,0,-0.507216907,0.808647645,0.316418903,0.316418903,-0.507216907,0,0,1,1
3555,15,196,36,70,80,1,1737.534,40,1607.866,MORE,158,728,886,1,2,10,0.937408461,10,0.174607574,0.182310086,-0.869025715,150,70,80,0,-0.199450275,-0.390166852,0,-1.241444975,0.961422129,0.961422129,0,-0.390166852,0,0,1
3556,15,197,45,110,122,1,1580.147,80,1506.909,MORE,154,642,796,1,2,12,1.124890153,12,0.523822722,2.024601486,-0.93393555,232,110,122,0,1.436041979,1.170500555,1.638700776,-1.241444975,0.957378222,0.957378222,1.638700776,1.170500555,1,0,1
3557,15,198,42,110,115,1,3868.655,20,715.023,MORE,-432,1952,1520,3,1,5,0.46870423,5,-0.698430296,-0.738835613,0.00989512,225,110,115,0,1.296426786,1.170500555,1.36558398,0.125283438,0.364945791,0.364945791,1.36558398,1.170500555,0,1,1
3558,15,199,41,110,112,1,4961.902,20,1886.832,MORE,408,2118,2526,5,1,2,0.187481692,2,-1.222253018,-0.738835613,0.460774055,222,110,112,0,1.236591704,1.170500555,1.248533925,1.492011851,1.21416634,1.21416634,1.248533925,1.170500555,0,1,1
3559,15,200,53,110,103,1,1960.82,50,2266.383,MORE,92,840,932,1,2,-7,-0.656185922,7,-0.349215148,0.642882936,-0.776937693,213,110,103,1,1.057086457,1.170500555,0.897383758,-1.241444975,0.894697657,0.894697657,0.897383758,1.170500555,1,0,1
3560,15,201,3,50,53,1,4807.99,10,2145.589,LESS,-1462,3594,2132,7,1,3,0.281222538,3,-1.047645444,-1.199408463,0.397297385,103,50,53,1,-1.136866566,-1.170500555,-1.053450499,2.858740265,-0.676360358,0.676360358,-1.053450499,-1.170500555,0,1,0
3561,15,202,20,50,40,1,1529.044,50,1622.089,LESS,408,528,936,1,2,-10,-0.937408461,10,0.174607574,0.642882936,-0.955011544,90,50,40,0,-1.396151924,-1.170500555,-1.560667406,-1.241444975,1.21416634,1.21416634,-1.560667406,-1.170500555,1,0,1
3562,15,203,25,80,88,0,1627.666,20,1923.786,LESS,-2016,2482,466,2,1,8,0.749926769,8,-0.174607574,-0.738835613,-0.914337677,168,80,88,1,0.15956022,0,0.312133481,-0.558080769,-1.23644153,1.23644153,0.312133481,0,0,0,0
3563,15,204,42,115,110,1,2454.485,30,1236.747,LESS,-26,1164,1138,3,1,-5,-0.46870423,5,-0.698430296,-0.278262763,-0.573339467,225,115,110,0,1.296426786,1.36558398,1.170500555,0.125283438,0.77540239,0.77540239,1.170500555,1.36558398,1,1,1
3564,15,205,53,103,110,0,1884.516,20,1775.404,LESS,-1472,1924,452,2,1,7,0.656185922,7,-0.349215148,-0.738835613,-0.808407129,213,103,110,1,1.057086457,0.897383758,1.170500555,-0.558080769,-0.686470127,0.686470127,1.170500555,0.897383758,0,0,0
3565,15,206,26,90,80,1,3335.151,40,983.234,LESS,-936,1930,994,1,2,-10,-0.937408461,10,0.174607574,0.182310086,-0.210133579,170,90,80,0,0.199450275,0.390166852,0,-1.241444975,-0.144586538,0.144586538,0,0.390166852,1,0,0
3566,15,207,35,80,72,0,3638.464,10,1272.518,LESS,-1044,2384,1340,4,1,-8,-0.749926769,8,-0.174607574,-1.199408463,-0.085040675,152,80,72,0,-0.15956022,0,-0.312133481,0.808647645,-0.253772037,0.253772037,-0.312133481,0,0,1,0
3567,15,208,28,93,80,1,4355.9,30,1819.126,LESS,-542,2400,1858,3,1,-13,-1.218630999,13,0.698430296,-0.278262763,0.210845598,173,93,80,0,0.259285357,0.507216907,0,0.125283438,0.253738338,0.253738338,0,0.507216907,1,1,1
3568,15,209,26,80,90,0,3821.367,60,788.314,LESS,-958,2232,1274,4,1,10,0.937408461,10,0.174607574,1.103455786,-0.009607484,170,80,90,1,0.199450275,0,0.390166852,0.808647645,-0.166828029,0.166828029,0.390166852,0,1,1,0
3569,15,210,25,88,80,1,1757.382,30,860.089,LESS,246,894,1140,1,1,-8,-0.749926769,8,-0.174607574,-0.278262763,-0.860839966,168,88,80,0,0.15956022,0.312133481,0,-1.241444975,1.050388091,1.050388091,0,0.312133481,1,0,1
3570,15,211,36,80,70,1,2452.173,20,1613.097,LESS,-192,1540,1348,1,1,-10,-0.937408461,10,0.174607574,-0.738835613,-0.574292987,150,80,70,0,-0.199450275,0,-0.390166852,-1.241444975,0.607580234,0.607580234,-0.390166852,0,0,0,1
3571,15,212,28,80,93,0,2488.712,70,706.892,LESS,-786,1462,676,2,1,13,1.218630999,13,0.698430296,1.564028636,-0.559223505,173,80,93,1,0.259285357,0,0.507216907,-0.558080769,0.007059988,0.007059988,0.507216907,0,1,0,1
3572,15,213,21,82,80,0,3737.865,50,866.837,LESS,-1342,2490,1148,4,1,-2,-0.187481692,2,-1.222253018,0.642882936,-0.044045532,162,82,80,0,0.039890055,0.07803337,0,0.808647645,-0.555043137,0.555043137,0,0.07803337,1,1,0
3573,15,214,19,50,41,0,1937.901,20,2005.139,LESS,-1478,2086,608,2,1,-9,-0.843667615,9,0,-0.738835613,-0.786389989,91,50,41,0,-1.376206896,-1.170500555,-1.521650721,-0.558080769,-0.692535988,0.692535988,-1.521650721,-1.170500555,0,1,0
3574,15,215,56,96,110,1,1545.585,30,1456.406,LESS,268,610,878,1,2,14,1.312371845,14,0.87303787,-0.278262763,-0.948189674,206,96,110,1,0.917471264,0.624266962,1.170500555,-1.241444975,1.072629582,1.072629582,1.170500555,0.624266962,1,0,1
3575,15,216,23,80,85,0,1850.509,10,1535.388,LESS,-1264,1764,500,2,1,5,0.46870423,5,-0.698430296,-1.199408463,-0.822432358,165,80,85,1,0.099725137,0,0.195083426,-0.558080769,-0.476186943,0.476186943,0.195083426,0,0,0,0
3576,15,217,10,60,50,1,2344.205,10,1818.262,LESS,-1554,2602,1048,3,1,-10,-0.937408461,10,0.174607574,-1.199408463,-0.618821347,110,60,50,0,-0.997251374,-0.780333703,-1.170500555,0.125283438,-0.769370228,0.769370228,-1.170500555,-0.780333703,0,1,0
3577,15,218,19,41,50,0,1751.028,60,1163.268,LESS,-544,1026,482,2,1,9,0.843667615,9,0,1.103455786,-0.863460495,91,41,50,1,-1.376206896,-1.521650721,-1.170500555,-0.558080769,0.251716385,0.251716385,-1.170500555,-1.521650721,1,0,1
3578,15,219,56,110,96,0,5484.384,10,1445.111,LESS,-1446,3548,2102,6,1,-14,-1.312371845,14,0.87303787,-1.199408463,0.676257041,206,110,96,0,0.917471264,1.170500555,0.624266962,2.175376058,-0.660184729,0.660184729,0.624266962,1.170500555,0,1,0
3579,15,220,35,72,80,0,5401.733,10,1641.212,LESS,-2594,4204,1610,4,1,8,0.749926769,8,-0.174607574,-1.199408463,0.642169964,152,72,80,1,-0.15956022,-0.312133481,0,0.808647645,-1.820786146,1.820786146,0,-0.312133481,0,1,0
3580,15,221,11,49,50,0,2323.862,20,1433.883,LESS,-1438,2094,656,2,1,1,0.093740846,1,-1.396860592,-0.738835613,-0.627211245,99,49,50,1,-1.216646676,-1.20951724,-1.170500555,-0.558080769,-0.652096914,0.652096914,-1.170500555,-1.20951724,0,0,0
3581,15,222,17,43,50,0,1736.275,50,956.566,LESS,-676,1122,446,2,1,7,0.656185922,7,-0.349215148,0.642882936,-0.869544954,93,43,50,1,-1.336316841,-1.443617351,-1.170500555,-0.558080769,0.118267441,0.118267441,-1.170500555,-1.443617351,1,0,1
3582,15,223,1,51,50,0,2496.636,20,1700.355,LESS,-1712,2246,534,2,1,-1,-0.093740846,1,-1.396860592,-0.738835613,-0.555955475,101,51,50,0,-1.176756621,-1.131483869,-1.170500555,-0.558080769,-0.929104569,0.929104569,-1.170500555,-1.131483869,0,0,0
3583,15,224,41,112,110,0,2643.958,10,1477.149,LESS,-1312,2414,1102,2,1,-2,-0.187481692,2,-1.222253018,-1.199408463,-0.495196665,222,112,110,0,1.236591704,1.248533925,1.170500555,-0.558080769,-0.524713832,0.524713832,1.170500555,1.248533925,0,0,0
3584,15,225,20,40,50,0,1751.451,60,1594.741,LESS,-1010,1532,522,2,1,10,0.937408461,10,0.174607574,1.103455786,-0.86328604,90,40,50,1,-1.396151924,-1.560667406,-1.170500555,-0.558080769,-0.219398825,0.219398825,-1.170500555,-1.560667406,1,0,0
3585,15,226,1,50,51,1,5616.222,30,1148.764,LESS,-1026,3312,2286,5,1,1,0.093740846,1,-1.396860592,-0.278262763,0.730629911,101,50,51,1,-1.176756621,-1.170500555,-1.131483869,1.492011851,-0.235574454,0.235574454,-1.131483869,-1.170500555,1,1,0
3586,15,227,23,85,80,1,6900.506,40,1275.932,LESS,-984,3722,2738,6,1,-5,-0.46870423,5,-0.698430296,0.182310086,1.260296676,165,85,80,0,0.099725137,0.195083426,0,2.175376058,-0.193113427,0.193113427,0,0.195083426,1,1,0
3587,15,228,11,50,49,0,6086.955,30,543.304,LESS,-1126,3378,2252,6,1,-1,-0.093740846,1,-1.396860592,-0.278262763,0.924770479,99,50,49,0,-1.216646676,-1.170500555,-1.20951724,2.175376058,-0.336672139,0.336672139,-1.20951724,-1.170500555,1,1,0
3588,15,229,17,50,43,1,5994.553,20,912.474,LESS,-440,2840,2400,5,2,-7,-0.656185922,7,-0.349215148,-0.738835613,0.886661876,93,50,43,0,-1.336316841,-1.170500555,-1.443617351,1.492011851,0.356857976,0.356857976,-1.443617351,-1.170500555,0,1,1
3589,15,230,21,80,82,1,3866.99,10,668.659,LESS,124,1796,1920,3,1,2,0.187481692,2,-1.222253018,-1.199408463,0.009208438,162,80,82,1,0.039890055,0,0.07803337,0.125283438,0.927048916,0.927048916,0.07803337,0,0,1,1
3590,15,231,10,50,60,0,2893.133,50,725.713,LESS,-452,1362,910,2,1,10,0.937408461,10,0.174607574,0.642882936,-0.392431454,110,50,60,1,-0.997251374,-1.170500555,-0.780333703,-0.558080769,0.344726254,0.344726254,-0.780333703,-1.170500555,1,0,1
3591,15,232,3,53,50,0,1795.426,10,1209.687,LESS,-1562,2112,550,2,1,-3,-0.281222538,3,-1.047645444,-1.199408463,-0.84514979,103,53,50,0,-1.136866566,-1.053450499,-1.170500555,-0.558080769,-0.777458043,0.777458043,-1.170500555,-1.053450499,0,0,0
3592,15,233,45,122,110,0,5605.866,10,1313.82,LESS,-810,3154,2344,6,1,-12,-1.124890153,12,0.523822722,-1.199408463,0.72635887,232,122,110,0,1.436041979,1.638700776,1.170500555,2.175376058,-0.017203456,0.017203456,1.170500555,1.638700776,0,1,1
3593,15,234,38,67,80,0,1843.322,70,1562.913,LESS,-684,1158,474,2,1,13,1.218630999,13,0.698430296,1.564028636,-0.825396434,147,67,80,1,-0.259285357,-0.507216907,0,-0.558080769,0.110179626,0.110179626,0,-0.507216907,1,0,1
3594,15,235,38,80,67,1,2435.599,30,1046.725,LESS,6,1098,1104,1,2,-13,-1.218630999,13,0.698430296,-0.278262763,-0.581128466,147,80,67,0,-0.259285357,0,-0.507216907,-1.241444975,0.807753649,0.807753649,-0.507216907,0,1,0,1
3595,15,236,36,70,80,0,2240.474,60,1292.919,LESS,-824,1310,486,2,1,10,0.937408461,10,0.174607574,1.103455786,-0.661602277,150,70,80,1,-0.199450275,-0.390166852,0,-0.558080769,-0.031357132,0.031357132,0,-0.390166852,1,0,1
3596,15,237,45,110,122,0,2563.388,10,1958.226,LESS,-2340,2978,638,2,1,12,1.124890153,12,0.523822722,-1.199408463,-0.528425492,232,110,122,1,1.436041979,1.170500555,1.638700776,-0.558080769,-1.563998027,1.563998027,1.638700776,1.170500555,0,0,0
3597,15,238,42,110,115,0,1991.946,10,845.607,LESS,-1318,1788,470,2,1,5,0.46870423,5,-0.698430296,-1.199408463,-0.764100651,225,110,115,1,1.296426786,1.170500555,1.36558398,-0.558080769,-0.530779693,0.530779693,1.36558398,1.170500555,0,0,0
3598,15,239,41,110,112,1,4074.443,20,1174.587,LESS,-1268,2874,1606,3,1,2,0.187481692,2,-1.222253018,-0.738835613,0.094766585,222,110,112,1,1.236591704,1.170500555,1.248533925,0.125283438,-0.480230851,0.480230851,1.248533925,1.170500555,0,1,0
3599,15,240,53,110,103,1,1927.761,30,1053.328,LESS,118,864,982,1,2,-7,-0.656185922,7,-0.349215148,-0.278262763,-0.790571946,213,110,103,0,1.057086457,1.170500555,0.897383758,-1.241444975,0.920983055,0.920983055,0.897383758,1.170500555,1,0,1
3600,16,1,49,110,131,1,5036.814,14,1646.553,LESS,-1422,3096,1674,3,1,21,1.968557767,21,2.095290887,-2.046783534,1.593341424,241,110,131,1,1.615547226,1.170500555,1.989850943,0.260263481,-1.574812164,1.574812164,1.989850943,1.170500555,0,1,0
3601,16,2,13,47,50,0,6666.279,34,1100.221,LESS,-492,3444,2952,8,1,3,0.281222538,3,-1.047645444,-0.929086041,2.735854752,97,47,50,1,-1.256536731,-1.28755061,-1.170500555,3.730443234,-0.297083389,0.297083389,-1.170500555,-1.28755061,0,1,0
3602,16,3,16,50,44,0,2896.882,44,724.44,LESS,-824,1694,870,4,1,-6,-0.562445076,6,-0.523822722,-0.370237295,0.09290979,94,50,44,0,-1.316371814,-1.170500555,-1.404600665,0.954299432,-0.753218823,0.753218823,-1.404600665,-1.170500555,0,1,0
3603,16,4,7,57,50,1,4941.589,24,1393.966,LESS,48,2698,2746,5,2,-7,-0.656185922,7,-0.349215148,-1.487934788,1.5265736,107,57,50,0,-1.057086457,-0.897383758,-1.170500555,1.648335383,0.444823641,0.444823641,-1.170500555,-0.897383758,0,1,1
3604,16,5,18,42,50,1,3747.957,34,1569.109,LESS,960,1206,2166,3,2,8,0.749926769,8,-0.174607574,-0.929086041,0.689648309,92,42,50,1,-1.356261869,-1.482634036,-1.170500555,0.260263481,1.697822182,1.697822182,-1.170500555,-1.482634036,0,1,1
3605,16,6,51,108,110,1,7078.549,24,1090.017,LESS,390,3116,3506,8,1,2,0.187481692,2,-1.222253018,-1.487934788,3.02492139,218,108,110,1,1.156811594,1.092467184,1.170500555,3.730443234,0.914698094,0.914698094,1.170500555,1.092467184,0,1,1
3606,16,7,31,78,80,1,8817.116,34,1262.065,LESS,1546,3212,4758,7,1,2,0.187481692,2,-1.222253018,-0.929086041,4.243932519,158,78,80,1,-0.039890055,-0.07803337,0,3.036407284,2.5029287,2.5029287,0,-0.07803337,0,1,1
3607,16,8,58,110,92,1,1844.604,54,1313.365,LESS,846,452,1298,1,2,-18,-1.687335229,18,1.571468165,0.188611452,-0.644903934,202,110,92,0,0.837691154,1.170500555,0.468200222,-1.12780842,1.541197364,1.541197364,0.468200222,1.170500555,1,0,1
3608,16,9,12,50,48,1,6962.203,34,1623.368,LESS,1458,1906,3364,6,1,-2,-0.187481692,2,-1.222253018,-0.929086041,2.943344397,98,50,48,0,-1.236591704,-1.170500555,-1.248533925,2.342371333,2.382025332,2.382025332,-1.248533925,-1.170500555,0,1,1
3609,16,10,54,110,101,1,2189.002,44,1225.72,LESS,386,792,1178,3,2,-9,-0.843667615,9,0,-0.370237295,-0.403426329,211,110,101,0,1.017196402,1.170500555,0.819350388,0.260263481,0.909202486,0.909202486,0.819350388,1.170500555,0,1,1
3610,16,11,14,46,50,0,1864.762,44,1066.813,LESS,-568,1106,538,2,1,4,0.374963384,4,-0.87303787,-0.370237295,-0.63076998,96,46,50,1,-1.276481759,-1.326567295,-1.170500555,-0.433772469,-0.401499934,0.401499934,-1.170500555,-1.326567295,0,0,0
3611,16,12,22,80,83,1,5642.773,34,1133.101,LESS,-342,2582,2240,5,2,3,0.281222538,3,-1.047645444,-0.929086041,2.018214762,163,80,83,1,0.059835082,0,0.117050055,1.648335383,-0.090998103,0.090998103,0.117050055,0,0,1,1
3612,16,13,6,50,56,0,7938.654,54,1651.733,LESS,-692,3524,2832,7,1,6,0.562445076,6,-0.523822722,0.188611452,3.627991371,106,50,56,1,-1.077031484,-1.170500555,-0.936400444,3.036407284,-0.571863771,0.571863771,-0.936400444,-1.170500555,1,1,0
3613,16,14,13,50,47,0,1773.503,54,1119.358,LESS,-536,1022,486,2,1,-3,-0.281222538,3,-1.047645444,0.188611452,-0.694757009,97,50,47,0,-1.256536731,-1.170500555,-1.28755061,-0.433772469,-0.357535073,0.357535073,-1.28755061,-1.170500555,1,0,0
3614,16,15,46,110,124,0,8362.72,34,941.766,LESS,-848,3918,3070,5,1,14,1.312371845,14,0.87303787,-0.929086041,3.925328876,234,110,124,1,1.475932034,1.170500555,1.716734147,1.648335383,-0.786192469,0.786192469,1.716734147,1.170500555,0,1,0
3615,16,16,27,91,80,1,4171.918,44,1154.943,LESS,614,1700,2314,6,1,-11,-1.031149307,11,0.349215148,-0.370237295,0.986912192,171,91,80,0,0.219395302,0.429183537,0,2.342371333,1.222452122,1.222452122,0,0.429183537,0,1,1
3616,16,17,40,64,80,0,6348.423,34,1126.422,LESS,-88,2928,2840,6,1,16,1.499853537,16,1.222253018,-0.929086041,2.512987297,144,64,80,1,-0.31912044,-0.624266962,0,2.342371333,0.257972982,0.257972982,0,-0.624266962,0,1,1
3617,16,18,22,83,80,0,4260.96,44,1258.434,LESS,-234,2000,1766,4,1,-3,-0.281222538,3,-1.047645444,-0.370237295,1.049344752,163,83,80,0,0.059835082,0.117050055,0,0.954299432,0.057383303,0.057383303,0,0.117050055,0,1,1
3618,16,19,54,101,110,0,3135.347,54,1462.357,LESS,-746,1822,1076,4,1,9,0.843667615,9,0,0.188611452,0.260111565,211,101,110,1,1.017196402,0.819350388,1.170500555,0.954299432,-0.646054474,0.646054474,1.170500555,0.819350388,1,1,0
3619,16,20,6,56,50,1,6903.403,44,1241.103,LESS,-238,3146,2908,7,2,-6,-0.562445076,6,-0.523822722,-0.370237295,2.902116274,106,56,50,0,-1.077031484,-0.936400444,-1.170500555,3.036407284,0.051887695,0.051887695,-1.170500555,-0.936400444,0,1,1
3620,16,21,18,50,42,0,4110.928,54,1234.954,LESS,-470,1760,1290,4,1,-8,-0.749926769,8,-0.174607574,0.188611452,0.944148532,92,50,42,0,-1.356261869,-1.170500555,-1.482634036,0.954299432,-0.266857547,0.266857547,-1.482634036,-1.170500555,1,1,0
3621,16,22,43,110,117,0,4106.266,50,1983.088,LESS,176,1928,2104,4,2,7,0.656185922,7,-0.349215148,-0.034928047,0.940879731,227,110,117,1,1.336316841,1.170500555,1.443617351,0.954299432,0.620683086,0.620683086,1.443617351,1.170500555,0,1,1
3622,16,23,32,77,80,1,8227.724,14,1822.837,LESS,-1296,4728,3432,7,1,3,0.281222538,3,-1.047645444,-2.046783534,3.830675275,157,77,80,1,-0.059835082,-0.117050055,0,3.036407284,-1.401700524,1.401700524,0,-0.117050055,0,1,0
3623,16,24,27,80,91,0,4491.226,54,1561.811,LESS,-730,2382,1652,4,1,11,1.031149307,11,0.349215148,0.188611452,1.210797729,171,80,91,1,0.219395302,0,0.429183537,0.954299432,-0.624072044,0.624072044,0.429183537,0,1,1,0
3624,16,25,16,44,50,0,2868.977,54,2084.783,LESS,-188,1490,1302,4,1,6,0.562445076,6,-0.523822722,0.188611452,0.07334396,94,44,50,1,-1.316371814,-1.404600665,-1.170500555,0.954299432,0.120582791,0.120582791,-1.170500555,-1.404600665,1,1,1
3625,16,26,7,50,57,0,3290.348,44,430.803,LESS,-276,1556,1280,4,1,7,0.656185922,7,-0.349215148,-0.370237295,0.368791843,107,50,57,1,-1.057086457,-1.170500555,-0.897383758,0.954299432,-0.000320577,0.000320577,-0.897383758,-1.170500555,0,1,1
3626,16,27,14,50,46,0,3626.132,44,1001.018,LESS,-810,1868,1058,2,1,-4,-0.374963384,4,-0.87303787,-0.370237295,0.604229668,96,50,46,0,-1.276481759,-1.170500555,-1.326567295,-0.433772469,-0.733984196,0.733984196,-1.326567295,-1.170500555,0,0,0
3627,16,28,51,110,108,1,6855.869,54,791.051,LESS,118,2062,2180,4,2,-2,-0.187481692,2,-1.222253018,0.188611452,2.868787403,218,110,108,0,1.156811594,1.170500555,1.092467184,0.954299432,0.540996775,0.540996775,1.092467184,1.170500555,1,1,1
3628,16,29,50,133,110,1,1653.647,64,965.699,LESS,766,500,1266,1,2,-23,-2.15603946,23,2.444506035,0.747460199,-0.778795069,243,133,110,0,1.655437281,2.067884313,1.170500555,-1.12780842,1.431285212,1.431285212,1.170500555,2.067884313,1,0,1
3629,16,30,49,131,110,1,2228.77,44,856.407,LESS,418,828,1246,1,2,-21,-1.968557767,21,2.095290887,-0.370237295,-0.375542656,241,131,110,0,1.615547226,1.989850943,1.170500555,-1.12780842,0.953167347,0.953167347,1.170500555,1.989850943,0,0,1
3630,16,31,47,126,110,1,5596.932,64,916.762,LESS,536,2256,2792,3,2,-16,-1.499853537,16,1.222253018,0.747460199,1.986072952,236,126,110,0,1.515822089,1.794767517,1.170500555,0.260263481,1.115287773,1.115287773,1.170500555,1.794767517,1,1,1
3631,16,32,50,110,133,0,3126.533,54,1201.835,LESS,-406,1874,1468,2,2,23,2.15603946,23,2.444506035,0.188611452,0.253931554,243,110,133,1,1.655437281,1.170500555,2.067884313,-0.433772469,-0.178927825,0.178927825,2.067884313,1.170500555,1,0,1
3632,16,33,47,110,126,0,2338.83,64,1198.427,LESS,-700,1362,662,2,1,16,1.499853537,16,1.222253018,0.747460199,-0.298373145,236,110,126,1,1.515822089,1.170500555,1.794767517,-0.433772469,-0.582854986,0.582854986,1.794767517,1.170500555,1,0,0
3633,16,34,12,48,50,0,5193.959,54,1199.714,LESS,442,1522,1964,3,1,2,0.187481692,2,-1.222253018,0.188611452,1.703524985,98,48,50,1,-1.236591704,-1.248533925,-1.170500555,0.260263481,0.986140993,0.986140993,-1.170500555,-1.248533925,1,1,1
3634,16,35,32,80,77,1,1584.104,54,1217.72,LESS,344,504,848,1,2,-3,-0.281222538,3,-1.047645444,0.188611452,-0.827555738,157,80,77,0,-0.059835082,0,-0.117050055,-1.12780842,0.851498606,0.851498606,-0.117050055,0,1,0,1
3635,16,36,43,117,110,0,1990.986,44,1492.007,LESS,-412,968,556,2,1,-7,-0.656185922,7,-0.349215148,-0.370237295,-0.542266942,227,117,110,0,1.336316841,1.443617351,1.170500555,-0.433772469,-0.187171237,0.187171237,1.170500555,1.443617351,0,0,0
3636,16,37,40,80,64,0,5000.792,34,906.248,LESS,-680,2502,1822,2,1,-16,-1.499853537,16,1.222253018,-0.929086041,1.56808429,144,80,64,0,-0.31912044,0,-0.624266962,-0.433772469,-0.555376948,0.555376948,-0.624266962,0,0,0,0
3637,16,38,31,80,78,0,6590.522,54,1512.063,LESS,150,2460,2610,2,2,-2,-0.187481692,2,-1.222253018,0.188611452,2.682737083,158,80,78,0,-0.039890055,0,-0.07803337,-0.433772469,0.584961636,0.584961636,-0.07803337,0,1,0,1
3638,16,39,46,124,110,1,4521.86,44,2062.364,LESS,1134,1648,2782,3,1,-14,-1.312371845,14,0.87303787,-0.370237295,1.23227702,234,124,110,0,1.475932034,1.716734147,1.170500555,0.260263481,1.936881114,1.936881114,1.170500555,1.716734147,0,1,1
3639,16,40,58,92,110,0,4227.98,54,1661.654,LESS,-1720,2882,1162,4,1,18,1.687335229,18,1.571468165,0.188611452,1.026220543,202,92,110,1,0.837691154,0.468200222,1.170500555,0.954299432,-1.984234933,1.984234933,1.170500555,0.468200222,1,1,0
3640,16,41,49,110,131,1,2008.781,54,1570.344,MORE,-246,1294,1048,1,1,21,1.968557767,21,2.095290887,0.188611452,-0.529789826,241,110,131,0,1.615547226,1.170500555,1.989850943,-1.12780842,0.04089648,0.04089648,1.989850943,1.170500555,0,0,0
3641,16,42,13,47,50,0,2586.882,54,1154.285,MORE,-522,1408,886,2,1,3,0.281222538,3,-1.047645444,0.188611452,-0.124449363,97,47,50,0,-1.256536731,-1.28755061,-1.170500555,-0.433772469,-0.338300447,0.338300447,-1.170500555,-1.28755061,1,0,0
3642,16,43,16,50,44,1,3858.222,64,993.097,MORE,-1136,2154,1018,3,2,-6,-0.562445076,6,-0.523822722,0.747460199,0.766961557,94,50,44,1,-1.316371814,-1.170500555,-1.404600665,0.260263481,-1.181876218,1.181876218,-1.404600665,-1.170500555,1,1,0
3643,16,44,7,57,50,0,2024.535,64,2929.459,MORE,-588,1162,574,2,1,-7,-0.656185922,7,-0.349215148,0.747460199,-0.518743774,107,57,50,1,-1.057086457,-0.897383758,-1.170500555,-0.433772469,-0.428977973,0.428977973,-1.170500555,-0.897383758,1,0,0
3644,16,45,18,42,50,1,2895.813,54,1411.194,MORE,172,1062,1234,3,2,8,0.749926769,8,-0.174607574,0.188611452,0.092160252,92,42,50,0,-1.356261869,-1.482634036,-1.170500555,0.260263481,0.615187478,0.615187478,-1.170500555,-1.482634036,1,1,1
3645,16,46,51,108,110,0,2284.07,64,1695.065,MORE,-338,1056,718,2,1,2,0.187481692,2,-1.222253018,0.747460199,-0.336768588,218,108,110,0,1.156811594,1.092467184,1.170500555,-0.433772469,-0.085502495,0.085502495,1.170500555,1.092467184,1,0,0
3646,16,47,31,78,80,1,1841.979,64,1556.903,MORE,832,428,1260,1,2,2,0.187481692,2,-1.222253018,0.747460199,-0.646744475,158,78,80,0,-0.039890055,-0.07803337,0,-1.12780842,1.521962738,1.521962738,0,-0.07803337,1,0,1
3647,16,48,58,110,92,0,2076.77,64,2730.553,MORE,-834,1384,550,2,1,-18,-1.687335229,18,1.571468165,0.747460199,-0.482118757,202,110,92,1,0.837691154,1.170500555,0.468200222,-0.433772469,-0.766957842,0.766957842,0.468200222,1.170500555,1,0,0
3648,16,49,12,50,48,0,3061.948,64,1116.562,MORE,-392,1526,1134,4,1,-2,-0.187481692,2,-1.222253018,0.747460199,0.208647228,98,50,48,1,-1.236591704,-1.170500555,-1.248533925,0.954299432,-0.159693199,0.159693199,-1.248533925,-1.170500555,1,1,0
3649,16,50,54,110,101,0,2374.73,44,1133.268,MORE,-730,1292,562,2,1,-9,-0.843667615,9,0,-0.370237295,-0.273201553,211,110,101,1,1.017196402,1.170500555,0.819350388,-0.433772469,-0.624072044,0.624072044,0.819350388,1.170500555,0,0,0
3650,16,51,14,46,50,1,3362.285,24,826.643,MORE,444,1122,1566,2,1,4,0.374963384,4,-0.87303787,-1.487934788,0.419231086,96,46,50,0,-1.276481759,-1.326567295,-1.170500555,-0.433772469,0.988888797,0.988888797,-1.170500555,-1.326567295,0,0,1
3651,16,52,22,80,83,0,2935.194,54,1297.523,MORE,-278,1368,1090,4,1,3,0.281222538,3,-1.047645444,0.188611452,0.119772577,163,80,83,0,0.059835082,0,0.117050055,0.954299432,-0.003068381,0.003068381,0.117050055,0,1,1,0
3652,16,53,6,50,56,1,1436.742,44,705.984,MORE,272,496,768,1,2,6,0.562445076,6,-0.523822722,-0.370237295,-0.930879866,106,50,56,0,-1.077031484,-1.170500555,-0.936400444,-1.12780842,0.752577669,0.752577669,-0.936400444,-1.170500555,0,0,1
3653,16,54,13,50,47,0,3460.248,30,1365.81,MORE,-2092,2642,550,2,1,-3,-0.281222538,3,-1.047645444,-1.15262554,0.487918682,97,50,47,1,-1.256536731,-1.170500555,-1.28755061,-0.433772469,-2.495326443,2.495326443,-1.28755061,-1.170500555,0,0,0
3654,16,55,46,110,124,1,2347.546,24,1986.477,MORE,-134,1220,1086,3,1,14,1.312371845,14,0.87303787,-1.487934788,-0.292261847,234,110,124,0,1.475932034,1.170500555,1.716734147,0.260263481,0.194773494,0.194773494,1.716734147,1.170500555,0,1,1
3655,16,56,27,91,80,1,4932.093,24,1708.037,MORE,876,1698,2574,4,1,-11,-1.031149307,11,0.349215148,-1.487934788,1.519915398,171,91,80,1,0.219395302,0.429183537,0,0.954299432,1.582414422,1.582414422,0,0.429183537,0,1,1
3656,16,57,40,64,80,1,3935.056,14,1237.635,MORE,-146,1874,1728,5,1,16,1.499853537,16,1.222253018,-2.046783534,0.820834374,144,64,80,0,-0.31912044,-0.624266962,0,1.648335383,0.178286671,0.178286671,0,-0.624266962,0,1,1
3657,16,58,22,83,80,1,2121.737,64,1128.934,MORE,-190,998,808,1,2,-3,-0.281222538,3,-1.047645444,0.747460199,-0.45058976,163,83,80,1,0.059835082,0.117050055,0,-1.12780842,0.117834987,0.117834987,0,0.117050055,1,0,1
3658,16,59,54,101,110,1,1531.599,84,1230.267,MORE,408,466,874,1,2,9,0.843667615,9,0,1.865157692,-0.864370068,211,101,110,0,1.017196402,0.819350388,1.170500555,-1.12780842,0.939428328,0.939428328,1.170500555,0.819350388,1,0,1
3659,16,60,6,56,50,0,2478.458,44,1563.26,MORE,-986,1598,612,2,1,-6,-0.562445076,6,-0.523822722,-0.370237295,-0.200471778,106,56,50,1,-1.077031484,-0.936400444,-1.170500555,-0.433772469,-0.975790932,0.975790932,-1.170500555,-0.936400444,0,0,0
3660,16,61,18,50,42,0,3828.946,54,2090.023,MORE,-1322,2356,1034,4,1,-8,-0.749926769,8,-0.174607574,0.188611452,0.746434439,92,50,42,1,-1.356261869,-1.170500555,-1.482634036,0.954299432,-1.437421973,1.437421973,-1.482634036,-1.170500555,1,1,0
3661,16,62,43,110,117,1,4461.252,24,790.713,MORE,432,1746,2178,5,2,7,0.656185922,7,-0.349215148,-1.487934788,1.189781202,227,110,117,0,1.336316841,1.170500555,1.443617351,1.648335383,0.972401974,0.972401974,1.443617351,1.170500555,0,1,1
3662,16,63,32,77,80,0,2795.627,34,1097.404,MORE,-748,1504,756,2,1,3,0.281222538,3,-1.047645444,-0.929086041,0.02191398,157,77,80,0,-0.059835082,-0.117050055,0,-0.433772469,-0.648802278,0.648802278,0,-0.117050055,0,0,0
3663,16,64,27,80,91,0,3155.075,44,1333.104,MORE,-158,1418,1260,4,1,11,1.031149307,11,0.349215148,-0.370237295,0.273944021,171,80,91,0,0.219395302,0,0.429183537,0.954299432,0.161799848,0.161799848,0.429183537,0,0,1,1
3664,16,65,16,44,50,1,1472.473,74,2048.362,MORE,54,556,610,1,1,6,0.562445076,6,-0.523822722,1.306308945,-0.905826769,94,44,50,0,-1.316371814,-1.404600665,-1.170500555,-1.12780842,0.453067053,0.453067053,-1.170500555,-1.404600665,1,0,1
3665,16,66,7,50,57,1,1866.506,74,1398.101,MORE,788,212,1000,1,2,7,0.656185922,7,-0.349215148,1.306308945,-0.629547159,107,50,57,0,-1.057086457,-1.170500555,-0.897383758,-1.12780842,1.461511054,1.461511054,-0.897383758,-1.170500555,1,0,1
3666,16,67,14,50,46,0,1862.875,74,955.688,MORE,-580,1070,490,1,2,-4,-0.374963384,4,-0.87303787,1.306308945,-0.632093066,96,50,46,1,-1.276481759,-1.170500555,-1.326567295,-1.12780842,-0.417986757,0.417986757,-1.326567295,-1.170500555,1,0,0
3667,16,68,51,110,108,0,1877.529,24,802.744,MORE,-462,1016,554,2,1,-2,-0.187481692,2,-1.222253018,-1.487934788,-0.621818289,218,110,108,1,1.156811594,1.170500555,1.092467184,-0.433772469,-0.255866332,0.255866332,1.092467184,1.170500555,0,1,0
3668,16,69,50,133,110,0,1935.355,54,1006.368,MORE,-454,1058,604,2,1,-23,-2.15603946,23,2.444506035,0.188611452,-0.581273094,243,133,110,1,1.655437281,2.067884313,1.170500555,-0.433772469,-0.244875117,0.244875117,1.170500555,2.067884313,1,1,0
3669,16,70,49,131,110,1,4587.041,34,1661.309,MORE,80,1982,2062,5,2,-21,-1.968557767,21,2.095290887,-0.929086041,1.277979236,241,131,110,1,1.615547226,1.989850943,1.170500555,1.648335383,0.488788502,0.488788502,1.170500555,1.989850943,0,1,1
3670,16,71,47,126,110,0,2047.813,4,1954.489,MORE,-1562,2114,552,2,1,-16,-1.499853537,16,1.222253018,-2.605632281,-0.502422205,236,126,110,1,1.515822089,1.794767517,1.170500555,-0.433772469,-1.767158432,1.767158432,1.170500555,1.794767517,0,0,0
3671,16,72,50,110,133,1,1788.521,64,1914.64,MORE,290,776,1066,2,1,23,2.15603946,23,2.444506035,0.747460199,-0.68422701,243,110,133,0,1.655437281,1.170500555,2.067884313,-0.433772469,0.777307903,0.777307903,2.067884313,1.170500555,1,1,1
3672,16,73,47,110,126,1,2422.426,94,1909.529,MORE,770,952,1722,3,2,16,1.499853537,16,1.222253018,2.424006438,-0.239759094,236,110,126,0,1.515822089,1.170500555,1.794767517,0.260263481,1.436780819,1.436780819,1.794767517,1.170500555,1,1,1
3673,16,74,12,48,50,1,2130.592,34,879.732,MORE,202,822,1024,3,2,2,0.187481692,2,-1.222253018,-0.929086041,-0.444381001,98,48,50,0,-1.236591704,-1.248533925,-1.170500555,0.260263481,0.656404535,0.656404535,-1.170500555,-1.248533925,0,1,1
3674,16,75,32,80,77,1,2285.173,54,1788.464,MORE,554,970,1524,5,2,-3,-0.281222538,3,-1.047645444,0.188611452,-0.33599521,157,80,77,1,-0.059835082,0,-0.117050055,1.648335383,1.140018007,1.140018007,-0.117050055,0,1,1,1
3675,16,76,43,117,110,0,4221.68,54,1298.565,MORE,-2938,3496,558,2,1,-7,-0.656185922,7,-0.349215148,0.188611452,1.021803244,227,117,110,1,1.336316841,1.443617351,1.170500555,-0.433772469,-3.657647458,3.657647458,1.170500555,1.443617351,1,1,0
3676,16,77,40,80,64,0,1724.138,4,1235.35,MORE,-1022,1540,518,2,1,-16,-1.499853537,16,1.222253018,-2.605632281,-0.729369701,144,80,64,1,-0.31912044,0,-0.624266962,-0.433772469,-1.025251401,1.025251401,-0.624266962,0,0,1,0
3677,16,78,31,80,78,0,2763.993,44,1174.27,MORE,-424,1450,1026,4,1,-2,-0.187481692,2,-1.222253018,-0.370237295,-0.000266469,158,80,78,1,-0.039890055,0,-0.07803337,0.954299432,-0.20365806,0.20365806,-0.07803337,0,0,1,0
3678,16,79,46,124,110,0,1961.624,54,1099.932,MORE,-664,1180,516,2,1,-14,-1.312371845,14,0.87303787,0.188611452,-0.56285436,234,124,110,1,1.475932034,1.716734147,1.170500555,-0.433772469,-0.533394518,0.533394518,1.170500555,1.716734147,1,1,0
3679,16,80,58,92,110,1,3086.572,24,1331.845,MORE,212,1212,1424,3,2,18,1.687335229,18,1.571468165,-1.487934788,0.225912557,202,92,110,0,0.837691154,0.468200222,1.170500555,0.260263481,0.670143554,0.670143554,1.170500555,0.468200222,0,1,1
3680,16,81,48,128,110,1,2803.514,44,1405.844,LESS,-372,1726,1354,3,1,-18,-1.687335229,18,1.571468165,-0.370237295,0.027444018,238,128,110,0,1.555712144,1.872800887,1.170500555,0.260263481,-0.13221516,0.13221516,1.170500555,1.872800887,0,1,1
3681,16,82,8,50,58,0,2544.863,24,846.986,LESS,-942,1464,522,2,1,8,0.749926769,8,-0.174607574,-1.487934788,-0.153911344,108,50,58,1,-1.037141429,-1.170500555,-0.858367073,-0.433772469,-0.915339248,0.915339248,-0.858367073,-1.170500555,0,0,0
3682,16,83,4,54,50,1,1861.787,54,1332.752,LESS,688,518,1206,1,2,-4,-0.374963384,4,-0.87303787,0.188611452,-0.632855927,104,54,50,0,-1.116921539,-1.014433814,-1.170500555,-1.12780842,1.324120863,1.324120863,-1.170500555,-1.014433814,1,0,1
3683,16,84,37,80,69,1,1488.12,54,1303.728,LESS,462,610,1072,2,1,-11,-1.031149307,11,0.349215148,0.188611452,-0.894855741,149,80,69,0,-0.219395302,0,-0.429183537,-0.433772469,1.013619031,1.013619031,-0.429183537,0,1,0,1
3684,16,85,52,105,110,1,2691.067,14,2116.576,LESS,204,1100,1304,3,2,5,0.46870423,5,-0.698430296,-2.046783534,-0.051399158,215,105,110,1,1.096976512,0.975417129,1.170500555,0.260263481,0.659152339,0.659152339,1.170500555,0.975417129,0,1,1
3685,16,86,5,55,50,1,2097.914,54,1109.751,LESS,302,776,1078,3,2,-5,-0.46870423,5,-0.698430296,0.188611452,-0.46729346,105,55,50,0,-1.096976512,-0.975417129,-1.170500555,0.260263481,0.793794726,0.793794726,-1.170500555,-0.975417129,1,1,1
3686,16,87,30,96,80,1,1489.775,74,1481.145,LESS,684,338,1022,1,2,-16,-1.499853537,16,1.222253018,1.306308945,-0.893695324,176,96,80,0,0.31912044,0.624266962,0,-1.12780842,1.318625255,1.318625255,0,0.624266962,1,0,1
3687,16,88,33,80,75,0,3101.53,34,2096.806,LESS,-912,1802,890,1,1,-5,-0.46870423,5,-0.698430296,-0.929086041,0.236400486,155,80,75,0,-0.099725137,0,-0.195083426,-1.12780842,-0.874122191,0.874122191,-0.195083426,0,0,0,0
3688,16,89,48,110,128,0,1626.11,44,1294.924,LESS,-576,1008,432,2,1,18,1.687335229,18,1.571468165,-0.370237295,-0.798102872,238,110,128,1,1.555712144,1.170500555,1.872800887,-0.433772469,-0.41249115,0.41249115,1.872800887,1.170500555,0,0,0
3689,16,90,9,59,50,1,2510.29,74,1692.951,LESS,536,960,1496,3,2,-9,-0.843667615,9,0,1.306308945,-0.178152499,109,59,50,0,-1.017196402,-0.819350388,-1.170500555,0.260263481,1.115287773,1.115287773,-1.170500555,-0.819350388,1,1,1
3690,16,91,44,110,119,0,1714.624,54,1999.882,LESS,-788,1196,408,2,1,9,0.843667615,9,0,0.188611452,-0.736040523,229,110,119,1,1.376206896,1.170500555,1.521650721,-0.433772469,-0.703758354,0.703758354,1.521650721,1.170500555,1,0,0
3691,16,92,2,52,50,0,3615.13,54,1589.484,LESS,-856,1770,914,3,1,-2,-0.187481692,2,-1.222253018,0.188611452,0.596515521,102,52,50,0,-1.156811594,-1.092467184,-1.170500555,0.260263481,-0.797183684,0.797183684,-1.170500555,-1.092467184,1,1,0
3692,16,93,8,58,50,1,1902.783,54,872.553,LESS,404,654,1058,1,2,-8,-0.749926769,8,-0.174607574,0.188611452,-0.60411123,108,58,50,0,-1.037141429,-0.858367073,-1.170500555,-1.12780842,0.933932721,0.933932721,-1.170500555,-0.858367073,1,0,1
3693,16,94,44,119,110,1,2407.591,44,1204.848,LESS,390,986,1376,4,1,-9,-0.843667615,9,0,-0.370237295,-0.250160782,229,119,110,0,1.376206896,1.521650721,1.170500555,0.954299432,0.914698094,0.914698094,1.170500555,1.521650721,0,1,1
3694,16,95,34,74,80,0,1659.011,44,813.938,LESS,-494,1006,512,2,1,6,0.562445076,6,-0.523822722,-0.370237295,-0.775034054,154,74,80,1,-0.119670165,-0.234100111,0,-0.433772469,-0.299831193,0.299831193,0,-0.234100111,0,0,0
3695,16,96,24,86,80,0,1623.478,24,1394.325,LESS,-742,1170,428,2,1,-6,-0.562445076,6,-0.523822722,-1.487934788,-0.799948321,166,86,80,0,0.119670165,0.234100111,0,-0.433772469,-0.640558867,0.640558867,0,0.234100111,0,0,0
3696,16,97,39,66,80,0,1791.695,54,1105.062,LESS,-360,902,542,2,1,14,1.312371845,14,0.87303787,0.188611452,-0.682001532,146,66,80,1,-0.279230385,-0.546233592,0,-0.433772469,-0.115728337,0.115728337,0,-0.546233592,1,0,1
3697,16,98,9,50,59,0,1734.857,54,966.912,LESS,-506,1032,526,2,1,9,0.843667615,9,0,0.188611452,-0.721853982,109,50,59,1,-1.017196402,-1.170500555,-0.819350388,-0.433772469,-0.316318016,0.316318016,-0.819350388,-1.170500555,1,0,0
3698,16,99,57,94,110,0,1758.39,44,1435.231,LESS,-706,1222,516,2,1,16,1.499853537,16,1.222253018,-0.370237295,-0.705353618,204,94,110,1,0.877581209,0.546233592,1.170500555,-0.433772469,-0.591098398,0.591098398,1.170500555,0.546233592,0,0,0
3699,16,100,60,110,87,1,2344.225,54,1853.898,LESS,524,794,1318,3,2,-23,-2.15603946,23,2.444506035,0.188611452,-0.294590395,197,110,87,0,0.737966017,1.170500555,0.273116796,0.260263481,1.09880095,1.09880095,0.273116796,1.170500555,1,1,1
3700,16,101,33,75,80,0,2101.854,54,812.684,LESS,-830,1384,554,2,1,5,0.46870423,5,-0.698430296,0.188611452,-0.464530895,155,75,80,1,-0.099725137,-0.195083426,0,-0.433772469,-0.761462234,0.761462234,0,-0.195083426,1,0,0
3701,16,102,15,50,45,1,3114.904,54,1596.082,LESS,312,1420,1732,3,1,-5,-0.46870423,5,-0.698430296,0.188611452,0.245777781,95,50,45,0,-1.296426786,-1.170500555,-1.36558398,0.260263481,0.807533745,0.807533745,-1.36558398,-1.170500555,1,1,1
3702,16,103,59,89,110,0,1732.851,54,1876.152,LESS,-1408,1792,384,2,1,21,1.968557767,21,2.095290887,0.188611452,-0.723260506,199,89,110,1,0.777856072,0.351150166,1.170500555,-0.433772469,-1.555577538,1.555577538,1.170500555,0.351150166,1,0,0
3703,16,104,29,80,94,0,2078.607,44,1673.861,LESS,-1008,1560,552,2,1,14,1.312371845,14,0.87303787,-0.370237295,-0.480830728,174,80,94,1,0.279230385,0,0.546233592,-0.433772469,-1.006016774,1.006016774,0.546233592,0,0,0,0
3704,16,105,55,110,98,0,1734.678,54,1843.91,LESS,-424,1094,670,2,2,-12,-1.124890153,12,0.523822722,0.188611452,-0.72197949,208,110,98,0,0.957361319,1.170500555,0.702300333,-0.433772469,-0.20365806,0.20365806,0.702300333,1.170500555,0,0,0
3705,16,106,29,94,80,1,2516.607,54,1602.598,LESS,970,1004,1974,3,2,-14,-1.312371845,14,0.87303787,0.188611452,-0.17372328,174,94,80,0,0.279230385,0.546233592,0,0.260263481,1.711561201,1.711561201,0,0.546233592,0,1,1
3706,16,107,57,110,94,1,2332.303,54,1475.042,LESS,-48,1266,1218,3,1,-16,-1.499853537,16,1.222253018,0.188611452,-0.302949607,204,110,94,0,0.877581209,1.170500555,0.546233592,0.260263481,0.312929058,0.312929058,0.546233592,1.170500555,0,1,1
3707,16,108,39,80,66,1,3024.633,54,1323.289,LESS,504,1254,1758,4,1,-14,-1.312371845,14,0.87303787,0.188611452,0.182483497,146,80,66,0,-0.279230385,0,-0.546233592,0.954299432,1.071322912,1.071322912,-0.546233592,0,0,1,1
3708,16,109,4,50,54,0,4090.687,64,2790.031,LESS,-2320,3070,750,2,1,4,0.374963384,4,-0.87303787,0.747460199,0.929956381,104,50,54,1,-1.116921539,-1.170500555,-1.014433814,-0.433772469,-2.808576078,2.808576078,-1.014433814,-1.170500555,1,0,0
3709,16,110,55,98,110,0,3128.631,64,1306.901,LESS,-840,1918,1078,4,1,12,1.124890153,12,0.523822722,0.747460199,0.255402584,208,98,110,1,0.957361319,0.702300333,1.170500555,0.954299432,-0.775201254,0.775201254,1.170500555,0.702300333,1,1,0
3710,16,111,2,50,52,0,2587.421,74,2137.141,LESS,-1428,1986,558,2,1,2,0.187481692,2,-1.222253018,1.306308945,-0.124071438,102,50,52,1,-1.156811594,-1.170500555,-1.092467184,-0.433772469,-1.583055576,1.583055576,-1.092467184,-1.170500555,1,0,0
3711,16,112,59,110,89,1,2383.534,74,2175.145,LESS,470,936,1406,3,2,-21,-1.968557767,21,2.095290887,1.306308945,-0.267028553,199,110,89,0,0.777856072,1.170500555,0.351150166,0.260263481,1.024610247,1.024610247,0.351150166,1.170500555,1,1,1
3712,16,113,60,87,110,0,3422.254,64,1509.588,LESS,-690,1760,1070,4,1,23,2.15603946,23,2.444506035,0.747460199,0.461278864,197,87,110,1,0.737966017,0.273116796,1.170500555,0.954299432,-0.569115967,0.569115967,1.170500555,0.273116796,1,1,0
3713,16,114,52,110,105,0,3160.078,54,1795.345,LESS,-984,1772,788,4,1,-5,-0.46870423,5,-0.698430296,0.188611452,0.277451918,215,110,105,0,1.096976512,1.170500555,0.975417129,0.954299432,-0.973043128,0.973043128,0.975417129,1.170500555,0,1,0
3714,16,115,30,80,96,0,1962.005,64,1601.351,LESS,-1072,1488,416,2,1,16,1.499853537,16,1.222253018,0.747460199,-0.562587218,176,80,96,1,0.31912044,0,0.624266962,-0.433772469,-1.093946496,1.093946496,0.624266962,0,1,0,0
3715,16,116,24,80,86,0,1680.483,64,986.194,LESS,-710,1122,412,2,1,6,0.562445076,6,-0.523822722,0.747460199,-0.759978778,166,80,86,1,0.119670165,0,0.234100111,-0.433772469,-0.596594005,0.596594005,0.234100111,0,1,0,0
3716,16,117,5,50,55,0,1656.122,64,1365.624,LESS,-734,1126,392,2,1,5,0.46870423,5,-0.698430296,0.747460199,-0.777059701,105,50,55,1,-1.096976512,-1.170500555,-0.975417129,-0.433772469,-0.629567651,0.629567651,-0.975417129,-1.170500555,1,0,0
3717,16,118,34,80,74,0,2741.023,14,1730.023,LESS,-568,1576,1008,4,1,-6,-0.562445076,6,-0.523822722,-2.046783534,-0.016372082,154,80,74,0,-0.119670165,0,-0.234100111,0.954299432,-0.401499934,0.401499934,-0.234100111,0,0,1,0
3718,16,119,15,45,50,0,2959.108,64,1039.52,LESS,-64,1252,1188,3,1,5,0.46870423,5,-0.698430296,0.747460199,0.136540082,95,45,50,1,-1.296426786,-1.36558398,-1.170500555,0.260263481,0.290946628,0.290946628,-1.170500555,-1.36558398,1,0,1
3719,16,120,37,69,80,0,1697.143,84,1744.624,LESS,-252,972,720,2,1,11,1.031149307,11,0.349215148,1.865157692,-0.748297476,149,69,80,1,-0.219395302,-0.429183537,0,-0.433772469,0.032653069,0.032653069,0,-0.429183537,1,0,1
3720,16,121,48,128,110,1,2297.314,54,1738.244,MORE,154,1236,1390,4,1,-18,-1.687335229,18,1.571468165,0.188611452,-0.327482444,238,128,110,1,1.555712144,1.872800887,1.170500555,0.954299432,0.590457244,0.590457244,1.170500555,1.872800887,1,1,1
3721,16,122,8,50,58,1,1450.68,54,1471.143,MORE,198,638,836,1,1,8,0.749926769,8,-0.174607574,0.188611452,-0.921107118,108,50,58,0,-1.037141429,-1.170500555,-0.858367073,-1.12780842,0.650908928,0.650908928,-0.858367073,-1.170500555,1,0,1
3722,16,123,4,54,50,0,1785.609,74,1356.09,MORE,-524,1250,726,3,2,-4,-0.374963384,4,-0.87303787,1.306308945,-0.686268783,104,54,50,1,-1.116921539,-1.014433814,-1.170500555,0.260263481,-0.34104825,0.34104825,-1.170500555,-1.014433814,1,1,0
3723,16,124,37,80,69,0,3070.115,54,2037.406,MORE,-1548,2356,808,2,1,-11,-1.031149307,11,0.349215148,0.188611452,0.21437359,149,80,69,1,-0.219395302,0,-0.429183537,-0.433772469,-1.747923805,1.747923805,-0.429183537,0,1,1,0
3724,16,125,52,105,110,0,2001.393,64,1384.372,MORE,-1064,1544,480,2,1,5,0.46870423,5,-0.698430296,0.747460199,-0.534969985,215,105,110,0,1.096976512,0.975417129,1.170500555,-0.433772469,-1.082955281,1.082955281,1.170500555,0.975417129,1,1,0
3725,16,126,5,55,50,1,3542.867,54,1436.544,MORE,-134,1608,1474,4,2,-5,-0.46870423,5,-0.698430296,0.188611452,0.545847701,105,55,50,1,-1.096976512,-0.975417129,-1.170500555,0.954299432,0.194773494,0.194773494,-1.170500555,-0.975417129,1,1,1
3726,16,127,30,96,80,0,1684.057,84,1900.555,MORE,-894,1392,498,2,1,-16,-1.499853537,16,1.222253018,1.865157692,-0.757472837,176,96,80,1,0.31912044,0.624266962,0,-0.433772469,-0.849391957,0.849391957,0,0.624266962,1,1,0
3727,16,128,33,80,75,0,3277.203,54,1411.742,MORE,-566,1600,1034,4,1,-5,-0.46870423,5,-0.698430296,0.188611452,0.359575114,155,80,75,1,-0.099725137,0,-0.195083426,0.954299432,-0.398752131,0.398752131,-0.195083426,0,1,1,0
3728,16,129,48,110,128,1,2804.936,64,1975.425,MORE,148,1106,1254,4,1,18,1.687335229,18,1.571468165,0.747460199,0.028441065,238,110,128,0,1.555712144,1.170500555,1.872800887,0.954299432,0.582213832,0.582213832,1.872800887,1.170500555,1,1,1
3729,16,130,9,59,50,0,2607.568,44,1261.758,MORE,-284,1422,1138,4,1,-9,-0.843667615,9,0,-0.370237295,-0.109945197,109,59,50,1,-1.017196402,-0.819350388,-1.170500555,0.954299432,-0.011311792,0.011311792,-1.170500555,-0.819350388,0,1,0
3730,16,131,44,110,119,1,4602.334,24,1066.111,MORE,196,1924,2120,5,1,9,0.843667615,9,0,-1.487934788,1.288702054,229,110,119,0,1.376206896,1.170500555,1.521650721,1.648335383,0.648161124,0.648161124,1.521650721,1.170500555,0,1,1
3731,16,132,2,52,50,1,2088.893,24,2252.214,MORE,382,792,1174,4,1,-2,-0.187481692,2,-1.222253018,-1.487934788,-0.473618611,102,52,50,1,-1.156811594,-1.092467184,-1.170500555,0.954299432,0.903706879,0.903706879,-1.170500555,-1.092467184,0,1,1
3732,16,133,8,58,50,0,2599.006,44,686.068,MORE,-1534,2130,596,2,1,-8,-0.749926769,8,-0.174607574,-0.370237295,-0.115948516,108,58,50,1,-1.037141429,-0.858367073,-1.170500555,-0.433772469,-1.728689178,1.728689178,-1.170500555,-0.858367073,0,1,0
3733,16,134,44,119,110,0,2728.257,34,1766.074,MORE,-152,1328,1176,2,1,-9,-0.843667615,9,0,-0.929086041,-0.025323072,229,119,110,1,1.376206896,1.521650721,1.170500555,-0.433772469,0.17004326,0.17004326,1.170500555,1.521650721,0,1,1
3734,16,135,34,74,80,1,1424.432,64,1262.171,MORE,472,394,866,1,2,6,0.562445076,6,-0.523822722,0.747460199,-0.939511127,154,74,80,0,-0.119670165,-0.234100111,0,-1.12780842,1.027358051,1.027358051,0,-0.234100111,1,0,1
3735,16,136,24,86,80,0,4003.233,54,952.968,MORE,460,1616,2076,4,1,-6,-0.562445076,6,-0.523822722,0.188611452,0.868637261,166,86,80,1,0.119670165,0.234100111,0,0.954299432,1.010871228,1.010871228,0,0.234100111,1,1,1
3736,16,137,39,66,80,1,2458.65,54,1980.77,MORE,152,1014,1166,3,2,14,1.312371845,14,0.87303787,0.188611452,-0.214360327,146,66,80,0,-0.279230385,-0.546233592,0,0.260263481,0.58770944,0.58770944,0,-0.546233592,1,1,1
3737,16,138,9,50,59,1,1380.082,64,1928.36,MORE,292,484,776,1,2,9,0.843667615,9,0,0.747460199,-0.970607509,109,50,59,0,-1.017196402,-1.170500555,-0.819350388,-1.12780842,0.780055707,0.780055707,-0.819350388,-1.170500555,1,0,1
3738,16,139,57,94,110,1,2036.945,64,2782.967,MORE,234,772,1006,3,2,16,1.499853537,16,1.222253018,0.747460199,-0.510042396,204,94,110,0,0.877581209,0.546233592,1.170500555,0.260263481,0.700369396,0.700369396,1.170500555,0.546233592,1,1,1
3739,16,140,60,110,87,0,2979.857,54,1034.516,MORE,-988,1852,864,2,1,-23,-2.15603946,23,2.444506035,0.188611452,0.151088421,197,110,87,1,0.737966017,1.170500555,0.273116796,-0.433772469,-0.978538736,0.978538736,0.273116796,1.170500555,1,1,0
3740,16,141,33,75,80,1,1563.707,64,1431.844,MORE,790,422,1212,1,2,5,0.46870423,5,-0.698430296,0.747460199,-0.841857269,155,75,80,0,-0.099725137,-0.195083426,0,-1.12780842,1.464258857,1.464258857,0,-0.195083426,1,0,1
3741,16,142,15,50,45,0,1949.932,24,1118.245,MORE,-872,1350,478,2,1,-5,-0.46870423,5,-0.698430296,-1.487934788,-0.571052306,95,50,45,1,-1.296426786,-1.170500555,-1.36558398,-0.433772469,-0.819166115,0.819166115,-1.36558398,-1.170500555,0,1,0
3742,16,143,59,89,110,1,1564.188,74,1426.149,MORE,480,460,940,1,2,21,1.968557767,21,2.095290887,1.306308945,-0.841520012,199,89,110,0,0.777856072,0.351150166,1.170500555,-1.12780842,1.038349266,1.038349266,1.170500555,0.351150166,1,0,1
3743,16,144,29,80,94,1,1570.775,84,1621.487,MORE,526,328,854,0,2,14,1.312371845,14,0.87303787,1.865157692,-0.836901481,174,80,94,0,0.279230385,0,0.546233592,-1.82184437,1.101548754,1.101548754,0.546233592,0,1,0,1
3744,16,145,55,110,98,0,2046.326,54,575.155,MORE,-634,1204,570,2,1,-12,-1.124890153,12,0.523822722,0.188611452,-0.503464828,208,110,98,1,0.957361319,1.170500555,0.702300333,-0.433772469,-0.49217746,0.49217746,0.702300333,1.170500555,0,0,0
3745,16,146,29,94,80,1,1989.609,44,1492.903,MORE,1032,402,1434,1,2,-14,-1.312371845,14,0.87303787,-0.370237295,-0.543232438,174,94,80,1,0.279230385,0.546233592,0,-1.12780842,1.796743119,1.796743119,0,0.546233592,0,0,1
3746,16,147,57,110,94,0,4922.105,34,1417.241,MORE,-2006,3248,1242,2,1,-16,-1.499853537,16,1.222253018,-0.929086041,1.512912227,204,110,94,1,0.877581209,1.170500555,0.546233592,-0.433772469,-2.377170879,2.377170879,0.546233592,1.170500555,0,0,0
3747,16,148,39,80,66,0,2979.601,34,1566.369,MORE,-1336,1838,502,2,1,-14,-1.312371845,14,0.87303787,-0.929086041,0.150908925,146,80,66,1,-0.279230385,0,-0.546233592,-0.433772469,-1.4566566,1.4566566,-0.546233592,0,0,0,0
3748,16,149,4,50,54,0,1501.083,44,1157.842,MORE,-676,1166,490,2,1,4,0.374963384,4,-0.87303787,-0.370237295,-0.885766623,104,50,54,0,-1.116921539,-1.170500555,-1.014433814,-0.433772469,-0.549881341,0.549881341,-1.014433814,-1.170500555,0,0,0
3749,16,150,55,98,110,1,4729,54,766.07,MORE,-1274,2808,1534,3,2,12,1.124890153,12,0.523822722,0.188611452,1.377515003,208,98,110,0,0.957361319,0.702300333,1.170500555,0.260263481,-1.371474682,1.371474682,1.170500555,0.702300333,0,1,0
3750,16,151,2,50,52,1,1268.247,44,1510.251,MORE,200,456,656,1,2,2,0.187481692,2,-1.222253018,-0.370237295,-1.049021577,102,50,52,0,-1.156811594,-1.170500555,-1.092467184,-1.12780842,0.653656731,0.653656731,-1.092467184,-1.170500555,0,0,1
3751,16,152,59,110,89,0,1773.473,54,1965.71,MORE,-1216,1722,506,2,1,-21,-1.968557767,21,2.095290887,0.188611452,-0.694778043,199,110,89,1,0.777856072,1.170500555,0.351150166,-0.433772469,-1.291788371,1.291788371,0.351150166,1.170500555,0,0,0
3752,16,153,60,87,110,1,3472.1,74,6672.377,MORE,734,1560,2294,3,2,23,2.15603946,23,2.444506035,1.306308945,0.496228813,197,87,110,0,0.737966017,0.273116796,1.170500555,0.260263481,1.387320351,1.387320351,1.170500555,0.273116796,1,1,1
3753,16,154,52,110,105,1,3527.954,54,1865.46,MORE,-508,1838,1330,4,1,-5,-0.46870423,5,-0.698430296,0.188611452,0.535391323,215,110,105,1,1.096976512,1.170500555,0.975417129,0.954299432,-0.31906582,0.31906582,0.975417129,1.170500555,0,1,0
3754,16,155,30,80,96,1,1474.216,54,1145.385,MORE,710,420,1130,1,2,16,1.499853537,16,1.222253018,0.188611452,-0.90460465,176,80,96,0,0.31912044,0,0.624266962,-1.12780842,1.354346705,1.354346705,0.624266962,0,0,0,1
3755,16,156,24,80,86,1,2694.189,64,1933.838,MORE,-496,1766,1270,0,2,6,0.562445076,6,-0.523822722,0.747460199,-0.049210141,166,80,86,0,0.119670165,0,0.234100111,-1.82184437,-0.302578997,0.302578997,0.234100111,0,1,0,0
3756,16,157,5,50,55,1,1369.8,64,928.387,MORE,356,406,762,1,2,5,0.46870423,5,-0.698430296,0.747460199,-0.977816822,105,50,55,0,-1.096976512,-1.170500555,-0.975417129,-1.12780842,0.867985429,0.867985429,-0.975417129,-1.170500555,1,0,1
3757,16,158,34,80,74,0,2337.132,54,962.254,MORE,-1284,1816,532,1,1,-6,-0.562445076,6,-0.523822722,0.188611452,-0.299563712,154,80,74,1,-0.119670165,0,-0.234100111,-1.12780842,-1.385213701,1.385213701,-0.234100111,0,0,0,0
3758,16,159,15,45,50,1,1163.444,54,1063.001,MORE,226,382,608,1,2,5,0.46870423,5,-0.698430296,0.188611452,-1.122505097,95,45,50,0,-1.296426786,-1.36558398,-1.170500555,-1.12780842,0.689378181,0.689378181,-1.170500555,-1.36558398,0,0,1
3759,16,160,37,69,80,1,2544.723,64,1346.78,MORE,-500,828,328,1,1,11,1.031149307,11,0.349215148,0.747460199,-0.154009506,149,69,80,0,-0.219395302,-0.429183537,0,-1.12780842,-0.308074605,0.308074605,0,-0.429183537,1,0,0
3760,16,161,3,50,53,0,3733.765,14,1145.701,LESS,-1166,2058,892,3,1,3,0.281222538,3,-1.047645444,-2.046783534,0.679697467,103,50,53,1,-1.136866566,-1.170500555,-1.053450499,0.260263481,-1.223093276,1.223093276,-1.053450499,-1.170500555,0,1,0
3761,16,162,20,50,40,1,1372.357,34,1250.605,LESS,720,366,1086,1,2,-10,-0.937408461,10,0.174607574,-0.929086041,-0.976023959,90,50,40,0,-1.396151924,-1.170500555,-1.560667406,-1.12780842,1.368085724,1.368085724,-1.560667406,-1.170500555,0,0,1
3762,16,163,25,80,88,0,1660.791,64,1387.411,LESS,-332,956,624,2,2,8,0.749926769,8,-0.174607574,0.747460199,-0.773785992,168,80,88,1,0.15956022,0,0.312133481,-0.433772469,-0.077259084,0.077259084,0.312133481,0,1,0,1
3763,16,164,42,115,110,1,2780.666,34,759.344,LESS,572,976,1548,3,2,-5,-0.46870423,5,-0.698430296,-0.929086041,0.011423947,225,115,110,0,1.296426786,1.36558398,1.170500555,0.260263481,1.164748241,1.164748241,1.170500555,1.36558398,0,1,1
3764,16,165,53,103,110,0,1638.734,54,1488.59,LESS,-858,1274,416,2,1,7,0.656185922,7,-0.349215148,0.188611452,-0.789251446,213,103,110,1,1.057086457,0.897383758,1.170500555,-0.433772469,-0.799931488,0.799931488,1.170500555,0.897383758,0,0,0
3765,16,166,26,90,80,1,2529.656,24,1882.865,LESS,530,912,1442,3,2,-10,-0.937408461,10,0.174607574,-1.487934788,-0.164573862,170,90,80,0,0.199450275,0.390166852,0,0.260263481,1.107044361,1.107044361,0,0.390166852,0,1,1
3766,16,167,35,80,72,1,3319.275,44,1068.634,LESS,712,1252,1964,3,2,-8,-0.749926769,8,-0.174607574,-0.370237295,0.389074256,152,80,72,0,-0.15956022,0,-0.312133481,0.260263481,1.357094509,1.357094509,-0.312133481,0,0,1,1
3767,16,168,28,93,80,1,1600.094,34,1478.032,LESS,528,608,1136,1,1,-13,-1.218630999,13,0.698430296,-0.929086041,-0.816344213,173,93,80,0,0.259285357,0.507216907,0,-1.12780842,1.104296557,1.104296557,0,0.507216907,0,0,1
3768,16,169,26,80,90,0,2007.16,80,1417.122,LESS,-734,1234,500,2,1,10,0.937408461,10,0.174607574,1.641618193,-0.530926404,170,80,90,1,0.199450275,0,0.390166852,-0.433772469,-0.629567651,0.629567651,0.390166852,0,1,0,0
3769,16,170,25,88,80,0,2217.586,44,1788.505,LESS,-1120,1606,486,2,1,-8,-0.749926769,8,-0.174607574,-0.370237295,-0.383384413,168,88,80,0,0.15956022,0.312133481,0,-0.433772469,-1.159893788,1.159893788,0,0.312133481,0,0,0
3770,16,171,36,80,70,1,2922.13,24,1634.033,LESS,266,1186,1452,3,2,-10,-0.937408461,10,0.174607574,-1.487934788,0.110612641,150,80,70,0,-0.199450275,0,-0.390166852,0.260263481,0.744334257,0.744334257,-0.390166852,0,0,1,1
3771,16,172,28,80,93,0,2608.895,84,1264.786,LESS,-344,884,540,1,2,13,1.218630999,13,0.698430296,1.865157692,-0.109014759,173,80,93,1,0.259285357,0,0.507216907,-1.12780842,-0.093745907,0.093745907,0.507216907,0,1,0,1
3772,16,173,21,82,80,1,2210.489,4,1455.871,LESS,-200,1218,1018,3,1,-2,-0.187481692,2,-1.222253018,-2.605632281,-0.388360535,162,82,80,0,0.039890055,0.07803337,0,0.260263481,0.104095968,0.104095968,0,0.07803337,0,0,1
3773,16,174,19,50,41,1,3039.761,44,1956.775,LESS,462,1164,1626,3,2,-9,-0.843667615,9,0,-0.370237295,0.193090624,91,50,41,0,-1.376206896,-1.170500555,-1.521650721,0.260263481,1.013619031,1.013619031,-1.521650721,-1.170500555,0,1,1
3774,16,175,56,96,110,0,1541.849,74,2200.985,LESS,-448,900,452,2,1,14,1.312371845,14,0.87303787,1.306308945,-0.857183193,206,96,110,1,0.917471264,0.624266962,1.170500555,-0.433772469,-0.236631705,0.236631705,1.170500555,0.624266962,1,0,0
3775,16,176,23,80,85,0,2464.052,64,1395.894,LESS,-878,1362,484,2,1,5,0.46870423,5,-0.698430296,0.747460199,-0.210572668,165,80,85,1,0.099725137,0,0.195083426,-0.433772469,-0.827409526,0.827409526,0.195083426,0,1,0,0
3776,16,177,10,60,50,1,2385.439,64,1713.784,LESS,226,894,1120,3,2,-10,-0.937408461,10,0.174607574,0.747460199,-0.265692846,110,60,50,0,-0.997251374,-0.780333703,-1.170500555,0.260263481,0.689378181,0.689378181,-1.170500555,-0.780333703,1,0,1
3777,16,178,19,41,50,0,1751.336,94,1892.466,LESS,-408,894,486,2,2,9,0.843667615,9,0,2.424006438,-0.71029959,91,41,50,1,-1.376206896,-1.521650721,-1.170500555,-0.433772469,-0.181675629,0.181675629,-1.170500555,-1.521650721,1,0,1
3778,16,179,56,110,96,0,3381.522,34,1625.101,LESS,-926,2064,1138,4,1,-14,-1.312371845,14,0.87303787,-0.929086041,0.432719273,206,110,96,0,0.917471264,1.170500555,0.624266962,0.954299432,-0.893356818,0.893356818,0.624266962,1.170500555,0,1,0
3779,16,180,35,72,80,0,4947.916,34,1861.562,LESS,-236,1698,1462,3,2,8,0.749926769,8,-0.174607574,-0.929086041,1.53100983,152,72,80,1,-0.15956022,-0.312133481,0,0.260263481,0.054635499,0.054635499,0,-0.312133481,0,0,1
3780,16,181,11,49,50,0,3439.893,64,1120.574,LESS,-512,1504,992,4,1,1,0.093740846,1,-1.396860592,0.747460199,0.473646599,99,49,50,1,-1.216646676,-1.20951724,-1.170500555,0.954299432,-0.324561428,0.324561428,-1.170500555,-1.20951724,1,1,0
3781,16,182,17,43,50,0,1827.288,54,858.738,LESS,-922,1302,380,2,1,7,0.656185922,7,-0.349215148,0.188611452,-0.657045196,93,43,50,1,-1.336316841,-1.443617351,-1.170500555,-0.433772469,-0.88786121,0.88786121,-1.170500555,-1.443617351,1,0,0
3782,16,183,1,51,50,0,4233.239,64,1427.498,LESS,-372,2180,1808,6,1,-1,-0.093740846,1,-1.396860592,0.747460199,1.029907936,101,51,50,0,-1.176756621,-1.131483869,-1.170500555,2.342371333,-0.13221516,0.13221516,-1.170500555,-1.131483869,1,1,1
3783,16,184,41,112,110,0,3197.341,64,1272.22,LESS,-662,1852,1190,4,1,-2,-0.187481692,2,-1.222253018,0.747460199,0.303579189,222,112,110,0,1.236591704,1.248533925,1.170500555,0.954299432,-0.530646714,0.530646714,1.170500555,1.248533925,1,1,0
3784,16,185,20,40,50,0,1839.566,44,2928.319,LESS,-2148,2544,396,2,1,10,0.937408461,10,0.174607574,-0.370237295,-0.648436371,90,40,50,1,-1.396151924,-1.560667406,-1.170500555,-0.433772469,-2.57226495,2.57226495,-1.170500555,-1.560667406,0,0,0
3785,16,186,1,50,51,0,1646.644,64,1561.518,LESS,-696,1076,380,2,1,1,0.093740846,1,-1.396860592,0.747460199,-0.783705282,101,50,51,1,-1.176756621,-1.170500555,-1.131483869,-0.433772469,-0.577359379,0.577359379,-1.131483869,-1.170500555,1,0,0
3786,16,187,23,85,80,0,1821.897,64,780.603,LESS,-588,1136,548,2,1,-5,-0.46870423,5,-0.698430296,0.747460199,-0.660825142,165,85,80,0,0.099725137,0.195083426,0,-0.433772469,-0.428977973,0.428977973,0,0.195083426,1,0,0
3787,16,188,11,50,49,1,3053.78,54,1644.752,LESS,364,1266,1630,3,1,-1,-0.093740846,1,-1.396860592,0.188611452,0.202920165,99,50,49,0,-1.216646676,-1.170500555,-1.20951724,0.260263481,0.878976644,0.878976644,-1.20951724,-1.170500555,0,1,1
3788,16,189,17,50,43,1,2725.795,20,1461.83,LESS,-602,1452,850,1,1,-7,-0.656185922,7,-0.349215148,-1.711474286,-0.027049324,93,50,43,0,-1.336316841,-1.170500555,-1.443617351,-1.12780842,-0.448212599,0.448212599,-1.443617351,-1.170500555,0,0,0
3789,16,190,21,80,82,0,1549.39,64,1183.902,LESS,-544,896,352,1,1,2,0.187481692,2,-1.222253018,0.747460199,-0.851895756,162,80,82,1,0.039890055,0,0.07803337,-1.12780842,-0.368526289,0.368526289,0.07803337,0,1,0,0
3790,16,191,10,50,60,0,1413.255,54,771.214,LESS,-520,862,342,2,1,10,0.937408461,10,0.174607574,0.188611452,-0.947347977,110,50,60,1,-0.997251374,-1.170500555,-0.780333703,-0.433772469,-0.335552643,0.335552643,-0.780333703,-1.170500555,0,0,0
3791,16,192,3,53,50,0,2962.129,64,1183.161,LESS,-552,1574,1022,4,1,-3,-0.281222538,3,-1.047645444,0.747460199,0.138658282,103,53,50,0,-1.136866566,-1.053450499,-1.170500555,0.954299432,-0.379517504,0.379517504,-1.170500555,-1.053450499,1,1,0
3792,16,193,45,122,110,1,3921.279,14,680.356,LESS,344,1726,2070,5,1,-12,-1.124890153,12,0.523822722,-2.046783534,0.811174512,232,122,110,0,1.436041979,1.638700776,1.170500555,1.648335383,0.851498606,0.851498606,1.170500555,1.638700776,0,1,1
3793,16,194,38,67,80,0,2808.397,54,1231.891,LESS,-590,1534,944,3,1,13,1.218630999,13,0.698430296,0.188611452,0.030867775,147,67,80,1,-0.259285357,-0.507216907,0,0.260263481,-0.431725776,0.431725776,0,-0.507216907,0,1,0
3794,16,195,38,80,67,0,2444.954,54,1108.493,LESS,-962,1676,714,2,1,-13,-1.218630999,13,0.698430296,0.188611452,-0.223963394,147,80,67,0,-0.259285357,0,-0.507216907,-0.433772469,-0.942817286,0.942817286,-0.507216907,0,1,0,0
3795,16,196,36,70,80,1,1661.744,44,1144.938,LESS,722,410,1132,1,2,10,0.937408461,10,0.174607574,-0.370237295,-0.773117788,150,70,80,1,-0.199450275,-0.390166852,0,-1.12780842,1.370833528,1.370833528,0,-0.390166852,0,0,1
3796,16,197,45,110,122,0,1944.174,64,1340.881,LESS,-802,1318,516,2,1,12,1.124890153,12,0.523822722,0.747460199,-0.575089577,232,110,122,1,1.436041979,1.170500555,1.638700776,-0.433772469,-0.722992981,0.722992981,1.638700776,1.170500555,1,0,0
3797,16,198,42,110,115,0,4598.125,64,1102.229,LESS,-1372,2742,1370,4,1,5,0.46870423,5,-0.698430296,0.747460199,1.285750877,225,110,115,1,1.296426786,1.170500555,1.36558398,0.954299432,-1.506117069,1.506117069,1.36558398,1.170500555,1,1,0
3798,16,199,41,110,112,0,2324.459,54,819.664,LESS,126,1072,1198,3,2,2,0.187481692,2,-1.222253018,0.188611452,-0.308449495,222,110,112,1,1.236591704,1.170500555,1.248533925,0.260263481,0.55198799,0.55198799,1.248533925,1.170500555,1,1,1
3799,16,200,53,110,103,0,2029.368,74,1238.017,LESS,-1040,1554,514,2,1,-7,-0.656185922,7,-0.349215148,1.306308945,-0.515355075,213,110,103,0,1.057086457,1.170500555,0.897383758,-0.433772469,-1.049981635,1.049981635,0.897383758,1.170500555,1,0,0
3800,16,201,3,50,53,0,3447.013,34,1662.247,MORE,-436,1838,1402,4,2,3,0.281222538,3,-1.047645444,-0.929086041,0.478638848,103,50,53,0,-1.136866566,-1.170500555,-1.053450499,0.954299432,-0.220144882,0.220144882,-1.053450499,-1.170500555,0,1,0
3801,16,202,20,50,40,0,2861.298,54,1401.24,MORE,-378,1408,1030,4,1,-10,-0.937408461,10,0.174607574,0.188611452,0.067959764,90,50,40,1,-1.396151924,-1.170500555,-1.560667406,0.954299432,-0.140458572,0.140458572,-1.560667406,-1.170500555,0,1,0
3802,16,203,25,80,88,1,1581.868,74,1480.129,MORE,-224,908,684,0,1,8,0.749926769,8,-0.174607574,1.306308945,-0.829123529,168,80,88,0,0.15956022,0,0.312133481,-1.82184437,0.071122322,0.071122322,0.312133481,0,1,0,0
3803,16,204,42,115,110,1,3253.279,14,662.804,MORE,348,1346,1694,3,1,-5,-0.46870423,5,-0.698430296,-2.046783534,0.342800596,225,115,110,1,1.296426786,1.36558398,1.170500555,0.260263481,0.856994214,0.856994214,1.170500555,1.36558398,0,1,1
3804,16,205,53,103,110,1,1378.583,64,1360.634,MORE,246,452,698,1,2,7,0.656185922,7,-0.349215148,0.747460199,-0.971658546,213,103,110,0,1.057086457,0.897383758,1.170500555,-1.12780842,0.716856219,0.716856219,1.170500555,0.897383758,1,0,1
3805,16,206,26,90,80,1,1118.566,54,1105.891,MORE,338,372,710,1,2,-10,-0.937408461,10,0.174607574,0.188611452,-1.153971691,170,90,80,1,0.199450275,0.390166852,0,-1.12780842,0.843255195,0.843255195,0,0.390166852,0,0,1
3806,16,207,35,80,72,0,4386.187,44,1779.802,MORE,-564,2272,1708,4,1,-8,-0.749926769,8,-0.174607574,-0.370237295,1.137148735,152,80,72,1,-0.15956022,0,-0.312133481,0.954299432,-0.396004327,0.396004327,-0.312133481,0,0,1,0
3807,16,208,28,93,80,0,4784.368,20,1225.529,MORE,-2122,3116,994,4,1,-13,-1.218630999,13,0.698430296,-1.711474286,1.41633675,173,93,80,1,0.259285357,0.507216907,0,0.954299432,-2.5365435,2.5365435,0,0.507216907,0,1,0
3808,16,209,26,80,90,0,4116.16,34,1207.044,MORE,-1298,2624,1326,4,1,10,0.937408461,10,0.174607574,-0.929086041,0.947816993,170,80,90,0,0.199450275,0,0.390166852,0.954299432,-1.404448328,1.404448328,0.390166852,0,0,1,0
3809,16,210,25,88,80,0,2423.192,24,772.322,MORE,-1330,1794,464,2,1,-8,-0.749926769,8,-0.174607574,-1.487934788,-0.239222007,168,88,80,1,0.15956022,0.312133481,0,-0.433772469,-1.448413189,1.448413189,0,0.312133481,0,0,0
3810,16,211,36,80,70,0,1776.985,54,840.423,MORE,-694,1140,446,2,1,-10,-0.937408461,10,0.174607574,0.188611452,-0.692315575,150,80,70,1,-0.199450275,0,-0.390166852,-0.433772469,-0.574611575,0.574611575,-0.390166852,0,0,0,0
3811,16,212,28,80,93,1,1505.001,84,1816.382,MORE,464,502,966,1,2,13,1.218630999,13,0.698430296,1.865157692,-0.883019484,173,80,93,0,0.259285357,0,0.507216907,-1.12780842,1.016366835,1.016366835,0.507216907,0,1,0,1
3812,16,213,21,82,80,1,1452.55,94,681.164,MORE,400,474,874,1,2,-2,-0.187481692,2,-1.222253018,2.424006438,-0.919795951,162,82,80,1,0.039890055,0.07803337,0,-1.12780842,0.928437113,0.928437113,0,0.07803337,1,0,1
3813,16,214,19,50,41,0,1761.95,54,1409.457,MORE,-506,1012,506,2,1,-9,-0.843667615,9,0,0.188611452,-0.702857494,91,50,41,1,-1.376206896,-1.170500555,-1.521650721,-0.433772469,-0.316318016,0.316318016,-1.521650721,-1.170500555,0,0,0
3814,16,215,56,96,110,1,1458.171,54,1024.91,MORE,708,430,1138,2,1,14,1.312371845,14,0.87303787,0.188611452,-0.915854739,206,96,110,0,0.917471264,0.624266962,1.170500555,-0.433772469,1.351598901,1.351598901,1.170500555,0.624266962,0,0,1
3815,16,216,23,80,85,1,2013.089,74,917.115,MORE,84,870,954,3,2,5,0.46870423,5,-0.698430296,1.306308945,-0.526769235,165,80,85,0,0.099725137,0,0.195083426,0.260263481,0.49428411,0.49428411,0.195083426,0,1,1,1
3816,16,217,10,60,50,1,1090.55,64,1329.506,MORE,152,382,534,1,2,-10,-0.937408461,10,0.174607574,0.747460199,-1.173615349,110,60,50,1,-0.997251374,-0.780333703,-1.170500555,-1.12780842,0.58770944,0.58770944,-1.170500555,-0.780333703,1,0,1
3817,16,218,19,41,50,1,1368.803,74,1226.284,MORE,530,390,920,1,2,9,0.843667615,9,0,1.306308945,-0.978515877,91,41,50,0,-1.376206896,-1.521650721,-1.170500555,-1.12780842,1.107044361,1.107044361,-1.170500555,-1.521650721,1,0,1
3818,16,219,56,110,96,0,3310.863,74,1164.647,MORE,-942,1964,1022,4,1,-14,-1.312371845,14,0.87303787,1.306308945,0.383176111,206,110,96,1,0.917471264,1.170500555,0.624266962,0.954299432,-0.915339248,0.915339248,0.624266962,1.170500555,1,1,0
3819,16,220,35,72,80,1,1333.375,74,1281.919,MORE,134,522,656,1,2,8,0.749926769,8,-0.174607574,1.306308945,-1.003356522,152,72,80,0,-0.15956022,-0.312133481,0,-1.12780842,0.562979205,0.562979205,0,-0.312133481,1,0,1
3820,16,221,11,49,50,1,1099.681,64,1724.947,MORE,-48,716,668,1,1,1,0.093740846,1,-1.396860592,0.747460199,-1.16721307,99,49,50,0,-1.216646676,-1.20951724,-1.170500555,-1.12780842,0.312929058,0.312929058,-1.170500555,-1.20951724,1,0,1
3821,16,222,17,43,50,1,1094.369,54,720.309,MORE,308,348,656,1,2,7,0.656185922,7,-0.349215148,0.188611452,-1.170937624,93,43,50,0,-1.336316841,-1.443617351,-1.170500555,-1.12780842,0.802038138,0.802038138,-1.170500555,-1.443617351,0,0,1
3822,16,223,1,51,50,1,1480.236,44,1647.814,MORE,-922,1370,448,2,1,-1,-0.093740846,1,-1.396860592,-0.370237295,-0.900383675,101,51,50,1,-1.176756621,-1.131483869,-1.170500555,-0.433772469,-0.88786121,0.88786121,-1.170500555,-1.131483869,0,1,0
3823,16,224,41,112,110,1,2309.816,54,1567.151,MORE,314,914,1228,2,2,-2,-0.187481692,2,-1.222253018,0.188611452,-0.318716559,222,112,110,1,1.236591704,1.248533925,1.170500555,-0.433772469,0.810281549,0.810281549,1.170500555,1.248533925,0,1,1
3824,16,225,20,40,50,1,1215.538,64,1015.409,MORE,360,344,704,1,2,10,0.937408461,10,0.174607574,0.747460199,-1.085978943,90,40,50,0,-1.396151924,-1.560667406,-1.170500555,-1.12780842,0.873481037,0.873481037,-1.170500555,-1.560667406,1,0,1
3825,16,226,1,50,51,0,2433.235,44,1644.443,MORE,-356,1212,856,3,2,1,0.093740846,1,-1.396860592,-0.370237295,-0.232180272,101,50,51,0,-1.176756621,-1.170500555,-1.131483869,0.260263481,-0.11023273,0.11023273,-1.131483869,-1.170500555,0,1,0
3826,16,227,23,85,80,1,2634.328,64,1744.245,MORE,898,832,1730,3,2,-5,-0.46870423,5,-0.698430296,0.747460199,-0.091182194,165,85,80,1,0.099725137,0.195083426,0,0.260263481,1.612640264,1.612640264,0,0.195083426,1,1,1
3827,16,228,11,50,49,0,3138.709,14,400.265,MORE,-946,1868,922,4,1,-1,-0.093740846,1,-1.396860592,-2.046783534,0.26246886,99,50,49,1,-1.216646676,-1.170500555,-1.20951724,0.954299432,-0.920834856,0.920834856,-1.20951724,-1.170500555,0,1,0
3828,16,229,17,50,43,0,2271.006,74,715.63,MORE,-944,1528,584,2,1,-7,-0.656185922,7,-0.349215148,1.306308945,-0.345928523,93,50,43,1,-1.336316841,-1.170500555,-1.443617351,-0.433772469,-0.918087052,0.918087052,-1.443617351,-1.170500555,1,1,0
3829,16,230,21,80,82,1,1691.994,74,1692.324,MORE,718,412,1130,1,2,2,0.187481692,2,-1.222253018,1.306308945,-0.751907742,162,80,82,0,0.039890055,0,0.07803337,-1.12780842,1.36533792,1.36533792,0.07803337,0,1,0,1
3830,16,231,10,50,60,1,1163.123,74,697.446,MORE,292,494,786,1,2,10,0.937408461,10,0.174607574,1.306308945,-1.122730169,110,50,60,0,-0.997251374,-1.170500555,-0.780333703,-1.12780842,0.780055707,0.780055707,-0.780333703,-1.170500555,1,0,1
3831,16,232,3,53,50,1,2011.25,54,1716.523,MORE,208,788,996,3,2,-3,-0.281222538,3,-1.047645444,0.188611452,-0.528058665,103,53,50,1,-1.136866566,-1.053450499,-1.170500555,0.260263481,0.664647947,0.664647947,-1.170500555,-1.053450499,0,1,1
3832,16,233,45,122,110,0,1789.399,74,1538.996,MORE,-488,1054,566,2,1,-12,-1.124890153,12,0.523822722,1.306308945,-0.683611392,232,122,110,1,1.436041979,1.638700776,1.170500555,-0.433772469,-0.291587782,0.291587782,1.170500555,1.638700776,1,0,0
3833,16,234,38,67,80,1,1387.178,64,1581.699,MORE,-268,896,628,1,1,13,1.218630999,13,0.698430296,0.747460199,-0.965632088,147,67,80,0,-0.259285357,-0.507216907,0,-1.12780842,0.010670638,0.010670638,0,-0.507216907,1,0,0
3834,16,235,38,80,67,0,1788.973,24,1520.412,MORE,-1388,1918,530,2,1,-13,-1.218630999,13,0.698430296,-1.487934788,-0.683910086,147,80,67,1,-0.259285357,0,-0.507216907,-0.433772469,-1.528099499,1.528099499,-0.507216907,0,0,0,0
3835,16,236,36,70,80,1,1354.686,44,1069.545,MORE,256,464,720,1,2,10,0.937408461,10,0.174607574,-0.370237295,-0.988414132,150,70,80,0,-0.199450275,-0.390166852,0,-1.12780842,0.730595238,0.730595238,0,-0.390166852,0,0,1
3836,16,237,45,110,122,0,1574.639,14,1738.907,MORE,-788,1250,462,2,1,12,1.124890153,12,0.523822722,-2.046783534,-0.834192204,232,110,122,0,1.436041979,1.170500555,1.638700776,-0.433772469,-0.703758354,0.703758354,1.638700776,1.170500555,0,0,0
3837,16,238,42,110,115,0,3036.334,54,1409.283,MORE,-440,1584,1144,3,2,5,0.46870423,5,-0.698430296,0.188611452,0.190687753,225,110,115,0,1.296426786,1.170500555,1.36558398,0.260263481,-0.22564049,0.22564049,1.36558398,1.170500555,0,1,0
3838,16,239,41,110,112,0,2535.757,14,692.268,MORE,-1300,1870,570,2,1,2,0.187481692,2,-1.222253018,-2.046783534,-0.160296094,222,110,112,0,1.236591704,1.170500555,1.248533925,-0.433772469,-1.407196132,1.407196132,1.248533925,1.170500555,0,1,0
3839,16,240,53,110,103,1,1278.781,44,1034.305,MORE,280,408,688,1,2,-7,-0.656185922,7,-0.349215148,-0.370237295,-1.041635572,213,110,103,1,1.057086457,1.170500555,0.897383758,-1.12780842,0.763568884,0.763568884,0.897383758,1.170500555,0,0,1
3840,17,1,49,110,131,1,5160.755,80,1884.758,MORE,82,2318,2400,5,2,21,1.968557767,21,2.095290887,0.77550228,-0.399699294,241,110,131,0,1.615547226,1.170500555,1.989850943,-0.146088959,-0.073665534,0.073665534,1.989850943,1.170500555,1,1,0
3841,17,2,13,47,50,1,5476.752,40,1548.726,MORE,-136,2394,2258,6,2,3,0.281222538,3,-1.047645444,-0.951834585,-0.311464421,97,47,50,0,-1.256536731,-1.28755061,-1.170500555,0.204524543,-0.25457901,0.25457901,-1.170500555,-1.28755061,0,1,0
3842,17,3,16,50,44,0,8795.442,30,1616.957,MORE,-2158,3992,1834,4,2,-6,-0.562445076,6,-0.523822722,-1.383668801,0.615203208,94,50,44,1,-1.316371814,-1.170500555,-1.404600665,-0.496702461,-1.932593003,1.932593003,-1.404600665,-1.170500555,0,0,0
3843,17,4,7,57,50,0,2722.045,80,1625.376,MORE,266,1298,1564,3,2,-7,-0.656185922,7,-0.349215148,0.77550228,-1.080652806,107,57,50,1,-1.057086457,-0.897383758,-1.170500555,-0.847315962,0.07903208,0.07903208,-1.170500555,-0.897383758,1,0,0
3844,17,5,18,42,50,1,2295.407,80,2449.336,MORE,1046,558,1604,2,2,8,0.749926769,8,-0.174607574,0.77550228,-1.199781626,92,42,50,0,-1.356261869,-1.482634036,-1.170500555,-1.197929464,0.726337181,0.726337181,-1.170500555,-1.482634036,1,0,1
3845,17,6,51,108,110,1,8504.661,80,1307.47,MORE,632,3302,3934,9,2,2,0.187481692,2,-1.222253018,0.77550228,0.534009321,218,108,110,0,1.156811594,1.092467184,1.170500555,1.256365048,0.382767551,0.382767551,1.170500555,1.092467184,1,1,1
3846,17,7,31,78,80,1,8819.823,80,1345.461,MORE,1678,2690,4368,9,2,2,0.187481692,2,-1.222253018,0.77550228,0.62201104,158,78,80,0,-0.039890055,-0.07803337,0,1.256365048,1.250820289,1.250820289,0,-0.07803337,1,1,1
3847,17,8,58,110,92,0,5062.996,80,2850.815,MORE,-846,2698,1852,6,2,-18,-1.687335229,18,1.571468165,0.77550228,-0.426996239,202,110,92,1,0.837691154,1.170500555,0.468200222,0.204524543,-0.843792628,0.843792628,0.468200222,1.170500555,1,1,0
3848,17,9,12,50,48,1,5747.128,80,1136.544,MORE,-154,2824,2670,6,2,-2,-0.187481692,2,-1.222253018,0.77550228,-0.23596816,98,50,48,1,-1.236591704,-1.170500555,-1.248533925,0.204524543,-0.269516821,0.269516821,-1.248533925,-1.170500555,1,1,0
3849,17,10,54,110,101,1,9253.138,20,1267.716,MORE,174,3948,4122,5,1,-9,-0.843667615,9,0,-1.815503017,0.743004258,211,110,101,1,1.017196402,1.170500555,0.819350388,-0.146088959,0.002683273,0.002683273,0.819350388,1.170500555,0,1,0
3850,17,11,14,46,50,1,4601.858,20,1119.638,MORE,1068,1642,2710,4,1,4,0.374963384,4,-0.87303787,-1.815503017,-0.555758389,96,46,50,0,-1.276481759,-1.326567295,-1.170500555,-0.496702461,0.744594505,0.744594505,-1.170500555,-1.326567295,0,0,1
3851,17,12,22,80,83,0,5596.897,20,2564.168,MORE,-1114,2706,1592,5,1,3,0.281222538,3,-1.047645444,-1.815503017,-0.277916701,163,80,83,0,0.059835082,0,0.117050055,-0.146088959,-1.066200022,1.066200022,0.117050055,0,0,1,0
3852,17,13,6,50,56,1,4091.185,70,1050.535,MORE,-106,1486,1380,3,2,6,0.562445076,6,-0.523822722,0.343668064,-0.698352044,106,50,56,0,-1.077031484,-1.170500555,-0.936400444,-0.847315962,-0.22968266,0.22968266,-0.936400444,-1.170500555,0,0,0
3853,17,14,13,50,47,0,6796.208,70,1497.38,MORE,-534,3028,2494,7,1,-3,-0.281222538,3,-1.047645444,0.343668064,0.056963231,97,50,47,1,-1.256536731,-1.170500555,-1.28755061,0.555138044,-0.584870588,0.584870588,-1.28755061,-1.170500555,0,1,0
3854,17,15,46,110,124,1,2675.749,90,988.718,MORE,696,946,1642,4,2,14,1.312371845,14,0.87303787,1.207336496,-1.093579896,234,110,124,0,1.475932034,1.170500555,1.716734147,-0.496702461,0.435879764,0.435879764,1.716734147,1.170500555,1,0,1
3855,17,16,27,91,80,0,5472.234,80,1868.926,MORE,1876,1790,3666,2,2,-11,-1.031149307,11,0.349215148,0.77550228,-0.312725968,171,91,80,1,0.219395302,0.429183537,0,-1.197929464,1.415136199,1.415136199,0,0.429183537,1,0,1
3856,17,17,40,64,80,1,8278.929,70,2005.083,MORE,-346,3628,3282,11,2,16,1.499853537,16,1.222253018,0.343668064,0.470978867,144,64,80,0,-0.31912044,-0.624266962,0,1.957592051,-0.428853461,0.428853461,0,-0.624266962,0,1,0
3857,17,18,22,83,80,1,11238.256,70,1323.144,MORE,228,4596,4824,8,2,-3,-0.281222538,3,-1.047645444,0.343668064,1.297302668,163,83,80,1,0.059835082,0.117050055,0,0.905751546,0.047496703,0.047496703,0,0.117050055,0,1,0
3858,17,19,54,101,110,1,14285.494,70,1643.864,MORE,206,6354,6560,14,2,9,0.843667615,9,0,0.343668064,2.148173587,211,101,110,0,1.017196402,0.819350388,1.170500555,3.009432556,0.02923938,0.02923938,1.170500555,0.819350388,1,1,0
3859,17,20,6,56,50,1,7703.028,30,782.259,MORE,-1750,4350,2600,6,2,-6,-0.562445076,6,-0.523822722,-1.383668801,0.310171798,106,56,50,1,-1.077031484,-0.936400444,-1.170500555,0.204524543,-1.594002643,1.594002643,-1.170500555,-0.936400444,0,1,0
3860,17,21,18,50,42,0,10331.197,30,1680.224,MORE,-932,4560,3628,8,1,-8,-0.749926769,8,-0.174607574,-1.383668801,1.044027366,92,50,42,1,-1.356261869,-1.170500555,-1.482634036,0.905751546,-0.915162165,0.915162165,-1.482634036,-1.170500555,0,1,0
3861,17,22,43,110,117,0,18416.96,20,1521.788,MORE,1282,6606,7888,8,1,7,0.656185922,7,-0.349215148,-1.815503017,3.301790165,227,110,117,0,1.336316841,1.170500555,1.443617351,0.905751546,0.922188468,0.922188468,1.443617351,1.170500555,0,1,1
3862,17,23,32,77,80,0,2657.793,20,2684.021,MORE,524,1602,2126,1,1,3,0.281222538,3,-1.047645444,-1.815503017,-1.098593695,157,77,80,0,-0.059835082,-0.117050055,0,-1.548542966,0.29314069,0.29314069,0,-0.117050055,0,0,1
3863,17,24,27,80,91,1,8402.476,80,1094.052,MORE,662,3522,4184,4,2,11,1.031149307,11,0.349215148,0.77550228,0.505476517,171,80,91,0,0.219395302,0,0.429183537,-0.496702461,0.407663901,0.407663901,0.429183537,0,1,0,1
3864,17,25,16,44,50,1,3144.345,80,1614.294,MORE,1316,1174,2490,4,2,6,0.562445076,6,-0.523822722,0.77550228,-0.962735273,94,44,50,0,-1.316371814,-1.404600665,-1.170500555,-0.496702461,0.950404332,0.950404332,-1.170500555,-1.404600665,1,0,1
3865,17,26,7,50,57,1,3045.078,80,1771.57,MORE,1748,1078,2826,4,2,7,0.656185922,7,-0.349215148,0.77550228,-0.990453293,107,50,57,0,-1.057086457,-1.170500555,-0.897383758,-0.496702461,1.308911772,1.308911772,-0.897383758,-1.170500555,1,0,1
3866,17,27,14,50,46,1,10122.536,30,1838.598,MORE,-580,4790,4210,8,2,-4,-0.374963384,4,-0.87303787,-1.383668801,0.985763595,96,50,46,1,-1.276481759,-1.170500555,-1.326567295,0.905751546,-0.623044991,0.623044991,-1.326567295,-1.170500555,0,1,0
3867,17,28,51,110,108,0,5818.096,70,983.345,MORE,1228,2066,3294,4,2,-2,-0.187481692,2,-1.222253018,0.343668064,-0.216151983,218,110,108,1,1.156811594,1.170500555,1.092467184,-0.496702461,0.877375038,0.877375038,1.092467184,1.170500555,0,0,1
3868,17,29,50,133,110,0,5373.225,90,2144.134,MORE,3134,1670,4804,3,2,-23,-2.15603946,23,2.444506035,1.207336496,-0.340371947,243,133,110,1,1.655437281,2.067884313,1.170500555,-0.847315962,2.459123144,2.459123144,1.170500555,2.067884313,1,0,1
3869,17,30,49,131,110,0,6580.386,90,1268.242,MORE,372,3086,3458,4,2,-21,-1.968557767,21,2.095290887,1.207336496,-0.003300084,241,131,110,1,1.615547226,1.989850943,1.170500555,-0.496702461,0.166999184,0.166999184,1.170500555,1.989850943,1,0,1
3870,17,31,47,126,110,0,5049.907,30,1670.858,MORE,808,2014,2822,3,1,-16,-1.499853537,16,1.222253018,-1.383668801,-0.430651041,236,126,110,1,1.515822089,1.794767517,1.170500555,-0.847315962,0.528826138,0.528826138,1.170500555,1.794767517,0,0,1
3871,17,32,50,110,133,1,10371.513,60,1128.029,MORE,-42,3592,3550,4,2,23,2.15603946,23,2.444506035,-0.088166152,1.055284679,243,110,133,0,1.655437281,1.170500555,2.067884313,-0.496702461,-0.176570447,0.176570447,2.067884313,1.170500555,0,0,0
3872,17,33,47,110,126,1,4922.645,80,2176.956,MORE,-178,2510,2332,3,2,16,1.499853537,16,1.222253018,0.77550228,-0.466186019,236,110,126,0,1.515822089,1.170500555,1.794767517,-0.847315962,-0.289433901,0.289433901,1.794767517,1.170500555,1,0,0
3873,17,34,12,48,50,0,4311.127,80,1147.108,MORE,-248,1890,1642,4,2,2,0.187481692,2,-1.222253018,0.77550228,-0.636938314,98,48,50,0,-1.236591704,-1.248533925,-1.170500555,-0.496702461,-0.347525384,0.347525384,-1.170500555,-1.248533925,1,0,0
3874,17,35,32,80,77,0,10980.744,20,1370.905,MORE,976,3070,4046,4,1,-3,-0.281222538,3,-1.047645444,-1.815503017,1.225398382,157,80,77,1,-0.059835082,0,-0.117050055,-0.496702461,0.668245698,0.668245698,-0.117050055,0,0,0,1
3875,17,36,43,117,110,0,6566.471,20,1974.558,MORE,576,2600,3176,4,1,-7,-0.656185922,7,-0.349215148,-1.815503017,-0.007185527,227,117,110,1,1.336316841,1.443617351,1.170500555,-0.496702461,0.336294364,0.336294364,1.170500555,1.443617351,0,0,1
3876,17,37,40,80,64,0,3874.463,70,2369.292,MORE,184,1826,2010,5,2,-16,-1.499853537,16,1.222253018,0.343668064,-0.758866663,144,80,64,1,-0.31912044,0,-0.624266962,-0.146088959,0.010982057,0.010982057,-0.624266962,0,1,1,0
3877,17,38,31,80,78,1,13264.296,70,1536.309,MORE,1392,4306,5698,9,2,-2,-0.187481692,2,-1.222253018,0.343668064,1.863027602,158,80,78,1,-0.039890055,0,-0.07803337,1.256365048,1.013475085,1.013475085,-0.07803337,0,1,1,1
3878,17,39,46,124,110,0,7431.411,20,1374.023,MORE,110,3128,3238,7,1,-14,-1.312371845,14,0.87303787,-1.815503017,0.234329016,234,124,110,1,1.475932034,1.716734147,1.170500555,0.555138044,-0.05042894,0.05042894,1.170500555,1.716734147,0,1,0
3879,17,40,58,92,110,1,8552.089,70,927.765,MORE,554,2674,3228,4,1,18,1.687335229,18,1.571468165,0.343668064,0.547252496,202,92,110,0,0.837691154,0.468200222,1.170500555,-0.496702461,0.31803704,0.31803704,1.170500555,0.468200222,1,0,1
3880,17,41,49,110,131,0,2444.521,80,1244.207,LESS,-104,1272,1168,3,2,21,1.968557767,21,2.095290887,0.77550228,-1.158144981,241,110,131,1,1.615547226,1.170500555,1.989850943,-0.847315962,-0.228022904,0.228022904,1.989850943,1.170500555,1,0,0
3881,17,42,13,47,50,1,4629.874,60,1351.708,LESS,552,1914,2466,6,2,3,0.281222538,3,-1.047645444,-0.088166152,-0.547935567,97,47,50,1,-1.256536731,-1.28755061,-1.170500555,0.204524543,0.316377284,0.316377284,-1.170500555,-1.28755061,0,1,1
3882,17,43,16,50,44,0,6612.573,20,3609.292,LESS,-3020,4828,1808,5,1,-6,-0.562445076,6,-0.523822722,-1.815503017,0.005687393,94,50,44,0,-1.316371814,-1.170500555,-1.404600665,-0.146088959,-2.647948128,2.647948128,-1.404600665,-1.170500555,0,0,0
3883,17,44,7,57,50,1,5829.472,60,1234.469,LESS,1068,2142,3210,6,2,-7,-0.656185922,7,-0.349215148,-0.088166152,-0.212975497,107,57,50,0,-1.057086457,-0.897383758,-1.170500555,0.204524543,0.744594505,0.744594505,-1.170500555,-0.897383758,0,1,1
3884,17,45,18,42,50,0,2945.771,90,1654.55,LESS,396,1502,1898,3,2,8,0.749926769,8,-0.174607574,1.207336496,-1.018182482,92,42,50,1,-1.356261869,-1.482634036,-1.170500555,-0.847315962,0.186916264,0.186916264,-1.170500555,-1.482634036,1,0,1
3885,17,46,51,108,110,1,7390.815,30,1948.695,LESS,180,3300,3480,11,1,2,0.187481692,2,-1.222253018,-1.383668801,0.222993519,218,108,110,1,1.156811594,1.092467184,1.170500555,1.957592051,0.007662543,0.007662543,1.170500555,1.092467184,0,1,1
3886,17,47,31,78,80,0,3348.937,70,1013.522,LESS,-246,1722,1476,5,2,2,0.187481692,2,-1.222253018,0.343668064,-0.905607676,158,78,80,1,-0.039890055,-0.07803337,0,-0.146088959,-0.345865627,0.345865627,0,-0.07803337,1,1,0
3887,17,48,58,110,92,1,10930.143,30,1119.618,LESS,-660,5354,4694,8,1,-18,-1.687335229,18,1.571468165,-1.383668801,1.21126922,202,110,92,0,0.837691154,1.170500555,0.468200222,0.905751546,-0.689435258,0.689435258,0.468200222,1.170500555,0,1,0
3888,17,49,12,50,48,0,4471.189,70,2105.744,LESS,-486,2650,2164,3,1,-2,-0.187481692,2,-1.222253018,0.343668064,-0.592244693,98,50,48,0,-1.236591704,-1.170500555,-1.248533925,-0.847315962,-0.545036428,0.545036428,-1.248533925,-1.170500555,1,0,0
3889,17,50,54,110,101,1,3547.778,30,1934.032,LESS,-104,1594,1490,5,1,-9,-0.843667615,9,0,-1.383668801,-0.850085914,211,110,101,0,1.017196402,1.170500555,0.819350388,-0.146088959,-0.228022904,0.228022904,0.819350388,1.170500555,0,1,0
3890,17,51,14,46,50,0,2703.865,30,1833.302,LESS,-770,1892,1122,3,1,4,0.374963384,4,-0.87303787,-1.383668801,-1.085729152,96,46,50,1,-1.276481759,-1.326567295,-1.170500555,-0.847315962,-0.780721875,0.780721875,-1.170500555,-1.326567295,0,0,0
3891,17,52,22,80,83,0,8335.483,60,2142.302,LESS,-1836,4668,2832,5,1,3,0.281222538,3,-1.047645444,-0.088166152,0.486770267,163,80,83,1,0.059835082,0,0.117050055,-0.146088959,-1.66537218,1.66537218,0.117050055,0,0,1,0
3892,17,53,6,50,56,0,8974.254,70,1685.04,LESS,-1694,4390,2696,10,2,6,0.562445076,6,-0.523822722,0.343668064,0.665132334,106,50,56,1,-1.077031484,-1.170500555,-0.936400444,1.606978549,-1.547529456,1.547529456,-0.936400444,-1.170500555,1,1,0
3893,17,54,13,50,47,0,7330.768,60,1123.613,LESS,178,2740,2918,4,1,-3,-0.281222538,3,-1.047645444,-0.088166152,0.20622678,97,50,47,0,-1.256536731,-1.170500555,-1.28755061,-0.496702461,0.006002787,0.006002787,-1.28755061,-1.170500555,0,0,1
3894,17,55,46,110,124,0,3614.821,70,795.244,LESS,-482,1748,1266,3,2,14,1.312371845,14,0.87303787,0.343668064,-0.831365702,234,110,124,1,1.475932034,1.170500555,1.716734147,-0.847315962,-0.541716914,0.541716914,1.716734147,1.170500555,1,0,0
3895,17,56,27,91,80,1,2288.655,70,724.628,LESS,-88,826,738,4,2,-11,-1.031149307,11,0.349215148,0.343668064,-1.201666967,171,91,80,0,0.219395302,0.429183537,0,-0.496702461,-0.21474485,0.21474485,0,0.429183537,1,0,0
3896,17,57,40,64,80,0,2827.265,10,2060.319,LESS,-1700,2580,880,3,1,16,1.499853537,16,1.222253018,-2.247337233,-1.051272548,144,64,80,1,-0.31912044,-0.624266962,0,-0.847315962,-1.552508726,1.552508726,0,-0.624266962,0,0,0
3897,17,58,22,83,80,1,5201.602,20,1069.843,LESS,108,2046,2154,5,2,-3,-0.281222538,3,-1.047645444,-1.815503017,-0.388293711,163,83,80,0,0.059835082,0.117050055,0,-0.146088959,-0.052088697,0.052088697,0,0.117050055,0,0,0
3898,17,59,54,101,110,1,4749.154,30,1901.504,LESS,520,1680,2200,3,2,9,0.843667615,9,0,-1.383668801,-0.514629378,211,101,110,1,1.017196402,0.819350388,1.170500555,-0.847315962,0.289821177,0.289821177,1.170500555,0.819350388,0,0,1
3899,17,60,6,56,50,0,7701.936,60,1289.502,LESS,-3462,3904,442,5,1,-6,-0.562445076,6,-0.523822722,-0.088166152,0.309866882,106,56,50,0,-1.077031484,-0.936400444,-1.170500555,-0.146088959,-3.014754352,3.014754352,-1.170500555,-0.936400444,0,1,0
3900,17,61,18,50,42,1,6227.031,90,1618.423,LESS,102,2138,2240,5,2,-8,-0.749926769,8,-0.174607574,1.207336496,-0.101966317,92,50,42,0,-1.356261869,-1.170500555,-1.482634036,-0.146088959,-0.057067967,0.057067967,-1.482634036,-1.170500555,1,1,0
3901,17,62,43,110,117,1,12798.777,10,1692.656,LESS,-354,5554,5200,9,1,7,0.656185922,7,-0.349215148,-2.247337233,1.73304216,227,110,117,1,1.336316841,1.170500555,1.443617351,1.256365048,-0.435492487,0.435492487,1.443617351,1.170500555,0,1,0
3902,17,63,32,77,80,0,8515.495,10,1727.946,LESS,-2788,4570,1782,6,1,3,0.281222538,3,-1.047645444,-2.247337233,0.537034466,157,77,80,1,-0.059835082,-0.117050055,0,0.204524543,-2.455416354,2.455416354,0,-0.117050055,0,1,0
3903,17,64,27,80,91,0,4721.237,90,1851.284,LESS,2082,1574,3656,3,2,11,1.031149307,11,0.349215148,1.207336496,-0.522424557,171,80,91,1,0.219395302,0,0.429183537,-0.847315962,1.586091136,1.586091136,0.429183537,0,1,0,1
3904,17,65,16,44,50,0,13318.478,70,2231.031,LESS,-1794,4438,2644,7,2,6,0.562445076,6,-0.523822722,0.343668064,1.878156676,94,44,50,1,-1.316371814,-1.404600665,-1.170500555,0.555138044,-1.630517289,1.630517289,-1.170500555,-1.404600665,1,1,0
3905,17,66,7,50,57,1,12227.114,80,771.887,LESS,-1434,4540,3106,9,2,7,0.656185922,7,-0.349215148,0.77550228,1.573418454,107,50,57,1,-1.057086457,-1.170500555,-0.897383758,1.256365048,-1.331761089,1.331761089,-0.897383758,-1.170500555,1,1,0
3906,17,67,14,50,46,1,10870.699,30,1620.168,LESS,252,3902,4154,8,1,-4,-0.374963384,4,-0.87303787,-1.383668801,1.194670854,96,50,46,0,-1.276481759,-1.170500555,-1.326567295,0.905751546,0.067413783,0.067413783,-1.326567295,-1.170500555,0,1,1
3907,17,68,51,110,108,0,5250.707,10,1792.364,LESS,-1052,3126,2074,5,1,-2,-0.187481692,2,-1.222253018,-2.247337233,-0.374582273,218,110,108,0,1.156811594,1.170500555,1.092467184,-0.146088959,-1.014747565,1.014747565,1.092467184,1.170500555,0,1,0
3908,17,69,50,133,110,1,7656.267,80,1867.646,LESS,-878,3084,2206,4,2,-23,-2.15603946,23,2.444506035,0.77550228,0.297114867,243,133,110,0,1.655437281,2.067884313,1.170500555,-0.496702461,-0.870348735,0.870348735,1.170500555,2.067884313,1,0,0
3909,17,70,49,131,110,1,5846.14,70,1602.484,LESS,70,2396,2466,6,2,-21,-1.968557767,21,2.095290887,0.343668064,-0.208321343,241,131,110,0,1.615547226,1.989850943,1.170500555,0.204524543,-0.083624074,0.083624074,1.170500555,1.989850943,1,1,0
3910,17,71,47,126,110,1,4033.852,60,1736.725,LESS,-572,1840,1268,4,1,-16,-1.499853537,16,1.222253018,-0.088166152,-0.714360962,236,126,110,0,1.515822089,1.794767517,1.170500555,-0.496702461,-0.616405964,0.616405964,1.170500555,1.794767517,0,0,0
3911,17,72,50,110,133,0,8756.368,30,1186.447,LESS,2140,2652,4792,2,1,23,2.15603946,23,2.444506035,-1.383668801,0.604292695,243,110,133,1,1.655437281,1.170500555,2.067884313,-1.197929464,1.634224079,1.634224079,2.067884313,1.170500555,0,0,1
3912,17,73,47,110,126,0,13434.458,70,2018.805,LESS,-1956,5506,3550,8,2,16,1.499853537,16,1.222253018,0.343668064,1.910541416,236,110,126,1,1.515822089,1.170500555,1.794767517,0.905751546,-1.76495758,1.76495758,1.794767517,1.170500555,1,1,0
3913,17,74,12,48,50,1,8655.99,30,1945.724,LESS,-2270,4008,1738,7,2,2,0.187481692,2,-1.222253018,-1.383668801,0.576264454,98,48,50,1,-1.236591704,-1.248533925,-1.170500555,0.555138044,-2.025539377,2.025539377,-1.170500555,-1.248533925,0,1,0
3914,17,75,32,80,77,1,8542.576,20,1106.427,LESS,690,3384,4074,8,2,-3,-0.281222538,3,-1.047645444,-1.815503017,0.54459621,157,80,77,0,-0.059835082,0,-0.117050055,0.905751546,0.430900494,0.430900494,-0.117050055,0,0,1,1
3915,17,76,43,117,110,0,6812.149,10,1832.587,LESS,-3804,4964,1160,5,1,-7,-0.656185922,7,-0.349215148,-2.247337233,0.061414387,227,117,110,0,1.336316841,1.443617351,1.170500555,-0.146088959,-3.298572742,3.298572742,1.170500555,1.443617351,0,1,0
3916,17,77,40,80,64,1,2079.317,100,2612.246,LESS,1592,596,2188,1,2,-16,-1.499853537,16,1.222253018,1.639170712,-1.260119774,144,80,64,0,-0.31912044,0,-0.624266962,-1.548542966,1.179450752,1.179450752,-0.624266962,0,1,0,1
3917,17,78,31,80,78,0,12903.296,30,1718.31,LESS,-1260,5638,4378,10,1,-2,-0.187481692,2,-1.222253018,-1.383668801,1.76222668,158,80,78,0,-0.039890055,0,-0.07803337,1.606978549,-1.187362259,1.187362259,-0.07803337,0,0,1,0
3918,17,79,46,124,110,1,4904.169,30,1800.018,LESS,1098,1614,2712,6,2,-14,-1.312371845,14,0.87303787,-1.383668801,-0.471345015,234,124,110,0,1.475932034,1.716734147,1.170500555,0.204524543,0.769490855,0.769490855,1.170500555,1.716734147,0,1,1
3919,17,80,58,92,110,0,3006.609,70,1382.53,LESS,-1334,1872,538,2,1,18,1.687335229,18,1.571468165,0.343668064,-1.001194873,202,92,110,1,0.837691154,0.468200222,1.170500555,-1.197929464,-1.248773256,1.248773256,1.170500555,0.468200222,1,0,0
3920,17,81,48,128,110,0,8105.937,70,1989.411,MORE,-1794,4766,2972,5,2,-18,-1.687335229,18,1.571468165,0.343668064,0.422674842,238,128,110,1,1.555712144,1.872800887,1.170500555,-0.146088959,-1.630517289,1.630517289,1.170500555,1.872800887,1,1,0
3921,17,82,8,50,58,0,6189.041,70,1383.456,MORE,-834,3252,2418,9,2,8,0.749926769,8,-0.174607574,0.343668064,-0.112574148,108,50,58,0,-1.037141429,-1.170500555,-0.858367073,1.256365048,-0.833834088,0.833834088,-0.858367073,-1.170500555,1,1,0
3922,17,83,4,54,50,0,7687.597,70,1853.206,MORE,-410,3574,3164,13,2,-4,-0.374963384,4,-0.87303787,0.343668064,0.305863047,104,54,50,1,-1.116921539,-1.014433814,-1.170500555,2.658819054,-0.481965674,0.481965674,-1.170500555,-1.014433814,1,1,0
3923,17,84,37,80,69,1,9285.34,30,1950.352,MORE,-2066,5498,3432,10,1,-11,-1.031149307,11,0.349215148,-1.383668801,0.751995924,149,80,69,1,-0.219395302,0,-0.429183537,1.606978549,-1.856244197,1.856244197,-0.429183537,0,0,1,0
3924,17,85,52,105,110,1,5532.585,70,2174.53,MORE,1100,2222,3322,7,2,5,0.46870423,5,-0.698430296,0.343668064,-0.295874343,215,105,110,0,1.096976512,0.975417129,1.170500555,0.555138044,0.771150611,0.771150611,1.170500555,0.975417129,1,1,1
3925,17,86,5,55,50,0,13944.792,70,1046.618,MORE,-1520,6540,5020,13,2,-5,-0.46870423,5,-0.698430296,0.343668064,2.053040413,105,55,50,1,-1.096976512,-0.975417129,-1.170500555,2.658819054,-1.403130626,1.403130626,-1.170500555,-0.975417129,1,1,0
3926,17,87,30,96,80,0,2445.729,70,908.982,MORE,1388,534,1922,2,2,-16,-1.499853537,16,1.222253018,0.343668064,-1.157807675,176,96,80,1,0.31912044,0.624266962,0,-1.197929464,1.010155572,1.010155572,0,0.624266962,1,0,1
3927,17,88,33,80,75,0,4590.124,70,1298.36,MORE,-608,2442,1834,5,2,-5,-0.46870423,5,-0.698430296,0.343668064,-0.559034837,155,80,75,1,-0.099725137,0,-0.195083426,-0.146088959,-0.646281584,0.646281584,-0.195083426,0,1,1,0
3928,17,89,48,110,128,1,8380.514,70,1765.172,MORE,-830,4236,3406,5,2,18,1.687335229,18,1.571468165,0.343668064,0.499344135,238,110,128,0,1.555712144,1.170500555,1.872800887,-0.146088959,-0.830514575,0.830514575,1.872800887,1.170500555,1,1,0
3929,17,90,9,59,50,0,3432.429,30,1569.177,MORE,-190,1654,1464,5,1,-9,-0.843667615,9,0,-1.383668801,-0.882294461,109,59,50,1,-1.017196402,-0.819350388,-1.170500555,-0.146088959,-0.299392441,0.299392441,-1.170500555,-0.819350388,0,1,0
3930,17,91,44,110,119,1,3722.621,70,1174.496,MORE,928,1214,2142,6,2,9,0.843667615,9,0,0.343668064,-0.801265039,229,110,119,0,1.376206896,1.170500555,1.521650721,0.204524543,0.628411538,0.628411538,1.521650721,1.170500555,1,1,1
3931,17,92,2,52,50,0,2249.913,80,909.602,MORE,190,1106,1296,3,2,-2,-0.187481692,2,-1.222253018,0.77550228,-1.212484776,102,52,50,1,-1.156811594,-1.092467184,-1.170500555,-0.847315962,0.015961327,0.015961327,-1.170500555,-1.092467184,1,0,0
3932,17,93,8,58,50,0,5482.09,70,1298.126,MORE,700,2210,2910,5,2,-8,-0.749926769,8,-0.174607574,0.343668064,-0.309973907,108,58,50,1,-1.037141429,-0.858367073,-1.170500555,-0.146088959,0.439199277,0.439199277,-1.170500555,-0.858367073,1,1,1
3933,17,94,44,119,110,0,3675.066,70,1913.276,MORE,678,1326,2004,3,1,-9,-0.843667615,9,0,0.343668064,-0.814543676,229,119,110,1,1.376206896,1.521650721,1.170500555,-0.847315962,0.420941954,0.420941954,1.170500555,1.521650721,0,0,1
3934,17,95,34,74,80,1,6204.276,40,1487.664,MORE,428,2316,2744,6,2,6,0.562445076,6,-0.523822722,-0.951834585,-0.108320126,154,74,80,0,-0.119670165,-0.234100111,0,0.204524543,0.21347237,0.21347237,0,-0.234100111,0,1,1
3935,17,96,24,86,80,0,7792.313,70,2540.591,MORE,-984,3970,2986,10,2,-6,-0.562445076,6,-0.523822722,0.343668064,0.335102574,166,86,80,1,0.119670165,0.234100111,0,1.606978549,-0.958315838,0.958315838,0,0.234100111,0,1,0
3936,17,97,39,66,80,1,6074.708,80,1998.812,MORE,232,1932,2164,5,2,14,1.312371845,14,0.87303787,0.77550228,-0.144499001,146,66,80,0,-0.279230385,-0.546233592,0,-0.146088959,0.050816217,0.050816217,0,-0.546233592,1,1,0
3937,17,98,9,50,59,0,4961.477,70,1955.29,MORE,798,1762,2560,5,1,9,0.843667615,9,0,0.343668064,-0.455343078,109,50,59,0,-1.017196402,-1.170500555,-0.819350388,-0.146088959,0.520527354,0.520527354,-0.819350388,-1.170500555,0,1,1
3938,17,99,57,94,110,1,2630.567,100,2650.241,MORE,722,1024,1746,2,2,16,1.499853537,16,1.222253018,1.639170712,-1.106195928,204,94,110,0,0.877581209,0.546233592,1.170500555,-1.197929464,0.457456601,0.457456601,1.170500555,0.546233592,1,0,1
3939,17,100,60,110,87,0,7520.661,80,1592.465,MORE,966,2642,3608,5,2,-23,-2.15603946,23,2.444506035,0.77550228,0.25925002,197,110,87,1,0.737966017,1.170500555,0.273116796,-0.146088959,0.659946914,0.659946914,0.273116796,1.170500555,1,1,1
3940,17,101,33,75,80,0,8540.538,20,1277.149,MORE,-388,3948,3560,12,1,5,0.46870423,5,-0.698430296,-1.815503017,0.544027146,155,75,80,0,-0.099725137,-0.195083426,0,2.308205553,-0.463708351,0.463708351,0,-0.195083426,0,1,0
3941,17,102,15,50,45,0,5538.106,70,1645.798,MORE,232,2152,2384,6,2,-5,-0.46870423,5,-0.698430296,0.343668064,-0.294332731,95,50,45,1,-1.296426786,-1.170500555,-1.36558398,0.204524543,0.050816217,0.050816217,-1.36558398,-1.170500555,0,1,0
3942,17,103,59,89,110,1,11191.67,70,2168.697,MORE,2794,3080,5874,9,2,21,1.968557767,21,2.095290887,0.343668064,1.284294602,199,89,110,0,0.777856072,0.351150166,1.170500555,1.256365048,2.17696451,2.17696451,1.170500555,0.351150166,0,1,1
3943,17,104,29,80,94,1,3857.111,70,1810.016,MORE,420,1478,1898,4,2,14,1.312371845,14,0.87303787,0.343668064,-0.763711809,174,80,94,0,0.279230385,0,0.546233592,-0.496702461,0.206833344,0.206833344,0.546233592,0,0,0,1
3944,17,105,55,110,98,1,5781.801,90,1393.902,MORE,316,2638,2954,4,2,-12,-1.124890153,12,0.523822722,1.207336496,-0.226286524,208,110,98,1,0.957361319,1.170500555,0.702300333,-0.496702461,0.120525997,0.120525997,0.702300333,1.170500555,1,0,1
3945,17,106,29,94,80,0,3470.306,80,1430.703,MORE,-456,1894,1438,3,2,-14,-1.312371845,14,0.87303787,0.77550228,-0.871718183,174,94,80,1,0.279230385,0.546233592,0,-0.847315962,-0.520140078,0.520140078,0,0.546233592,1,0,0
3946,17,107,57,110,94,0,6867.006,80,2753.246,MORE,1876,2554,4430,7,2,-16,-1.499853537,16,1.222253018,0.77550228,0.076731939,204,110,94,1,0.877581209,1.170500555,0.546233592,0.555138044,1.415136199,1.415136199,0.546233592,1.170500555,1,1,1
3947,17,108,39,80,66,1,10484.592,30,2767.49,MORE,296,4806,5102,11,2,-14,-1.312371845,14,0.87303787,-1.383668801,1.086859381,146,80,66,1,-0.279230385,0,-0.546233592,1.957592051,0.10392843,0.10392843,-0.546233592,0,0,1,1
3948,17,109,4,50,54,1,6690.687,80,2090.133,MORE,1916,2254,4170,7,2,4,0.374963384,4,-0.87303787,0.77550228,0.027498926,104,50,54,0,-1.116921539,-1.170500555,-1.014433814,0.555138044,1.448331332,1.448331332,-1.014433814,-1.170500555,1,1,1
3949,17,110,55,98,110,1,3292.039,90,1178.069,MORE,-182,1742,1560,3,2,12,1.124890153,12,0.523822722,1.207336496,-0.92149513,208,98,110,0,0.957361319,0.702300333,1.170500555,-0.847315962,-0.292753414,0.292753414,1.170500555,0.702300333,1,0,0
3950,17,111,2,50,52,0,5662.382,30,975.951,MORE,-842,2828,1986,5,1,2,0.187481692,2,-1.222253018,-1.383668801,-0.259631525,102,50,52,0,-1.156811594,-1.170500555,-1.092467184,-0.146088959,-0.840473115,0.840473115,-1.092467184,-1.170500555,0,0,0
3951,17,112,59,110,89,0,2884.823,70,1513.162,MORE,256,890,1146,3,2,-21,-1.968557767,21,2.095290887,0.343668064,-1.035200805,199,110,89,1,0.777856072,1.170500555,0.351150166,-0.847315962,0.070733297,0.070733297,0.351150166,1.170500555,0,0,0
3952,17,113,60,87,110,1,12863.287,30,2034.216,MORE,3704,3592,7296,9,2,23,2.15603946,23,2.444506035,-1.383668801,1.751055089,197,87,110,0,0.737966017,0.273116796,1.170500555,1.256365048,2.932153795,2.932153795,1.170500555,0.273116796,0,1,1
3953,17,114,52,110,105,0,13077.122,30,1520.921,MORE,-944,6158,5214,15,1,-5,-0.46870423,5,-0.698430296,-1.383668801,1.81076358,215,110,105,1,1.096976512,1.170500555,0.975417129,3.360046058,-0.925120705,0.925120705,0.975417129,1.170500555,0,1,0
3954,17,115,30,80,96,1,2517.831,90,1790.625,MORE,806,738,1544,2,2,16,1.499853537,16,1.222253018,1.207336496,-1.137674855,176,80,96,0,0.31912044,0,0.624266962,-1.197929464,0.527166381,0.527166381,0.624266962,0,1,0,1
3955,17,116,24,80,86,1,5439.782,80,1337.69,MORE,356,2496,2852,2,2,6,0.562445076,6,-0.523822722,0.77550228,-0.32178744,166,80,86,0,0.119670165,0,0.234100111,-1.197929464,0.15372113,0.15372113,0.234100111,0,1,0,1
3956,17,117,5,50,55,1,9844.08,60,941.09,MORE,-976,3448,2472,5,2,5,0.46870423,5,-0.698430296,-0.088166152,0.90801118,105,50,55,0,-1.096976512,-1.170500555,-0.975417129,-0.146088959,-0.951676812,0.951676812,-0.975417129,-1.170500555,0,0,0
3957,17,118,34,80,74,0,3222.062,70,930.497,MORE,-720,1714,994,3,1,-6,-0.562445076,6,-0.523822722,0.343668064,-0.941034593,154,80,74,1,-0.119670165,0,-0.234100111,-0.847315962,-0.739227958,0.739227958,-0.234100111,0,0,0,0
3958,17,119,15,45,50,1,10498.829,40,1601.188,MORE,-3764,5498,1734,5,2,5,0.46870423,5,-0.698430296,-0.951834585,1.090834735,95,45,50,0,-1.296426786,-1.36558398,-1.170500555,-0.146088959,-3.265377609,3.265377609,-1.170500555,-1.36558398,0,0,0
3959,17,120,37,69,80,1,8477.369,70,1620.5,MORE,2214,2894,5108,6,2,11,1.031149307,11,0.349215148,0.343668064,0.52638866,149,69,80,0,-0.219395302,-0.429183537,0,0.204524543,1.695635076,1.695635076,0,-0.429183537,0,1,1
3960,17,121,48,128,110,1,5271.764,70,2117.242,LESS,1102,1868,2970,6,2,-18,-1.687335229,18,1.571468165,0.343668064,-0.368702591,238,128,110,0,1.555712144,1.872800887,1.170500555,0.204524543,0.772810368,0.772810368,1.170500555,1.872800887,1,1,1
3961,17,122,8,50,58,0,4316.538,70,1317.454,LESS,130,1732,1862,5,1,8,0.749926769,8,-0.174607574,0.343668064,-0.635427417,108,50,58,1,-1.037141429,-1.170500555,-0.858367073,-0.146088959,-0.033831373,0.033831373,-0.858367073,-1.170500555,1,1,1
3962,17,123,4,54,50,1,12920.204,60,2214.647,LESS,700,5192,5892,11,1,-4,-0.374963384,4,-0.87303787,-0.088166152,1.766947849,104,54,50,0,-1.116921539,-1.014433814,-1.170500555,1.957592051,0.439199277,0.439199277,-1.170500555,-1.014433814,0,1,1
3963,17,124,37,80,69,1,6095.05,80,2072.271,LESS,2652,1520,4172,6,2,-11,-1.031149307,11,0.349215148,0.77550228,-0.138818967,149,80,69,0,-0.219395302,0,-0.429183537,0.204524543,2.059121787,2.059121787,-0.429183537,0,1,1,1
3964,17,125,52,105,110,0,4053.583,80,2413.638,LESS,-144,2036,1892,5,2,5,0.46870423,5,-0.698430296,0.77550228,-0.708851535,215,105,110,1,1.096976512,0.975417129,1.170500555,-0.146088959,-0.261218037,0.261218037,1.170500555,0.975417129,1,1,0
3965,17,126,5,55,50,1,3514.554,70,2280.619,LESS,1714,1002,2716,4,2,-5,-0.46870423,5,-0.698430296,0.343668064,-0.859362949,105,55,50,0,-1.096976512,-0.975417129,-1.170500555,-0.496702461,1.280695909,1.280695909,-1.170500555,-0.975417129,1,0,1
3966,17,127,30,96,80,1,12553.764,70,1862.331,LESS,752,5156,5908,14,2,-16,-1.499853537,16,1.222253018,0.343668064,1.664627932,176,96,80,0,0.31912044,0.624266962,0,3.009432556,0.482352951,0.482352951,0,0.624266962,1,1,1
3967,17,128,33,80,75,0,8568.648,80,1179.063,LESS,526,3498,4024,5,2,-5,-0.46870423,5,-0.698430296,0.77550228,0.551876215,155,80,75,0,-0.099725137,0,-0.195083426,-0.146088959,0.294800447,0.294800447,-0.195083426,0,1,1,1
3968,17,129,48,110,128,0,8922.804,70,1348.375,LESS,964,2676,3640,5,2,18,1.687335229,18,1.571468165,0.343668064,0.650766109,238,110,128,1,1.555712144,1.170500555,1.872800887,-0.146088959,0.658287158,0.658287158,1.872800887,1.170500555,1,1,1
3969,17,130,9,59,50,1,2577.67,90,1152.504,LESS,1652,560,2212,2,2,-9,-0.843667615,9,0,1.207336496,-1.120966195,109,59,50,0,-1.017196402,-0.819350388,-1.170500555,-1.197929464,1.229243452,1.229243452,-1.170500555,-0.819350388,1,0,1
3970,17,131,44,110,119,1,5706.84,70,1008.563,LESS,380,2192,2572,5,2,9,0.843667615,9,0,0.343668064,-0.247217654,229,110,119,1,1.376206896,1.170500555,1.521650721,-0.146088959,0.17363821,0.17363821,1.521650721,1.170500555,1,1,1
3971,17,132,2,52,50,0,8982.118,40,1682.722,LESS,-3630,5750,2120,4,1,-2,-0.187481692,2,-1.222253018,-0.951834585,0.667328175,102,52,50,0,-1.156811594,-1.092467184,-1.170500555,-0.496702461,-3.154173912,3.154173912,-1.170500555,-1.092467184,0,0,0
3972,17,133,8,58,50,0,16282.19,80,1308.448,LESS,3402,5264,8666,4,1,-8,-0.749926769,8,-0.174607574,0.77550228,2.705704887,108,58,50,0,-1.037141429,-0.858367073,-1.170500555,-0.496702461,2.681530538,2.681530538,-1.170500555,-0.858367073,1,0,1
3973,17,134,44,119,110,1,15123.462,70,1592.908,LESS,1560,5576,7136,6,2,-9,-0.843667615,9,0,0.343668064,2.382156822,229,119,110,0,1.376206896,1.521650721,1.170500555,0.204524543,1.152894645,1.152894645,1.170500555,1.521650721,1,1,1
3974,17,135,34,74,80,1,8323.117,80,1289.418,LESS,822,3424,4246,8,2,6,0.562445076,6,-0.523822722,0.77550228,0.483317347,154,74,80,1,-0.119670165,-0.234100111,0,0.905751546,0.540444434,0.540444434,0,-0.234100111,1,1,1
3975,17,136,24,86,80,0,9225.887,70,1163.191,LESS,256,3696,3952,8,2,-6,-0.562445076,6,-0.523822722,0.343668064,0.735395045,166,86,80,0,0.119670165,0.234100111,0,0.905751546,0.070733297,0.070733297,0,0.234100111,1,1,1
3976,17,137,39,66,80,0,3566.353,70,1069.515,LESS,-404,1884,1480,3,2,14,1.312371845,14,0.87303787,0.343668064,-0.844899273,146,66,80,1,-0.279230385,-0.546233592,0,-0.847315962,-0.476986404,0.476986404,0,-0.546233592,1,0,0
3977,17,138,9,50,59,0,2282.687,80,1553.771,LESS,784,810,1594,3,2,9,0.843667615,9,0,0.77550228,-1.203333393,109,50,59,1,-1.017196402,-1.170500555,-0.819350388,-0.847315962,0.508909057,0.508909057,-0.819350388,-1.170500555,1,0,1
3978,17,139,57,94,110,0,4023.027,60,2224.178,LESS,-888,2240,1352,4,2,16,1.499853537,16,1.222253018,-0.088166152,-0.717383593,204,94,110,1,0.877581209,0.546233592,1.170500555,-0.496702461,-0.878647518,0.878647518,1.170500555,0.546233592,0,0,0
3979,17,140,60,110,87,1,7287.878,70,1358.407,LESS,2990,1328,4318,3,2,-23,-2.15603946,23,2.444506035,0.343668064,0.194250737,197,110,87,0,0.737966017,1.170500555,0.273116796,-0.847315962,2.339620664,2.339620664,0.273116796,1.170500555,1,0,1
3980,17,141,33,75,80,0,14257.749,60,1866.404,LESS,604,5228,5832,12,1,5,0.46870423,5,-0.698430296,-0.088166152,2.140426436,155,75,80,1,-0.099725137,-0.195083426,0,2.308205553,0.359530957,0.359530957,0,-0.195083426,0,1,1
3981,17,142,15,50,45,1,5033.45,70,1587.073,LESS,870,1818,2688,4,2,-5,-0.46870423,5,-0.698430296,0.343668064,-0.435246278,95,50,45,0,-1.296426786,-1.170500555,-1.36558398,-0.496702461,0.580278594,0.580278594,-1.36558398,-1.170500555,1,0,1
3982,17,143,59,89,110,0,2468.377,80,1434.37,LESS,-288,1300,1012,3,1,21,1.968557767,21,2.095290887,0.77550228,-1.151483744,199,89,110,1,0.777856072,0.351150166,1.170500555,-0.847315962,-0.380720517,0.380720517,1.170500555,0.351150166,1,0,0
3983,17,144,29,80,94,0,3251.114,80,1134.36,LESS,-212,1920,1708,3,2,14,1.312371845,14,0.87303787,0.77550228,-0.932922492,174,80,94,1,0.279230385,0,0.546233592,-0.847315962,-0.317649764,0.317649764,0.546233592,0,1,0,0
3984,17,145,55,110,98,0,9190.952,30,1288.067,LESS,-366,3120,2754,5,1,-12,-1.124890153,12,0.523822722,-1.383668801,0.725640252,208,110,98,0,0.957361319,1.170500555,0.702300333,-0.146088959,-0.445451027,0.445451027,0.702300333,1.170500555,0,1,0
3985,17,146,29,94,80,1,3479.847,70,2284.591,LESS,1528,822,2350,4,2,-14,-1.312371845,14,0.87303787,0.343668064,-0.869054078,174,94,80,0,0.279230385,0.546233592,0,-0.496702461,1.126338539,1.126338539,0,0.546233592,0,0,1
3986,17,147,57,110,94,0,7210.042,20,1721.618,LESS,-1336,3596,2260,6,1,-16,-1.499853537,16,1.222253018,-1.815503017,0.172516829,204,110,94,0,0.877581209,1.170500555,0.546233592,0.204524543,-1.250433012,1.250433012,0.546233592,1.170500555,0,1,0
3987,17,148,39,80,66,1,6443.748,80,1226.075,LESS,2878,1464,4342,3,2,-14,-1.312371845,14,0.87303787,0.77550228,-0.041453094,146,80,66,0,-0.279230385,0,-0.546233592,-0.847315962,2.24667429,2.24667429,-0.546233592,0,1,0,1
3988,17,149,4,50,54,0,3443.126,70,1170.907,LESS,-568,1774,1206,3,1,4,0.374963384,4,-0.87303787,0.343668064,-0.879307571,104,50,54,1,-1.116921539,-1.170500555,-1.014433814,-0.847315962,-0.613086451,0.613086451,-1.014433814,-1.170500555,0,0,0
3989,17,150,55,98,110,0,3965.528,60,2893.465,LESS,-290,2072,1782,2,2,12,1.124890153,12,0.523822722,-0.088166152,-0.733438863,208,98,110,1,0.957361319,0.702300333,1.170500555,-1.197929464,-0.382380274,0.382380274,1.170500555,0.702300333,0,0,0
3990,17,151,2,50,52,1,3753.102,70,1778.819,LESS,2062,58,2120,1,2,2,0.187481692,2,-1.222253018,0.343668064,-0.792753923,102,50,52,1,-1.156811594,-1.170500555,-1.092467184,-1.548542966,1.569493569,1.569493569,-1.092467184,-1.170500555,0,0,1
3991,17,152,59,110,89,1,5763.077,80,1168.568,LESS,1844,1362,3206,3,2,-21,-1.968557767,21,2.095290887,0.77550228,-0.231514769,199,110,89,0,0.777856072,1.170500555,0.351150166,-0.847315962,1.388580092,1.388580092,0.351150166,1.170500555,1,0,1
3992,17,153,60,87,110,0,1628.609,70,1540.039,LESS,-832,1260,428,1,1,23,2.15603946,23,2.444506035,0.343668064,-1.385969586,197,87,110,1,0.737966017,0.273116796,1.170500555,-1.548542966,-0.832174331,0.832174331,1.170500555,0.273116796,0,0,0
3993,17,154,52,110,105,0,10223.509,40,1596.649,LESS,156,4528,4684,11,1,-5,-0.46870423,5,-0.698430296,-0.951834585,1.013957976,215,110,105,0,1.096976512,1.170500555,0.975417129,1.957592051,-0.012254537,0.012254537,0.975417129,1.170500555,0,1,1
3994,17,155,30,80,96,0,3848.055,70,1140.505,LESS,-178,1976,1798,3,2,16,1.499853537,16,1.222253018,0.343668064,-0.766240488,176,80,96,1,0.31912044,0,0.624266962,-0.847315962,-0.289433901,0.289433901,0.624266962,0,0,0,0
3995,17,156,24,80,86,0,7369.801,70,1365.785,LESS,1010,2576,3586,5,1,6,0.562445076,6,-0.523822722,0.343668064,0.217125845,166,80,86,1,0.119670165,0,0.234100111,-0.146088959,0.696461561,0.696461561,0.234100111,0,1,1,1
3996,17,157,5,50,55,0,9430.724,70,1473.526,LESS,2844,2140,4984,3,2,5,0.46870423,5,-0.698430296,0.343668064,0.792591052,105,50,55,1,-1.096976512,-1.170500555,-0.975417129,-0.847315962,2.218458427,2.218458427,-0.975417129,-1.170500555,0,0,1
3997,17,158,34,80,74,1,11885.698,30,1937.232,LESS,1982,3398,5380,10,2,-6,-0.562445076,6,-0.523822722,-1.383668801,1.478085912,154,80,74,0,-0.119670165,0,-0.234100111,1.606978549,1.503103302,1.503103302,-0.234100111,0,0,1,1
3998,17,159,15,45,50,1,3495.468,70,1015.159,LESS,964,1064,2028,4,2,5,0.46870423,5,-0.698430296,0.343668064,-0.864692274,95,45,50,1,-1.296426786,-1.36558398,-1.170500555,-0.496702461,0.658287158,0.658287158,-1.170500555,-1.36558398,0,0,1
3999,17,160,37,69,80,0,10982.379,30,1164.335,LESS,716,3086,3802,5,2,11,1.031149307,11,0.349215148,-1.383668801,1.225854918,149,69,80,1,-0.219395302,-0.429183537,0,-0.146088959,0.452477331,0.452477331,0,-0.429183537,0,1,1
4000,17,161,3,50,53,0,5097.561,70,1727.61,MORE,-334,2668,2334,5,2,3,0.281222538,3,-1.047645444,0.343668064,-0.41734476,103,50,53,0,-1.136866566,-1.170500555,-1.053450499,-0.146088959,-0.418894921,0.418894921,-1.053450499,-1.170500555,0,0,0
4001,17,162,20,50,40,0,4035.593,70,1582.013,MORE,472,1562,2034,3,2,-10,-0.937408461,10,0.174607574,0.343668064,-0.713874828,90,50,40,1,-1.396151924,-1.170500555,-1.560667406,-0.847315962,0.249987017,0.249987017,-1.560667406,-1.170500555,0,0,1
4002,17,163,25,80,88,1,2430.067,90,1126.198,MORE,664,1084,1748,2,2,8,0.749926769,8,-0.174607574,1.207336496,-1.162180928,168,80,88,0,0.15956022,0,0.312133481,-1.197929464,0.409323657,0.409323657,0.312133481,0,1,0,1
4003,17,164,42,115,110,1,6841.13,90,1730.135,MORE,704,3240,3944,6,2,-5,-0.46870423,5,-0.698430296,1.207336496,0.069506663,225,115,110,1,1.296426786,1.36558398,1.170500555,0.204524543,0.442518791,0.442518791,1.170500555,1.36558398,1,1,1
4004,17,165,53,103,110,1,4750.34,80,2733.197,MORE,1622,1854,3476,6,2,7,0.656185922,7,-0.349215148,0.77550228,-0.514298215,213,103,110,0,1.057086457,0.897383758,1.170500555,0.204524543,1.204347102,1.204347102,1.170500555,0.897383758,1,1,1
4005,17,166,26,90,80,0,4076.55,60,2076.784,MORE,-342,2094,1752,5,2,-10,-0.937408461,10,0.174607574,-0.088166152,-0.70243853,170,90,80,1,0.199450275,0.390166852,0,-0.146088959,-0.425533947,0.425533947,0,0.390166852,0,0,0
4006,17,167,35,80,72,0,5521.174,70,1353.149,MORE,-770,2652,1882,5,2,-8,-0.749926769,8,-0.174607574,0.343668064,-0.299060602,152,80,72,1,-0.15956022,0,-0.312133481,-0.146088959,-0.780721875,0.780721875,-0.312133481,0,1,0,0
4007,17,168,28,93,80,0,9502.706,70,1818.496,MORE,1276,3468,4744,10,2,-13,-1.218630999,13,0.698430296,0.343668064,0.812690365,173,93,80,1,0.259285357,0.507216907,0,1.606978549,0.917209198,0.917209198,0,0.507216907,1,1,1
4008,17,169,26,80,90,1,5340.182,70,1834.438,MORE,1000,1940,2940,6,2,10,0.937408461,10,0.174607574,0.343668064,-0.349598443,170,80,90,0,0.199450275,0,0.390166852,0.204524543,0.688162778,0.688162778,0.390166852,0,0,1,1
4009,17,170,25,88,80,0,4030.404,60,1031.06,MORE,-338,1832,1494,5,1,-8,-0.749926769,8,-0.174607574,-0.088166152,-0.715323736,168,88,80,1,0.15956022,0.312133481,0,-0.146088959,-0.422214434,0.422214434,0,0.312133481,0,0,0
4010,17,171,36,80,70,0,7517.559,70,2168.856,MORE,-600,3296,2696,8,2,-10,-0.937408461,10,0.174607574,0.343668064,0.258383858,150,80,70,1,-0.199450275,0,-0.390166852,0.905751546,-0.639642558,0.639642558,-0.390166852,0,0,1,0
4011,17,172,28,80,93,1,8643.44,30,2553.384,MORE,766,3500,4266,11,1,13,1.218630999,13,0.698430296,-1.383668801,0.572760156,173,80,93,0,0.259285357,0,0.507216907,1.957592051,0.493971247,0.493971247,0.507216907,0,0,1,1
4012,17,173,21,82,80,1,8397.547,90,3444.753,MORE,1912,3378,5290,10,2,-2,-0.187481692,2,-1.222253018,1.207336496,0.504100208,162,82,80,1,0.039890055,0.07803337,0,1.606978549,1.445011819,1.445011819,0,0.07803337,1,1,1
4013,17,174,19,50,41,0,5101.478,70,1895.51,MORE,-882,2794,1912,5,2,-9,-0.843667615,9,0,0.343668064,-0.416251029,91,50,41,1,-1.376206896,-1.170500555,-1.521650721,-0.146088959,-0.873668248,0.873668248,-1.521650721,-1.170500555,0,0,0
4014,17,175,56,96,110,1,6750.532,70,2249.196,MORE,986,1890,2876,4,2,14,1.312371845,14,0.87303787,0.343668064,0.044209261,206,96,110,0,0.917471264,0.624266962,1.170500555,-0.496702461,0.676544481,0.676544481,1.170500555,0.624266962,0,0,1
4015,17,176,23,80,85,0,10678.701,70,1813.926,MORE,-564,4752,4188,8,2,5,0.46870423,5,-0.698430296,0.343668064,1.141059842,165,80,85,0,0.099725137,0,0.195083426,0.905751546,-0.609766938,0.609766938,0.195083426,0,0,1,0
4016,17,177,10,60,50,0,3040.401,70,1164.89,MORE,-460,1450,990,3,1,-10,-0.937408461,10,0.174607574,0.343668064,-0.991759237,110,60,50,1,-0.997251374,-0.780333703,-1.170500555,-0.847315962,-0.523459591,0.523459591,-1.170500555,-0.780333703,0,0,0
4017,17,178,19,41,50,0,8784.855,20,1422.327,MORE,-1212,4506,3294,9,1,9,0.843667615,9,0,-1.815503017,0.612247032,91,41,50,0,-1.376206896,-1.521650721,-1.170500555,1.256365048,-1.147528099,1.147528099,-1.170500555,-1.521650721,0,1,0
4018,17,179,56,110,96,0,7283.052,80,988.624,MORE,-786,3340,2554,5,2,-14,-1.312371845,14,0.87303787,0.77550228,0.192903188,206,110,96,1,0.917471264,1.170500555,0.624266962,-0.146088959,-0.793999928,0.793999928,0.624266962,1.170500555,1,0,0
4019,17,180,35,72,80,1,2988.272,70,1159.549,MORE,1126,880,2006,2,2,8,0.749926769,8,-0.174607574,0.343668064,-1.006315058,152,72,80,0,-0.15956022,-0.312133481,0,-1.197929464,0.792727448,0.792727448,0,-0.312133481,0,0,1
4020,17,181,11,49,50,0,2952.379,60,1543.877,MORE,-48,1360,1312,3,1,1,0.093740846,1,-1.396860592,-0.088166152,-1.01633735,99,49,50,0,-1.216646676,-1.20951724,-1.170500555,-0.847315962,-0.181549717,0.181549717,-1.170500555,-1.20951724,0,0,0
4021,17,182,17,43,50,1,4316.585,80,1287.81,MORE,856,1608,2464,4,2,7,0.656185922,7,-0.349215148,0.77550228,-0.635414293,93,43,50,0,-1.336316841,-1.443617351,-1.170500555,-0.496702461,0.568660298,0.568660298,-1.170500555,-1.443617351,1,0,1
4022,17,183,1,51,50,0,12613.209,10,1756.196,MORE,-1498,5736,4238,9,1,-1,-0.093740846,1,-1.396860592,-2.247337233,1.681226577,101,51,50,1,-1.176756621,-1.131483869,-1.170500555,1.256365048,-1.384873302,1.384873302,-1.170500555,-1.131483869,0,1,0
4023,17,184,41,112,110,0,8638.512,20,1003.276,MORE,-760,4224,3464,7,1,-2,-0.187481692,2,-1.222253018,-1.815503017,0.571384125,222,112,110,1,1.236591704,1.248533925,1.170500555,0.555138044,-0.772423091,0.772423091,1.170500555,1.248533925,0,1,0
4024,17,185,20,40,50,1,3047.884,80,1843.859,MORE,1110,1086,2196,4,2,10,0.937408461,10,0.174607574,0.77550228,-0.989669782,90,40,50,0,-1.396151924,-1.560667406,-1.170500555,-0.496702461,0.779449395,0.779449395,-1.170500555,-1.560667406,1,0,1
4025,17,186,1,50,51,1,4555.576,70,1851.764,MORE,402,1296,1698,5,2,1,0.093740846,1,-1.396860592,0.343668064,-0.568681569,101,50,51,0,-1.176756621,-1.170500555,-1.131483869,-0.146088959,0.191895534,0.191895534,-1.131483869,-1.170500555,1,1,1
4026,17,187,23,85,80,0,1776.571,80,998.053,MORE,-164,900,736,1,2,-5,-0.46870423,5,-0.698430296,0.77550228,-1.344654611,165,85,80,1,0.099725137,0.195083426,0,-1.548542966,-0.277815604,0.277815604,0,0.195083426,1,0,0
4027,17,188,11,50,49,1,8255.092,70,1723.695,MORE,490,2920,3410,6,2,-1,-0.093740846,1,-1.396860592,0.343668064,0.464322935,99,50,49,1,-1.216646676,-1.170500555,-1.20951724,0.204524543,0.264924827,0.264924827,-1.20951724,-1.170500555,1,1,1
4028,17,189,17,50,43,0,4504.07,80,1051.128,MORE,-18,2010,1992,4,2,-7,-0.656185922,7,-0.349215148,0.77550228,-0.583063432,93,50,43,1,-1.336316841,-1.170500555,-1.443617351,-0.496702461,-0.156653367,0.156653367,-1.443617351,-1.170500555,1,0,0
4029,17,190,21,80,82,0,5685.101,70,1543.762,MORE,-744,3020,2276,5,2,2,0.187481692,2,-1.222253018,0.343668064,-0.253287769,162,80,82,0,0.039890055,0,0.07803337,-0.146088959,-0.759145038,0.759145038,0.07803337,0,0,0,0
4030,17,191,10,50,60,1,15205.986,80,1281.138,MORE,1226,4864,6090,12,2,10,0.937408461,10,0.174607574,0.77550228,2.405199745,110,50,60,0,-0.997251374,-1.170500555,-0.780333703,2.308205553,0.875715281,0.875715281,-0.780333703,-1.170500555,1,1,1
4031,17,192,3,53,50,0,4380.422,30,1382.503,MORE,408,1680,2088,4,1,-3,-0.281222538,3,-1.047645444,-1.383668801,-0.617589284,103,53,50,1,-1.136866566,-1.053450499,-1.170500555,-0.496702461,0.196874804,0.196874804,-1.170500555,-1.053450499,0,0,1
4032,17,193,45,122,110,0,3073.457,70,1079.399,MORE,352,1382,1734,3,2,-12,-1.124890153,12,0.523822722,0.343668064,-0.982529111,232,122,110,1,1.436041979,1.638700776,1.170500555,-0.847315962,0.150401617,0.150401617,1.170500555,1.638700776,0,0,1
4033,17,194,38,67,80,1,3444.061,80,1127.84,MORE,1254,1182,2436,4,2,13,1.218630999,13,0.698430296,0.77550228,-0.879046493,147,67,80,0,-0.259285357,-0.507216907,0,-0.496702461,0.898951875,0.898951875,0,-0.507216907,1,0,1
4034,17,195,38,80,67,1,17791.478,80,1003.688,MORE,736,5206,5942,11,2,-13,-1.218630999,13,0.698430296,0.77550228,3.127138745,147,80,67,1,-0.259285357,0,-0.507216907,1.957592051,0.469074897,0.469074897,-0.507216907,0,1,1,1
4035,17,196,36,70,80,1,1860.292,80,1543.183,MORE,740,464,1204,2,2,10,0.937408461,10,0.174607574,0.77550228,-1.321277453,150,70,80,0,-0.199450275,-0.390166852,0,-1.197929464,0.472394411,0.472394411,0,-0.390166852,1,0,1
4036,17,197,45,110,122,1,3502.319,100,2453.312,MORE,1600,1340,2940,4,2,12,1.124890153,12,0.523822722,1.639170712,-0.862779291,232,110,122,0,1.436041979,1.170500555,1.638700776,-0.496702461,1.186089779,1.186089779,1.638700776,1.170500555,1,0,1
4037,17,198,42,110,115,1,14815.109,80,1577.189,MORE,590,5524,6114,10,2,5,0.46870423,5,-0.698430296,0.77550228,2.296056359,225,110,115,0,1.296426786,1.170500555,1.36558398,1.606978549,0.347912661,0.347912661,1.36558398,1.170500555,1,1,1
4038,17,199,41,110,112,0,3301.886,60,1951.137,MORE,-418,1750,1332,3,1,2,0.187481692,2,-1.222253018,-0.088166152,-0.918745582,222,110,112,0,1.236591704,1.170500555,1.248533925,-0.847315962,-0.488604701,0.488604701,1.248533925,1.170500555,0,0,0
4039,17,200,53,110,103,1,3517.441,70,1849.595,MORE,-196,1372,1176,3,1,-7,-0.656185922,7,-0.349215148,0.343668064,-0.858556821,213,110,103,1,1.057086457,1.170500555,0.897383758,-0.847315962,-0.304371711,0.304371711,0.897383758,1.170500555,0,0,0
4040,17,201,3,50,53,0,6140.254,70,1918.991,LESS,-516,2850,2334,7,2,3,0.281222538,3,-1.047645444,0.343668064,-0.126196792,103,50,53,1,-1.136866566,-1.170500555,-1.053450499,0.555138044,-0.569932778,0.569932778,-1.053450499,-1.170500555,0,1,0
4041,17,202,20,50,40,1,6970.968,70,1462.674,LESS,1198,2616,3814,6,2,-10,-0.937408461,10,0.174607574,0.343668064,0.10576093,90,50,40,0,-1.396151924,-1.170500555,-1.560667406,0.204524543,0.852478688,0.852478688,-1.560667406,-1.170500555,0,1,1
4042,17,203,25,80,88,0,3131.329,60,1427.525,LESS,-260,1570,1310,3,1,8,0.749926769,8,-0.174607574,-0.088166152,-0.96636969,168,80,88,1,0.15956022,0,0.312133481,-0.847315962,-0.357483924,0.357483924,0.312133481,0,0,0,0
4043,17,204,42,115,110,1,6617.152,10,1964.042,LESS,-940,3810,2870,4,1,-5,-0.46870423,5,-0.698430296,-2.247337233,0.006965973,225,115,110,0,1.296426786,1.36558398,1.170500555,-0.496702461,-0.921801192,0.921801192,1.170500555,1.36558398,0,0,0
4044,17,205,53,103,110,0,3995.447,60,1555.351,LESS,-196,1824,1628,3,1,7,0.656185922,7,-0.349215148,-0.088166152,-0.725084672,213,103,110,1,1.057086457,0.897383758,1.170500555,-0.847315962,-0.304371711,0.304371711,1.170500555,0.897383758,0,0,0
4045,17,206,26,90,80,1,13947.519,90,2055.077,LESS,1504,3868,5372,8,2,-10,-0.937408461,10,0.174607574,1.207336496,2.053801865,170,90,80,0,0.199450275,0.390166852,0,0.905751546,1.106421458,1.106421458,0,0.390166852,1,1,1
4046,17,207,35,80,72,1,13634.49,80,1293.934,LESS,-88,4526,4438,7,2,-8,-0.749926769,8,-0.174607574,0.77550228,1.966395737,152,80,72,0,-0.15956022,0,-0.312133481,0.555138044,-0.21474485,0.21474485,-0.312133481,0,1,1,0
4047,17,208,28,93,80,1,4056.044,80,867.173,LESS,924,1356,2280,4,2,-13,-1.218630999,13,0.698430296,0.77550228,-0.708164358,173,93,80,0,0.259285357,0.507216907,0,-0.496702461,0.625092024,0.625092024,0,0.507216907,1,0,1
4048,17,209,26,80,90,0,2312.452,80,1083.429,LESS,-306,1214,908,3,1,10,0.937408461,10,0.174607574,0.77550228,-1.195022203,170,80,90,1,0.199450275,0,0.390166852,-0.847315962,-0.395658327,0.395658327,0.390166852,0,1,0,0
4049,17,210,25,88,80,0,7872.835,70,1983.329,LESS,724,2690,3414,6,2,-8,-0.749926769,8,-0.174607574,0.343668064,0.357586485,168,88,80,0,0.15956022,0.312133481,0,0.204524543,0.459116357,0.459116357,0,0.312133481,0,1,1
4050,17,211,36,80,70,1,11600.637,80,1071.43,LESS,1426,3032,4458,8,2,-10,-0.937408461,10,0.174607574,0.77550228,1.398489203,150,80,70,0,-0.199450275,0,-0.390166852,0.905751546,1.041690948,1.041690948,-0.390166852,0,1,1,1
4051,17,212,28,80,93,0,3214.68,80,1310.568,LESS,-716,1932,1216,3,1,13,1.218630999,13,0.698430296,0.77550228,-0.943095846,173,80,93,1,0.259285357,0,0.507216907,-0.847315962,-0.735908445,0.735908445,0.507216907,0,1,0,0
4052,17,213,21,82,80,0,10573.491,70,1465.425,LESS,-776,4380,3604,9,2,-2,-0.187481692,2,-1.222253018,0.343668064,1.111682376,162,82,80,0,0.039890055,0.07803337,0,1.256365048,-0.785701145,0.785701145,0,0.07803337,0,1,0
4053,17,214,19,50,41,1,1503.495,80,1498.878,LESS,824,476,1300,2,2,-9,-0.843667615,9,0,0.77550228,-1.420904785,91,50,41,0,-1.376206896,-1.170500555,-1.521650721,-1.197929464,0.542104191,0.542104191,-1.521650721,-1.170500555,1,0,1
4054,17,215,56,96,110,0,3768.844,80,1992.22,LESS,206,1722,1928,3,2,14,1.312371845,14,0.87303787,0.77550228,-0.788358333,206,96,110,1,0.917471264,0.624266962,1.170500555,-0.847315962,0.02923938,0.02923938,1.170500555,0.624266962,1,0,1
4055,17,216,23,80,85,0,11161.013,80,997.708,LESS,-1432,4324,2892,5,1,5,0.46870423,5,-0.698430296,0.77550228,1.275734342,165,80,85,1,0.099725137,0,0.195083426,-0.146088959,-1.330101332,1.330101332,0.195083426,0,1,1,0
4056,17,217,10,60,50,1,1612.697,90,1916.159,LESS,1110,486,1596,2,2,-10,-0.937408461,10,0.174607574,1.207336496,-1.390412645,110,60,50,0,-0.997251374,-0.780333703,-1.170500555,-1.197929464,0.779449395,0.779449395,-1.170500555,-0.780333703,1,0,1
4057,17,218,19,41,50,0,10174.789,20,1418.337,LESS,-1226,4212,2986,6,1,9,0.843667615,9,0,-1.815503017,1.00035404,91,41,50,1,-1.376206896,-1.521650721,-1.170500555,0.204524543,-1.159146395,1.159146395,-1.170500555,-1.521650721,0,1,0
4058,17,219,56,110,96,1,3083.707,60,1332.876,LESS,1068,790,1858,2,2,-14,-1.312371845,14,0.87303787,-0.088166152,-0.979667035,206,110,96,0,0.917471264,1.170500555,0.624266962,-1.197929464,0.744594505,0.744594505,0.624266962,1.170500555,0,0,1
4059,17,220,35,72,80,0,2981.672,80,1396.509,LESS,-802,1536,734,2,1,8,0.749926769,8,-0.174607574,0.77550228,-1.008157955,152,72,80,1,-0.15956022,-0.312133481,0,-1.197929464,-0.807277981,0.807277981,0,-0.312133481,1,0,0
4060,17,221,11,49,50,1,2556.866,80,1389.146,LESS,1202,642,1844,2,2,1,0.093740846,1,-1.396860592,0.77550228,-1.126775232,99,49,50,1,-1.216646676,-1.20951724,-1.170500555,-1.197929464,0.855798201,0.855798201,-1.170500555,-1.20951724,1,0,1
4061,17,222,17,43,50,0,8286.367,70,1066.99,LESS,-236,2772,2536,3,1,7,0.656185922,7,-0.349215148,0.343668064,0.473055757,93,43,50,1,-1.336316841,-1.443617351,-1.170500555,-0.847315962,-0.337566844,0.337566844,-1.170500555,-1.443617351,1,0,0
4062,17,223,1,51,50,0,14342.408,60,2032.821,LESS,-1160,6026,4866,8,2,-1,-0.093740846,1,-1.396860592,-0.088166152,2.164065509,101,51,50,0,-1.176756621,-1.131483869,-1.170500555,0.905751546,-1.104374425,1.104374425,-1.170500555,-1.131483869,0,1,0
4063,17,224,41,112,110,1,7255.014,70,1444.704,LESS,1882,2188,4070,8,2,-2,-0.187481692,2,-1.222253018,0.343668064,0.185074223,222,112,110,0,1.236591704,1.248533925,1.170500555,0.905751546,1.420115469,1.420115469,1.170500555,1.248533925,0,1,1
4064,17,225,20,40,50,0,5220.749,70,2063.176,LESS,-576,2658,2082,5,1,10,0.937408461,10,0.174607574,0.343668064,-0.382947353,90,40,50,1,-1.396151924,-1.560667406,-1.170500555,-0.146088959,-0.619725478,0.619725478,-1.170500555,-1.560667406,0,1,0
4065,17,226,1,50,51,1,13476.043,20,994.896,LESS,754,4918,5672,14,1,1,0.093740846,1,-1.396860592,-1.815503017,1.922153068,101,50,51,1,-1.176756621,-1.170500555,-1.131483869,3.009432556,0.484012707,0.484012707,-1.131483869,-1.170500555,0,1,1
4066,17,227,23,85,80,0,13700.488,30,1025.474,LESS,-386,5496,5110,11,1,-5,-0.46870423,5,-0.698430296,-1.383668801,1.984824156,165,85,80,0,0.099725137,0.195083426,0,1.957592051,-0.462048594,0.462048594,0,0.195083426,0,1,0
4067,17,228,11,50,49,1,3857.125,70,1137.964,LESS,698,1442,2140,4,2,-1,-0.093740846,1,-1.396860592,0.343668064,-0.7637079,99,50,49,0,-1.216646676,-1.170500555,-1.20951724,-0.496702461,0.437539521,0.437539521,-1.20951724,-1.170500555,0,0,1
4068,17,229,17,50,43,1,1733.65,90,880.831,LESS,974,520,1494,2,2,-7,-0.656185922,7,-0.349215148,1.207336496,-1.35663931,93,50,43,0,-1.336316841,-1.170500555,-1.443617351,-1.197929464,0.666585941,0.666585941,-1.443617351,-1.170500555,1,0,1
4069,17,230,21,80,82,0,5214.45,20,1218.271,LESS,220,2270,2490,5,1,2,0.187481692,2,-1.222253018,-1.815503017,-0.384706204,162,80,82,1,0.039890055,0,0.07803337,-0.146088959,0.040857677,0.040857677,0.07803337,0,0,1,1
4070,17,231,10,50,60,0,5060.513,90,921.342,LESS,204,2196,2400,5,2,10,0.937408461,10,0.174607574,1.207336496,-0.42768956,110,50,60,1,-0.997251374,-1.170500555,-0.780333703,-0.146088959,0.027579623,0.027579623,-0.780333703,-1.170500555,1,0,1
4071,17,232,3,53,50,1,2134.451,80,1592.609,LESS,782,628,1410,2,2,-3,-0.281222538,3,-1.047645444,0.77550228,-1.244724876,103,53,50,0,-1.136866566,-1.053450499,-1.170500555,-1.197929464,0.507249301,0.507249301,-1.170500555,-1.053450499,1,0,1
4072,17,233,45,122,110,1,2692.977,80,951.816,LESS,-88,1342,1254,4,2,-12,-1.124890153,12,0.523822722,0.77550228,-1.088769375,232,122,110,0,1.436041979,1.638700776,1.170500555,-0.496702461,-0.21474485,0.21474485,1.170500555,1.638700776,1,0,0
4073,17,234,38,67,80,0,7441.111,70,934.567,LESS,-164,3280,3116,9,1,13,1.218630999,13,0.698430296,0.343668064,0.237037517,147,67,80,1,-0.259285357,-0.507216907,0,1.256365048,-0.277815604,0.277815604,0,-0.507216907,1,1,0
4074,17,235,38,80,67,1,9072.115,30,1421.41,LESS,240,3200,3440,8,1,-13,-1.218630999,13,0.698430296,-1.383668801,0.692457761,147,80,67,0,-0.259285357,0,-0.507216907,0.905751546,0.057455243,0.057455243,-0.507216907,0,0,1,1
4075,17,236,36,70,80,0,1870.211,70,2256.514,LESS,278,862,1140,2,2,10,0.937408461,10,0.174607574,0.343668064,-1.318507801,150,70,80,1,-0.199450275,-0.390166852,0,-1.197929464,0.08899062,0.08899062,0,-0.390166852,1,0,1
4076,17,237,45,110,122,0,4735.279,80,1314.407,LESS,-42,2266,2224,5,2,12,1.124890153,12,0.523822722,0.77550228,-0.518503652,232,110,122,1,1.436041979,1.170500555,1.638700776,-0.146088959,-0.176570447,0.176570447,1.638700776,1.170500555,1,0,0
4077,17,238,42,110,115,0,3985.485,10,776.351,LESS,-206,1900,1694,5,1,5,0.46870423,5,-0.698430296,-2.247337233,-0.727866331,225,110,115,1,1.296426786,1.170500555,1.36558398,-0.146088959,-0.312670494,0.312670494,1.36558398,1.170500555,0,0,0
4078,17,239,41,110,112,0,4554.13,70,1291.767,LESS,208,1716,1924,5,2,2,0.187481692,2,-1.222253018,0.343668064,-0.569085332,222,110,112,1,1.236591704,1.170500555,1.248533925,-0.146088959,0.030899137,0.030899137,1.248533925,1.170500555,1,1,1
4079,17,240,53,110,103,0,3471.15,10,1123.361,LESS,-574,1790,1216,2,1,-7,-0.656185922,7,-0.349215148,-2.247337233,-0.871482515,213,110,103,0,1.057086457,1.170500555,0.897383758,-1.197929464,-0.618065721,0.618065721,0.897383758,1.170500555,0,0,0
4080,18,1,49,110,131,0,4023.951,74,1548.214,LESS,-98,2262,2164,3,2,21,1.968557767,21,2.095290887,0.841037765,-0.464982801,241,110,131,1,1.615547226,1.170500555,1.989850943,-1.7128963,-0.410374403,0.410374403,1.989850943,1.170500555,1,0,0
4081,18,2,13,47,50,1,5703.099,34,1764.67,LESS,1072,1968,3040,5,1,3,0.281222538,3,-1.047645444,-0.654694459,0.457116942,97,47,50,1,-1.256536731,-1.28755061,-1.170500555,-0.749015615,0.583134575,0.583134575,-1.170500555,-1.28755061,0,0,1
4082,18,3,16,50,44,1,4273.391,74,2719.159,LESS,1114,1376,2490,4,2,-6,-0.562445076,6,-0.523822722,0.841037765,-0.328003476,94,50,44,0,-1.316371814,-1.170500555,-1.404600665,-1.230955958,0.618799,0.618799,-1.404600665,-1.170500555,1,0,1
4083,18,4,7,57,50,0,5631.191,84,2378.804,LESS,2204,2488,4692,5,2,-7,-0.656185922,7,-0.349215148,1.214970821,0.417628851,107,57,50,0,-1.057086457,-0.897383758,-1.170500555,-0.749015615,1.544375741,1.544375741,-1.170500555,-0.897383758,1,0,1
4084,18,5,18,42,50,0,4558.732,54,1712.116,LESS,-592,2254,1662,5,1,8,0.749926769,8,-0.174607574,0.093171653,-0.17130921,92,42,50,1,-1.356261869,-1.482634036,-1.170500555,-0.749015615,-0.829855972,0.829855972,-1.170500555,-1.482634036,1,0,0
4085,18,6,51,108,110,0,8729.055,0,2266.079,LESS,-2776,6088,3312,9,1,2,0.187481692,2,-1.222253018,-1.926066849,2.118812784,218,108,110,1,1.156811594,1.092467184,1.170500555,1.178745754,-2.684406065,2.684406065,1.170500555,1.092467184,0,1,0
4086,18,7,31,78,80,0,7565.496,14,3789.964,LESS,-2294,6094,3800,10,1,2,0.187481692,2,-1.222253018,-1.402560571,1.479847395,158,78,80,1,-0.039890055,-0.07803337,0,1.660686096,-2.275114332,2.275114332,0,-0.07803337,0,1,0
4087,18,8,58,110,92,1,5851.782,34,1476.892,LESS,1154,2080,3234,8,2,-18,-1.687335229,18,1.571468165,-0.654694459,0.538765823,202,110,92,0,0.837691154,1.170500555,0.468200222,0.696805412,0.652765119,0.652765119,0.468200222,1.170500555,0,1,1
4088,18,9,12,50,48,0,5886.287,4,2100.568,LESS,-1662,4308,2646,9,1,-2,-0.187481692,2,-1.222253018,-1.776493627,0.557714154,98,50,48,0,-1.236591704,-1.170500555,-1.248533925,1.178745754,-1.738449653,1.738449653,-1.248533925,-1.170500555,0,1,0
4089,18,10,54,110,101,1,5691.921,54,2297.411,LESS,1434,1868,3302,5,2,-9,-0.843667615,9,0,0.093171653,0.450978572,211,110,101,0,1.017196402,1.170500555,0.819350388,-0.749015615,0.890527952,0.890527952,0.819350388,1.170500555,1,0,1
4090,18,11,14,46,50,0,8676.572,24,2196.18,LESS,-1982,4746,2764,7,1,4,0.374963384,4,-0.87303787,-1.028627515,2.089991881,96,46,50,1,-1.276481759,-1.326567295,-1.170500555,0.214865069,-2.010178604,2.010178604,-1.170500555,-1.326567295,0,1,0
4091,18,12,22,80,83,0,8534.586,44,3421.31,LESS,-992,4382,3390,7,1,3,0.281222538,3,-1.047645444,-0.280761403,2.01202064,163,80,83,1,0.059835082,0,0.117050055,0.214865069,-1.169517161,1.169517161,0.117050055,0,0,1,0
4092,18,13,6,50,56,1,5737.74,4,1835.524,LESS,1028,2790,3818,6,1,6,0.562445076,6,-0.523822722,-1.776493627,0.476139957,106,50,56,1,-1.077031484,-1.170500555,-0.936400444,-0.267075273,0.545771845,0.545771845,-0.936400444,-1.170500555,0,0,1
4093,18,14,13,50,47,0,7827.216,24,2367.535,LESS,-1368,4390,3022,6,1,-3,-0.281222538,3,-1.047645444,-1.028627515,1.62357025,97,50,47,0,-1.256536731,-1.170500555,-1.28755061,-0.267075273,-1.488798679,1.488798679,-1.28755061,-1.170500555,0,0,0
4094,18,15,46,110,124,0,6763.579,54,2203.306,LESS,-862,3620,2758,8,2,14,1.312371845,14,0.87303787,0.093171653,1.039476767,234,110,124,1,1.475932034,1.170500555,1.716734147,0.696805412,-1.059127274,1.059127274,1.716734147,1.170500555,1,1,0
4095,18,16,27,91,80,1,9908.079,74,2141.013,LESS,1026,3958,4984,10,2,-11,-1.031149307,11,0.349215148,0.841037765,2.766270737,171,91,80,0,0.219395302,0.429183537,0,1.660686096,0.544073539,0.544073539,0,0.429183537,1,1,1
4096,18,17,40,64,80,0,7691.736,94,3795.213,LESS,2796,3434,6230,10,2,16,1.499853537,16,1.222253018,1.588903877,1.549171762,144,64,80,1,-0.31912044,-0.624266962,0,1.660686096,2.047074301,2.047074301,0,-0.624266962,1,1,1
4097,18,18,22,83,80,1,4923.352,84,2492.383,LESS,2598,1192,3790,6,2,-3,-0.281222538,3,-1.047645444,1.214970821,0.028920911,163,83,80,0,0.059835082,0.117050055,0,-0.267075273,1.878942012,1.878942012,0,0.117050055,1,0,1
4098,18,19,54,101,110,0,5201.37,74,2953.335,LESS,-32,2670,2638,6,2,9,0.843667615,9,0,0.841037765,0.181593771,211,101,110,1,1.017196402,0.819350388,1.170500555,-0.267075273,-0.354330307,0.354330307,1.170500555,0.819350388,1,0,0
4099,18,20,6,56,50,0,5645.46,44,2316.044,LESS,10,2602,2612,7,1,-6,-0.562445076,6,-0.523822722,-0.280761403,0.425464635,106,56,50,0,-1.077031484,-0.936400444,-1.170500555,0.214865069,-0.318665882,0.318665882,-1.170500555,-0.936400444,1,1,0
4100,18,21,18,50,42,1,5919.066,24,2101.285,LESS,1232,2092,3324,8,1,-8,-0.749926769,8,-0.174607574,-1.028627515,0.575714656,92,50,42,0,-1.356261869,-1.170500555,-1.482634036,0.696805412,0.718999051,0.718999051,-1.482634036,-1.170500555,0,1,1
4101,18,22,43,110,117,0,5664.624,14,3421.56,LESS,-364,3128,2764,8,1,7,0.656185922,7,-0.349215148,-1.402560571,0.435988496,227,110,117,1,1.336316841,1.170500555,1.443617351,0.696805412,-0.636249094,0.636249094,1.443617351,1.170500555,0,1,0
4102,18,23,32,77,80,0,6393.367,54,2219.075,LESS,96,2646,2742,7,1,3,0.281222538,3,-1.047645444,0.093171653,0.836175813,157,77,80,1,-0.059835082,-0.117050055,0,0.214865069,-0.245638726,0.245638726,0,-0.117050055,1,1,0
4103,18,24,27,80,91,0,5747.181,44,2296.691,LESS,92,2720,2812,7,2,11,1.031149307,11,0.349215148,-0.280761403,0.481324457,171,80,91,1,0.219395302,0,0.429183537,0.214865069,-0.249035338,0.249035338,0.429183537,0,0,1,0
4104,18,25,16,44,50,0,8679.67,24,2210.399,LESS,-284,3688,3404,9,1,6,0.562445076,6,-0.523822722,-1.028627515,2.09169314,94,44,50,1,-1.316371814,-1.404600665,-1.170500555,1.178745754,-0.568316856,0.568316856,-1.170500555,-1.404600665,0,1,0
4105,18,26,7,50,57,0,8494.314,0,1481.642,LESS,-342,4732,4390,9,1,7,0.656185922,7,-0.349215148,-1.926066849,1.989905376,107,50,57,1,-1.057086457,-1.170500555,-0.897383758,1.178745754,-0.617567728,0.617567728,-0.897383758,-1.170500555,0,1,0
4106,18,27,14,50,46,1,7389.205,4,1520.486,LESS,584,3424,4008,8,1,-4,-0.374963384,4,-0.87303787,-1.776493627,1.383037652,96,50,46,0,-1.276481759,-1.170500555,-1.326567295,0.696805412,0.168747925,0.168747925,-1.326567295,-1.170500555,0,1,1
4107,18,28,51,110,108,1,10777.297,14,1361.89,LESS,90,4996,5086,10,1,-2,-0.187481692,2,-1.222253018,-1.402560571,3.243599534,218,110,108,0,1.156811594,1.170500555,1.092467184,1.660686096,-0.250733644,0.250733644,1.092467184,1.170500555,0,1,0
4108,18,29,50,133,110,1,4992.517,34,1929.464,LESS,1380,1444,2824,6,2,-23,-2.15603946,23,2.444506035,-0.654694459,0.066902691,243,133,110,0,1.655437281,2.067884313,1.170500555,-0.267075273,0.844673691,0.844673691,1.170500555,2.067884313,0,0,1
4109,18,30,49,131,110,1,5133.566,44,1789.912,LESS,2470,1222,3692,6,2,-21,-1.968557767,21,2.095290887,-0.280761403,0.144359381,241,131,110,0,1.615547226,1.989850943,1.170500555,-0.267075273,1.770250432,1.770250432,1.170500555,1.989850943,1,0,1
4110,18,31,47,126,110,1,3539.847,64,1531.482,LESS,870,1032,1902,4,2,-16,-1.499853537,16,1.222253018,0.467104709,-0.730827249,236,126,110,0,1.515822089,1.794767517,1.170500555,-1.230955958,0.411605675,0.411605675,1.170500555,1.794767517,1,0,1
4111,18,32,50,110,133,0,5347.944,74,2499.172,LESS,56,2884,2940,8,2,23,2.15603946,23,2.444506035,0.841037765,0.2620845,243,110,133,1,1.655437281,1.170500555,2.067884313,0.696805412,-0.279604845,0.279604845,2.067884313,1.170500555,1,1,0
4112,18,33,47,110,126,0,6035.228,84,2627.515,LESS,498,3292,3790,7,2,16,1.499853537,16,1.222253018,1.214970821,0.639504716,236,110,126,1,1.515822089,1.170500555,1.794767517,0.214865069,0.095720769,0.095720769,1.794767517,1.170500555,1,1,1
4113,18,34,12,48,50,0,8028.052,0,1459.024,LESS,-518,4562,4044,9,1,2,0.187481692,2,-1.222253018,-1.926066849,1.733858815,98,48,50,1,-1.236591704,-1.248533925,-1.170500555,1.178745754,-0.767018652,0.767018652,-1.170500555,-1.248533925,0,1,0
4114,18,35,32,80,77,0,7310.241,14,2901.717,LESS,-1328,4648,3320,9,1,-3,-0.281222538,3,-1.047645444,-1.402560571,1.339674778,157,80,77,0,-0.059835082,0,-0.117050055,1.178745754,-1.45483256,1.45483256,-0.117050055,0,0,1,0
4115,18,36,43,117,110,1,6028.14,44,1757.19,LESS,1508,2000,3508,8,2,-7,-0.656185922,7,-0.349215148,-0.280761403,0.635612359,227,117,110,0,1.336316841,1.443617351,1.170500555,0.696805412,0.953365272,0.953365272,1.170500555,1.443617351,1,1,1
4116,18,37,40,80,64,0,5521.11,34,1220.441,LESS,8,2480,2488,7,1,-16,-1.499853537,16,1.222253018,-0.654694459,0.357178157,144,80,64,0,-0.31912044,0,-0.624266962,0.214865069,-0.320364188,0.320364188,-0.624266962,0,0,1,0
4117,18,38,31,80,78,0,5207.763,14,2820.53,LESS,-928,3002,2074,7,1,-2,-0.187481692,2,-1.222253018,-1.402560571,0.18510447,158,80,78,0,-0.039890055,0,-0.07803337,0.214865069,-1.115171371,1.115171371,-0.07803337,0,0,1,0
4118,18,39,46,124,110,1,6076.576,54,1292.948,LESS,650,2188,2838,7,2,-14,-1.312371845,14,0.87303787,0.093171653,0.662210862,234,124,110,0,1.475932034,1.716734147,1.170500555,0.214865069,0.224792021,0.224792021,1.170500555,1.716734147,1,1,1
4119,18,40,58,92,110,0,4206.846,54,1289.294,LESS,-1034,2656,1622,5,2,18,1.687335229,18,1.571468165,0.093171653,-0.364546489,202,92,110,1,0.837691154,0.468200222,1.170500555,-0.749015615,-1.205181586,1.205181586,1.170500555,0.468200222,1,0,0
4120,18,41,49,110,131,1,7075.798,74,1227.298,MORE,1272,2304,3576,8,2,21,1.968557767,21,2.095290887,0.841037765,1.210931016,241,110,131,0,1.615547226,1.170500555,1.989850943,0.696805412,0.75296517,0.75296517,1.989850943,1.170500555,1,1,1
4121,18,42,13,47,50,1,6712.44,14,2162.617,MORE,-534,3742,3208,9,1,3,0.281222538,3,-1.047645444,-1.402560571,1.011393918,97,47,50,0,-1.256536731,-1.28755061,-1.170500555,1.178745754,-0.780605099,0.780605099,-1.170500555,-1.28755061,0,1,0
4122,18,43,16,50,44,0,4320.861,34,2029.358,MORE,-346,2168,1822,5,1,-6,-0.562445076,6,-0.523822722,-0.654694459,-0.301935449,94,50,44,1,-1.316371814,-1.170500555,-1.404600665,-0.749015615,-0.62096434,0.62096434,-1.404600665,-1.170500555,0,0,0
4123,18,44,7,57,50,0,6032.645,54,1029.605,MORE,62,2668,2730,9,1,-7,-0.656185922,7,-0.349215148,0.093171653,0.638086268,107,57,50,1,-1.057086457,-0.897383758,-1.170500555,1.178745754,-0.274509927,0.274509927,-1.170500555,-0.897383758,0,1,0
4124,18,45,18,42,50,1,6490.056,64,1542.783,MORE,1586,2270,3856,8,2,8,0.749926769,8,-0.174607574,0.467104709,0.889272325,92,42,50,0,-1.356261869,-1.482634036,-1.170500555,0.696805412,1.019599204,1.019599204,-1.170500555,-1.482634036,1,1,1
4125,18,46,51,108,110,1,5453.454,84,1490.19,MORE,1600,2186,3786,8,2,2,0.187481692,2,-1.222253018,1.214970821,0.320025042,218,108,110,0,1.156811594,1.092467184,1.170500555,0.696805412,1.031487345,1.031487345,1.170500555,1.092467184,1,1,1
4126,18,47,31,78,80,1,8890.217,20,1913.574,MORE,-432,4854,4422,10,1,2,0.187481692,2,-1.222253018,-1.178200737,2.207314476,158,78,80,0,-0.039890055,-0.07803337,0,1.660686096,-0.693991496,0.693991496,0,-0.07803337,0,1,0
4127,18,48,58,110,92,0,3306.749,74,2688.896,MORE,-378,1568,1190,5,1,-18,-1.687335229,18,1.571468165,0.841037765,-0.858832408,202,110,92,1,0.837691154,1.170500555,0.468200222,-0.749015615,-0.648137235,0.648137235,0.468200222,1.170500555,1,0,0
4128,18,49,12,50,48,0,5462.756,44,2315.924,MORE,-256,2802,2546,7,2,-2,-0.187481692,2,-1.222253018,-0.280761403,0.325133211,98,50,48,1,-1.236591704,-1.170500555,-1.248533925,0.214865069,-0.544540573,0.544540573,-1.248533925,-1.170500555,0,1,0
4129,18,50,54,110,101,0,4068.082,24,893.655,MORE,-822,2338,1516,5,1,-9,-0.843667615,9,0,-1.028627515,-0.440748377,211,110,101,1,1.017196402,1.170500555,0.819350388,-0.749015615,-1.025161155,1.025161155,0.819350388,1.170500555,0,0,0
4130,18,51,14,46,50,0,5324.076,54,2520.742,MORE,-502,2724,2222,7,1,4,0.374963384,4,-0.87303787,0.093171653,0.24897745,96,46,50,0,-1.276481759,-1.326567295,-1.170500555,0.214865069,-0.753432204,0.753432204,-1.170500555,-1.326567295,0,1,0
4131,18,52,22,80,83,1,3127.338,94,2076.589,MORE,2132,892,3024,4,2,3,0.281222538,3,-1.047645444,1.588903877,-0.95735549,163,80,83,0,0.059835082,0,0.117050055,-1.230955958,1.483236727,1.483236727,0.117050055,0,1,0,1
4132,18,53,6,50,56,1,5073.158,54,2019.24,MORE,576,2008,2584,8,2,6,0.562445076,6,-0.523822722,0.093171653,0.111186485,106,50,56,0,-1.077031484,-1.170500555,-0.936400444,0.696805412,0.161954701,0.161954701,-0.936400444,-1.170500555,0,1,0
4133,18,54,13,50,47,1,2805.148,74,2238.206,MORE,1420,788,2208,4,2,-3,-0.281222538,3,-1.047645444,0.841037765,-1.134285288,97,50,47,1,-1.256536731,-1.170500555,-1.28755061,-1.230955958,0.87863981,0.87863981,-1.28755061,-1.170500555,1,0,1
4134,18,55,46,110,124,1,2704.112,44,620.182,MORE,756,932,1688,4,2,14,1.312371845,14,0.87303787,-0.280761403,-1.189768944,234,110,124,0,1.475932034,1.170500555,1.716734147,-1.230955958,0.314802236,0.314802236,1.716734147,1.170500555,0,0,0
4135,18,56,27,91,80,0,9469.143,14,1257.82,MORE,-376,4990,4614,11,1,-11,-1.031149307,11,0.349215148,-1.402560571,2.525230178,171,91,80,1,0.219395302,0.429183537,0,2.142626439,-0.64643893,0.64643893,0,0.429183537,0,1,0
4136,18,57,40,64,80,1,3309.721,84,1846.02,MORE,2632,1028,3660,4,2,16,1.499853537,16,1.222253018,1.214970821,-0.857200342,144,64,80,0,-0.31912044,-0.624266962,0,-1.230955958,1.907813213,1.907813213,0,-0.624266962,1,0,1
4137,18,58,22,83,80,1,3512.929,54,493.21,MORE,1320,950,2270,4,2,-3,-0.281222538,3,-1.047645444,0.093171653,-0.745609199,163,83,80,1,0.059835082,0.117050055,0,-1.230955958,0.793724513,0.793724513,0,0.117050055,0,0,1
4138,18,59,54,101,110,1,2829.821,94,1972.832,MORE,2280,822,3102,4,2,9,0.843667615,9,0,1.588903877,-1.120736175,211,101,110,0,1.017196402,0.819350388,1.170500555,-1.230955958,1.608911367,1.608911367,1.170500555,0.819350388,1,0,1
4139,18,60,6,56,50,0,7894.319,14,3107.341,MORE,-838,4418,3580,9,1,-6,-0.562445076,6,-0.523822722,-1.402560571,1.660419687,106,56,50,1,-1.077031484,-0.936400444,-1.170500555,1.178745754,-1.038747603,1.038747603,-1.170500555,-0.936400444,0,1,0
4140,18,61,18,50,42,1,4102.758,64,2533.638,MORE,1194,1618,2812,5,2,-8,-0.749926769,8,-0.174607574,0.467104709,-0.421706143,92,50,42,1,-1.356261869,-1.170500555,-1.482634036,-0.749015615,0.686731238,0.686731238,-1.482634036,-1.170500555,0,0,1
4141,18,62,43,110,117,1,5442.824,44,2319.035,MORE,1802,1710,3512,8,2,7,0.656185922,7,-0.349215148,-0.280761403,0.314187605,227,110,117,0,1.336316841,1.170500555,1.443617351,0.696805412,1.203016246,1.203016246,1.443617351,1.170500555,0,1,1
4142,18,63,32,77,80,0,4131.013,34,1658.784,MORE,-298,1784,1486,5,1,3,0.281222538,3,-1.047645444,-0.654694459,-0.406189983,157,77,80,0,-0.059835082,-0.117050055,0,-0.749015615,-0.580204998,0.580204998,0,-0.117050055,0,0,0
4143,18,64,27,80,91,1,4778.66,54,2395.374,MORE,1182,1658,2840,6,2,11,1.031149307,11,0.349215148,0.093171653,-0.050536323,171,80,91,0,0.219395302,0,0.429183537,-0.267075273,0.676541402,0.676541402,0.429183537,0,0,0,1
4144,18,65,16,44,50,1,3386.115,34,2154.066,MORE,-178,2128,1950,4,1,6,0.562445076,6,-0.523822722,-0.654694459,-0.815248776,94,44,50,0,-1.316371814,-1.404600665,-1.170500555,-1.230955958,-0.478306641,0.478306641,-1.170500555,-1.404600665,0,0,0
4145,18,66,7,50,57,1,2518.068,84,3082.993,MORE,1300,1502,2802,4,2,7,0.656185922,7,-0.349215148,1.214970821,-1.291934521,107,50,57,0,-1.057086457,-1.170500555,-0.897383758,-1.230955958,0.776741453,0.776741453,-0.897383758,-1.170500555,1,0,1
4146,18,67,14,50,46,1,5298.538,74,1881.16,MORE,-76,2264,2188,6,2,-4,-0.374963384,4,-0.87303787,0.841037765,0.234953324,96,50,46,1,-1.276481759,-1.170500555,-1.326567295,-0.267075273,-0.391693038,0.391693038,-1.326567295,-1.170500555,1,1,0
4147,18,68,51,110,108,0,3416.423,54,2362.229,MORE,-352,1854,1502,6,2,-2,-0.187481692,2,-1.222253018,0.093171653,-0.798605217,218,110,108,1,1.156811594,1.170500555,1.092467184,-0.267075273,-0.626059258,0.626059258,1.092467184,1.170500555,0,0,0
4148,18,69,50,133,110,0,3039.393,94,1693.932,MORE,602,1580,2182,4,2,-23,-2.15603946,23,2.444506035,1.588903877,-1.005650258,243,133,110,1,1.655437281,2.067884313,1.170500555,-1.230955958,0.184032678,0.184032678,1.170500555,2.067884313,1,0,0
4149,18,70,49,131,110,0,2373.224,84,2092.373,MORE,400,1470,1870,4,2,-21,-1.968557767,21,2.095290887,1.214970821,-1.371475226,241,131,110,1,1.615547226,1.989850943,1.170500555,-1.230955958,0.012503778,0.012503778,1.170500555,1.989850943,1,0,0
4150,18,71,47,126,110,0,5304.009,44,3145.539,MORE,-822,2776,1954,7,1,-16,-1.499853537,16,1.222253018,-0.280761403,0.23795771,236,126,110,1,1.515822089,1.794767517,1.170500555,0.214865069,-1.025161155,1.025161155,1.170500555,1.794767517,0,1,0
4151,18,72,50,110,133,1,2315.723,84,2345.756,MORE,1912,712,2624,3,2,23,2.15603946,23,2.444506035,1.214970821,-1.40305175,243,110,133,0,1.655437281,1.170500555,2.067884313,-1.7128963,1.296423073,1.296423073,2.067884313,1.170500555,1,0,1
4152,18,73,47,110,126,1,3882.361,94,1682.079,MORE,1762,1298,3060,6,2,16,1.499853537,16,1.222253018,1.588903877,-0.54273658,236,110,126,0,1.515822089,1.170500555,1.794767517,-0.267075273,1.169050127,1.169050127,1.794767517,1.170500555,1,0,1
4153,18,74,12,48,50,0,3421.09,34,2205.343,MORE,-126,1814,1688,5,2,2,0.187481692,2,-1.222253018,-0.654694459,-0.796042346,98,48,50,0,-1.236591704,-1.248533925,-1.170500555,-0.749015615,-0.434150686,0.434150686,-1.170500555,-1.248533925,0,0,0
4154,18,75,32,80,77,0,6181.335,14,2941.937,MORE,-902,3754,2852,9,1,-3,-0.281222538,3,-1.047645444,-1.402560571,0.719738993,157,80,77,1,-0.059835082,0,-0.117050055,1.178745754,-1.093093393,1.093093393,-0.117050055,0,0,1,0
4155,18,76,43,117,110,0,4822.684,54,2108.796,MORE,-714,2516,1802,7,1,-7,-0.656185922,7,-0.349215148,0.093171653,-0.026360658,227,117,110,1,1.336316841,1.443617351,1.170500555,0.214865069,-0.933452634,0.933452634,1.170500555,1.443617351,0,1,0
4156,18,77,40,80,64,0,5032.717,74,2202.329,MORE,-404,2494,2090,7,1,-16,-1.499853537,16,1.222253018,0.841037765,0.088978416,144,80,64,1,-0.31912044,0,-0.624266962,0.214865069,-0.670215213,0.670215213,-0.624266962,0,1,1,0
4157,18,78,31,80,78,0,4728.562,64,2985.988,MORE,-1204,2784,1580,6,1,-2,-0.187481692,2,-1.222253018,0.467104709,-0.078047509,158,80,78,1,-0.039890055,0,-0.07803337,-0.267075273,-1.349537591,1.349537591,-0.07803337,0,1,0,0
4158,18,79,46,124,110,0,5177.705,84,3806.263,MORE,598,2874,3472,5,2,-14,-1.312371845,14,0.87303787,1.214970821,0.168598198,234,124,110,1,1.475932034,1.716734147,1.170500555,-0.749015615,0.180636066,0.180636066,1.170500555,1.716734147,1,0,0
4159,18,80,58,92,110,1,3390.173,64,3018.965,MORE,1064,1484,2548,6,1,18,1.687335229,18,1.571468165,0.467104709,-0.813020336,202,92,110,0,0.837691154,0.468200222,1.170500555,-0.267075273,0.576341352,0.576341352,1.170500555,0.468200222,1,0,1
4160,18,81,48,128,110,1,5208.796,44,1743.221,LESS,1306,992,2298,5,2,-18,-1.687335229,18,1.571468165,-0.280761403,0.185671739,238,128,110,0,1.555712144,1.872800887,1.170500555,-0.749015615,0.781836371,0.781836371,1.170500555,1.872800887,1,0,1
4161,18,82,8,50,58,0,4426.965,74,2474.62,LESS,-296,2216,1920,7,2,8,0.749926769,8,-0.174607574,0.841037765,-0.243668714,108,50,58,1,-1.037141429,-1.170500555,-0.858367073,0.214865069,-0.578506692,0.578506692,-0.858367073,-1.170500555,1,1,0
4162,18,83,4,54,50,0,4649.958,4,1192.188,LESS,-932,2776,1844,7,1,-4,-0.374963384,4,-0.87303787,-1.776493627,-0.12121269,104,54,50,0,-1.116921539,-1.014433814,-1.170500555,0.214865069,-1.118567983,1.118567983,-1.170500555,-1.014433814,0,1,0
4163,18,84,37,80,69,1,4222.268,24,1179.6,LESS,1124,1390,2514,6,1,-11,-1.031149307,11,0.349215148,-1.028627515,-0.356077538,149,80,69,0,-0.219395302,0,-0.429183537,-0.267075273,0.62729053,0.62729053,-0.429183537,0,0,0,1
4164,18,85,52,105,110,1,4089.141,24,2496.385,LESS,1286,1254,2540,6,2,5,0.46870423,5,-0.698430296,-1.028627515,-0.429183883,215,105,110,1,1.096976512,0.975417129,1.170500555,-0.267075273,0.764853312,0.764853312,1.170500555,0.975417129,0,0,1
4165,18,86,5,55,50,1,5405.467,0,3685.715,LESS,560,3318,3878,10,1,-5,-0.46870423,5,-0.698430296,-1.926066849,0.293673106,105,55,50,0,-1.096976512,-0.975417129,-1.170500555,1.660686096,0.148368253,0.148368253,-1.170500555,-0.975417129,0,1,1
4166,18,87,30,96,80,1,2681.787,74,2581.256,LESS,420,1062,1482,4,1,-16,-1.499853537,16,1.222253018,0.841037765,-1.202028659,176,96,80,0,0.31912044,0.624266962,0,-1.230955958,0.029486837,0.029486837,0,0.624266962,1,0,1
4167,18,88,33,80,75,1,4838.84,54,1912.625,LESS,1200,1754,2954,8,2,-5,-0.46870423,5,-0.698430296,0.093171653,-0.017488633,155,80,75,0,-0.099725137,0,-0.195083426,0.696805412,0.691826156,0.691826156,-0.195083426,0,1,1,1
4168,18,89,48,110,128,0,2908.082,84,1090.372,LESS,680,1364,2044,5,2,18,1.687335229,18,1.571468165,1.214970821,-1.077759351,238,110,128,1,1.555712144,1.170500555,1.872800887,-0.749015615,0.25026661,0.25026661,1.872800887,1.170500555,1,0,1
4169,18,90,9,59,50,1,4764.191,44,2935.025,LESS,624,2184,2808,9,1,-9,-0.843667615,9,0,-0.280761403,-0.058481936,109,59,50,0,-1.017196402,-0.819350388,-1.170500555,1.178745754,0.202714043,0.202714043,-1.170500555,-0.819350388,0,1,1
4170,18,91,44,110,119,0,6443.599,64,1940.741,LESS,-600,3218,2618,8,2,9,0.843667615,9,0,0.467104709,0.863760585,229,110,119,1,1.376206896,1.170500555,1.521650721,0.696805412,-0.836649195,0.836649195,1.521650721,1.170500555,1,1,0
4171,18,92,2,52,50,1,5246.056,14,1693.41,LESS,254,2964,3218,7,1,-2,-0.187481692,2,-1.222253018,-1.402560571,0.206132971,102,52,50,0,-1.156811594,-1.092467184,-1.170500555,0.214865069,-0.111472557,0.111472557,-1.170500555,-1.092467184,0,1,0
4172,18,93,8,58,50,1,4727.949,24,1749.543,LESS,1298,1526,2824,6,2,-8,-0.749926769,8,-0.174607574,-1.028627515,-0.078384136,108,58,50,0,-1.037141429,-0.858367073,-1.170500555,-0.267075273,0.775043147,0.775043147,-1.170500555,-0.858367073,0,0,1
4173,18,94,44,119,110,1,5236.652,0,1301.762,LESS,972,2286,3258,9,1,-9,-0.843667615,9,0,-1.926066849,0.200968789,229,119,110,0,1.376206896,1.521650721,1.170500555,1.178745754,0.498219278,0.498219278,1.170500555,1.521650721,0,1,1
4174,18,95,34,74,80,0,3206.787,54,1812.731,LESS,-150,1736,1586,5,2,6,0.562445076,6,-0.523822722,0.093171653,-0.913726279,154,74,80,1,-0.119670165,-0.234100111,0,-0.749015615,-0.454530358,0.454530358,0,-0.234100111,1,0,0
4175,18,96,24,86,80,1,6376.202,14,1762.568,LESS,92,3288,3380,8,1,-6,-0.562445076,6,-0.523822722,-1.402560571,0.826749698,166,86,80,0,0.119670165,0.234100111,0,0.696805412,-0.249035338,0.249035338,0,0.234100111,0,1,0
4176,18,97,39,66,80,0,4663.721,64,2261.952,LESS,-926,2634,1708,7,1,14,1.312371845,14,0.87303787,0.467104709,-0.113654775,146,66,80,1,-0.279230385,-0.546233592,0,0.214865069,-1.113473065,1.113473065,0,-0.546233592,1,1,0
4177,18,98,9,50,59,0,2647.401,84,3069.539,LESS,-200,1756,1556,4,2,9,0.843667615,9,0,1.214970821,-1.220911642,109,50,59,1,-1.017196402,-1.170500555,-0.819350388,-1.230955958,-0.496988006,0.496988006,-0.819350388,-1.170500555,1,0,0
4178,18,99,57,94,110,0,6164.809,64,1467.975,LESS,208,2616,2824,5,2,16,1.499853537,16,1.222253018,0.467104709,0.710663784,204,94,110,1,0.877581209,0.546233592,1.170500555,-0.749015615,-0.150533593,0.150533593,1.170500555,0.546233592,1,0,0
4179,18,100,60,110,87,1,5970.937,54,4192.04,LESS,2006,2230,4236,8,2,-23,-2.15603946,23,2.444506035,0.093171653,0.604199481,197,110,87,0,0.737966017,1.170500555,0.273116796,0.696805412,1.376243452,1.376243452,0.273116796,1.170500555,1,1,1
4180,18,101,33,75,80,0,3411.939,64,2257.915,LESS,-1138,2156,1018,5,1,5,0.46870423,5,-0.698430296,0.467104709,-0.801067594,155,75,80,1,-0.099725137,-0.195083426,0,-0.749015615,-1.293493495,1.293493495,0,-0.195083426,1,0,0
4181,18,102,15,50,45,1,2627.966,74,2439.044,LESS,1904,700,2604,4,2,-5,-0.46870423,5,-0.698430296,0.841037765,-1.231584321,95,50,45,0,-1.296426786,-1.170500555,-1.36558398,-1.230955958,1.289629849,1.289629849,-1.36558398,-1.170500555,1,0,1
4182,18,103,59,89,110,0,2841.398,100,2841.046,LESS,744,1646,2390,5,2,21,1.968557767,21,2.095290887,1.81326371,-1.114378695,199,89,110,1,0.777856072,0.351150166,1.170500555,-0.749015615,0.3046124,0.3046124,1.170500555,0.351150166,1,0,1
4183,18,104,29,80,94,0,3157.693,94,2520.303,LESS,560,1748,2308,5,2,14,1.312371845,14,0.87303787,1.588903877,-0.940686121,174,80,94,1,0.279230385,0,0.546233592,-0.749015615,0.148368253,0.148368253,0.546233592,0,1,0,1
4184,18,105,55,110,98,1,6867.889,24,1601.112,LESS,710,2730,3440,10,2,-12,-1.124890153,12,0.523822722,-1.028627515,1.096758331,208,110,98,0,0.957361319,1.170500555,0.702300333,1.660686096,0.275741199,0.275741199,0.702300333,1.170500555,0,1,1
4185,18,106,29,94,80,1,2251.285,74,1920.052,LESS,858,684,1542,4,2,-14,-1.312371845,14,0.87303787,0.841037765,-1.438437709,174,94,80,0,0.279230385,0.546233592,0,-1.230955958,0.401415839,0.401415839,0,0.546233592,1,0,1
4186,18,107,57,110,94,1,6441.037,4,1443.799,LESS,402,3098,3500,8,1,-16,-1.499853537,16,1.222253018,-1.776493627,0.862353669,204,110,94,0,0.877581209,1.170500555,0.546233592,0.696805412,0.014202083,0.014202083,0.546233592,1.170500555,0,1,1
4187,18,108,39,80,66,1,3046.216,64,1670.503,LESS,1238,892,2130,5,1,-14,-1.312371845,14,0.87303787,0.467104709,-1.001903425,146,80,66,0,-0.279230385,0,-0.546233592,-0.749015615,0.724093969,0.724093969,-0.546233592,0,1,0,1
4188,18,109,4,50,54,0,6263.325,74,2528.227,LESS,100,3002,3102,9,2,4,0.374963384,4,-0.87303787,0.841037765,0.764763588,104,50,54,1,-1.116921539,-1.170500555,-1.014433814,1.178745754,-0.242242114,0.242242114,-1.014433814,-1.170500555,1,1,0
4189,18,110,55,98,110,0,3785.637,14,1651.532,LESS,-1630,3082,1452,7,1,12,1.124890153,12,0.523822722,-1.402560571,-0.595852312,208,98,110,1,0.957361319,0.702300333,1.170500555,0.214865069,-1.711276758,1.711276758,1.170500555,0.702300333,0,1,0
4190,18,111,2,50,52,1,2733.086,54,1899.542,LESS,1362,628,1990,4,2,2,0.187481692,2,-1.222253018,0.093171653,-1.173857947,102,50,52,1,-1.156811594,-1.170500555,-1.092467184,-1.230955958,0.829388938,0.829388938,-1.092467184,-1.170500555,1,0,1
4191,18,112,59,110,89,1,2549.217,74,1772.157,LESS,1506,540,2046,4,2,-21,-1.968557767,21,2.095290887,0.841037765,-1.274829129,199,110,89,0,0.777856072,1.170500555,0.351150166,-1.230955958,0.951666966,0.951666966,0.351150166,1.170500555,1,0,1
4192,18,113,60,87,110,0,2723.61,100,1747.292,LESS,902,1356,2258,5,2,23,2.15603946,23,2.444506035,1.81326371,-1.179061668,197,87,110,1,0.737966017,0.273116796,1.170500555,-0.749015615,0.43877857,0.43877857,1.170500555,0.273116796,1,0,1
4193,18,114,52,110,105,0,7797.761,4,1449.62,LESS,-1046,4408,3362,11,1,-5,-0.46870423,5,-0.698430296,-1.776493627,1.607395114,215,110,105,0,1.096976512,1.170500555,0.975417129,2.142626439,-1.215371421,1.215371421,0.975417129,1.170500555,0,1,0
4194,18,115,30,80,96,0,2058.104,94,1787.583,LESS,1066,1064,2130,3,2,16,1.499853537,16,1.222253018,1.588903877,-1.544522552,176,80,96,1,0.31912044,0,0.624266962,-1.7128963,0.578039658,0.578039658,0.624266962,0,1,0,1
4195,18,116,24,80,86,0,3299.447,44,1193.7,LESS,-776,1898,1122,5,1,6,0.562445076,6,-0.523822722,-0.280761403,-0.862842282,166,80,86,1,0.119670165,0,0.234100111,-0.749015615,-0.986100119,0.986100119,0.234100111,0,0,0,0
4196,18,117,5,50,55,1,7186.69,24,1253.391,LESS,1024,2812,3836,10,2,5,0.46870423,5,-0.698430296,-1.028627515,1.271827068,105,50,55,1,-1.096976512,-1.170500555,-0.975417129,1.660686096,0.542375233,0.542375233,-0.975417129,-1.170500555,0,1,1
4197,18,118,34,80,74,0,4215.198,44,1978.062,LESS,-682,2136,1454,4,1,-6,-0.562445076,6,-0.523822722,-0.280761403,-0.35996001,154,80,74,0,-0.119670165,0,-0.234100111,-1.230955958,-0.906279739,0.906279739,-0.234100111,0,0,0,0
4198,18,119,15,45,50,0,5900.336,20,3005.876,LESS,-2092,4658,2566,9,1,5,0.46870423,5,-0.698430296,-1.178200737,0.565429126,95,45,50,1,-1.296426786,-1.36558398,-1.170500555,1.178745754,-2.103585431,2.103585431,-1.170500555,-1.36558398,0,1,0
4199,18,120,37,69,80,0,2816.864,64,1623.158,LESS,-312,1402,1090,5,1,11,1.031149307,11,0.349215148,0.467104709,-1.127851477,149,69,80,1,-0.219395302,-0.429183537,0,-0.749015615,-0.592093139,0.592093139,0,-0.429183537,1,0,0
4200,18,121,48,128,110,0,6173.666,74,2308.675,MORE,-684,2826,2142,10,2,-18,-1.687335229,18,1.571468165,0.841037765,0.715527582,238,128,110,1,1.555712144,1.872800887,1.170500555,1.660686096,-0.907978045,0.907978045,1.170500555,1.872800887,1,1,0
4201,18,122,8,50,58,1,3306.925,54,2173.463,MORE,1072,1052,2124,6,2,8,0.749926769,8,-0.174607574,0.093171653,-0.858735758,108,50,58,0,-1.037141429,-1.170500555,-0.858367073,-0.267075273,0.583134575,0.583134575,-0.858367073,-1.170500555,0,1,1
4202,18,123,4,54,50,0,6664.722,4,2708.727,MORE,-1966,4788,2822,9,1,-4,-0.374963384,4,-0.87303787,-1.776493627,0.985189703,104,54,50,1,-1.116921539,-1.014433814,-1.170500555,1.178745754,-1.996592157,1.996592157,-1.170500555,-1.014433814,0,1,0
4203,18,124,37,80,69,0,6250.446,14,1958.329,MORE,-2320,4762,2442,9,1,-11,-1.031149307,11,0.349215148,-1.402560571,0.757691119,149,80,69,1,-0.219395302,0,-0.429183537,1.178745754,-2.297192309,2.297192309,-0.429183537,0,0,1,0
4204,18,125,52,105,110,1,3739.708,74,2060.356,MORE,1374,1294,2668,6,2,5,0.46870423,5,-0.698430296,0.841037765,-0.621074103,215,105,110,0,1.096976512,0.975417129,1.170500555,-0.267075273,0.839578773,0.839578773,1.170500555,0.975417129,1,1,1
4205,18,126,5,55,50,0,7016.376,54,1539.984,MORE,-636,3114,2478,9,1,-5,-0.46870423,5,-0.698430296,0.093171653,1.17829958,105,55,50,1,-1.096976512,-0.975417129,-1.170500555,1.178745754,-0.867218703,0.867218703,-1.170500555,-0.975417129,0,1,0
4206,18,127,30,96,80,0,2834.924,64,2279.198,MORE,-458,1508,1050,5,1,-16,-1.499853537,16,1.222253018,0.467104709,-1.117933876,176,96,80,1,0.31912044,0.624266962,0,-0.749015615,-0.716069473,0.716069473,0,0.624266962,1,0,0
4207,18,128,33,80,75,1,7416.059,84,1492.854,MORE,1996,2694,4690,8,2,-5,-0.46870423,5,-0.698430296,1.214970821,1.397784456,155,80,75,1,-0.099725137,0,-0.195083426,0.696805412,1.367751922,1.367751922,-0.195083426,0,1,1,1
4208,18,129,48,110,128,1,2708.862,94,2774.308,MORE,3372,656,4028,4,2,18,1.687335229,18,1.571468165,1.588903877,-1.187160494,238,110,128,0,1.555712144,1.170500555,1.872800887,-1.230955958,2.536186413,2.536186413,1.872800887,1.170500555,1,0,1
4209,18,130,9,59,50,0,3080.123,74,2204.839,MORE,478,1824,2302,5,2,-9,-0.843667615,9,0,0.841037765,-0.983283484,109,59,50,1,-1.017196402,-0.819350388,-1.170500555,-0.749015615,0.078737709,0.078737709,-1.170500555,-0.819350388,1,0,0
4210,18,131,44,110,119,1,5181.807,44,1341.212,MORE,248,2142,2390,7,2,9,0.843667615,9,0,-0.280761403,0.1708508,229,110,119,0,1.376206896,1.170500555,1.521650721,0.214865069,-0.116567474,0.116567474,1.521650721,1.170500555,0,1,0
4211,18,132,2,52,50,1,7452.204,4,2157.18,MORE,1170,3242,4412,11,1,-2,-0.187481692,2,-1.222253018,-1.776493627,1.417633389,102,52,50,1,-1.156811594,-1.092467184,-1.170500555,2.142626439,0.666351567,0.666351567,-1.170500555,-1.092467184,0,1,1
4212,18,133,8,58,50,0,2372.702,94,2111.031,MORE,420,1624,2044,3,2,-8,-0.749926769,8,-0.174607574,1.588903877,-1.371761881,108,58,50,1,-1.037141429,-0.858367073,-1.170500555,-1.7128963,0.029486837,0.029486837,-1.170500555,-0.858367073,1,0,0
4213,18,134,44,119,110,1,10680.274,44,2536.874,MORE,1546,3596,5142,12,2,-9,-0.843667615,9,0,-0.280761403,3.190319606,229,119,110,1,1.376206896,1.521650721,1.170500555,2.624566781,0.985633085,0.985633085,1.170500555,1.521650721,0,1,1
4214,18,135,34,74,80,1,6787.801,24,1528.683,MORE,322,2976,3298,10,1,6,0.562445076,6,-0.523822722,-1.028627515,1.052778215,154,74,80,0,-0.119670165,-0.234100111,0,1.660686096,-0.053730154,0.053730154,0,-0.234100111,0,1,0
4215,18,136,24,86,80,0,6399.58,14,1652.122,MORE,-1454,4110,2656,9,1,-6,-0.562445076,6,-0.523822722,-1.402560571,0.839587666,166,86,80,1,0.119670165,0.234100111,0,1.178745754,-1.561825834,1.561825834,0,0.234100111,0,1,0
4216,18,137,39,66,80,1,1399.156,54,2009.495,MORE,794,342,1136,2,2,14,1.312371845,14,0.87303787,0.093171653,-1.906382126,146,66,80,0,-0.279230385,-0.546233592,0,-2.194836642,0.347070049,0.347070049,0,-0.546233592,0,0,1
4217,18,138,9,50,59,1,2122.066,84,1563.226,MORE,1922,662,2584,4,2,9,0.843667615,9,0,1.214970821,-1.509397986,109,50,59,0,-1.017196402,-1.170500555,-0.819350388,-1.230955958,1.304914602,1.304914602,-0.819350388,-1.170500555,1,0,1
4218,18,139,57,94,110,1,3394.367,64,2546.805,MORE,1056,958,2014,6,2,16,1.499853537,16,1.222253018,0.467104709,-0.810717212,204,94,110,0,0.877581209,0.546233592,1.170500555,-0.267075273,0.569548128,0.569548128,1.170500555,0.546233592,1,0,1
4219,18,140,60,110,87,0,4659.232,84,2494.98,MORE,-252,2550,2298,8,2,-23,-2.15603946,23,2.444506035,1.214970821,-0.116119897,197,110,87,1,0.737966017,1.170500555,0.273116796,0.696805412,-0.541143961,0.541143961,0.273116796,1.170500555,1,1,0
4220,18,141,33,75,80,0,6347.686,24,2475.3,MORE,-126,2752,2626,7,1,5,0.46870423,5,-0.698430296,-1.028627515,0.811090211,155,75,80,0,-0.099725137,-0.195083426,0,0.214865069,-0.434150686,0.434150686,0,-0.195083426,0,1,0
4221,18,142,15,50,45,1,4806.331,44,3158.224,MORE,1548,1682,3230,8,2,-5,-0.46870423,5,-0.698430296,-0.280761403,-0.035340865,95,50,45,1,-1.296426786,-1.170500555,-1.36558398,0.696805412,0.987331391,0.987331391,-1.36558398,-1.170500555,0,1,1
4222,18,143,59,89,110,1,3109.061,94,2660.011,MORE,2724,784,3508,4,2,21,1.968557767,21,2.095290887,1.588903877,-0.967392257,199,89,110,0,0.777856072,0.351150166,1.170500555,-1.230955958,1.985935287,1.985935287,1.170500555,0.351150166,1,0,1
4223,18,144,29,80,94,1,4449.014,74,2092.286,MORE,1126,1534,2660,6,2,14,1.312371845,14,0.87303787,0.841037765,-0.231560564,174,80,94,0,0.279230385,0,0.546233592,-0.267075273,0.628988836,0.628988836,0.546233592,0,1,0,1
4224,18,145,55,110,98,0,3725.623,84,2505.987,MORE,1086,2114,3200,6,2,-12,-1.124890153,12,0.523822722,1.214970821,-0.628808844,208,110,98,1,0.957361319,1.170500555,0.702300333,-0.267075273,0.595022717,0.595022717,0.702300333,1.170500555,1,0,1
4225,18,146,29,94,80,0,4789.33,54,2530.498,MORE,-1020,2872,1852,7,1,-14,-1.312371845,14,0.87303787,0.093171653,-0.04467692,174,94,80,1,0.279230385,0.546233592,0,0.214865069,-1.193293444,1.193293444,0,0.546233592,0,1,0
4226,18,147,57,110,94,0,4982.533,54,3118.883,MORE,-1098,2910,1812,7,1,-16,-1.499853537,16,1.222253018,0.093171653,0.061420003,204,110,94,1,0.877581209,1.170500555,0.546233592,0.214865069,-1.259527376,1.259527376,0.546233592,1.170500555,0,1,0
4227,18,148,39,80,66,0,3483.972,74,1445.683,MORE,-772,2068,1296,5,1,-14,-1.312371845,14,0.87303787,0.841037765,-0.76151086,146,80,66,1,-0.279230385,0,-0.546233592,-0.749015615,-0.982703507,0.982703507,-0.546233592,0,1,0,0
4228,18,149,4,50,54,1,6542.814,24,1481.964,MORE,2254,2026,4280,8,2,4,0.374963384,4,-0.87303787,-1.028627515,0.918244243,104,50,54,0,-1.116921539,-1.170500555,-1.014433814,0.696805412,1.586833389,1.586833389,-1.014433814,-1.170500555,0,1,1
4229,18,150,55,98,110,1,2421.26,94,1321.258,MORE,1836,790,2626,4,2,12,1.124890153,12,0.523822722,1.588903877,-1.345096382,208,98,110,0,0.957361319,0.702300333,1.170500555,-1.230955958,1.231887447,1.231887447,1.170500555,0.702300333,1,0,1
4230,18,151,2,50,52,1,5013.56,24,2145.031,MORE,1024,1730,2754,6,1,2,0.187481692,2,-1.222253018,-1.028627515,0.078458399,102,50,52,0,-1.156811594,-1.170500555,-1.092467184,-0.267075273,0.542375233,0.542375233,-1.092467184,-1.170500555,0,0,1
4231,18,152,59,110,89,0,2292.479,94,2299.181,MORE,1104,1638,2742,3,2,-21,-1.968557767,21,2.095290887,1.588903877,-1.415816132,199,110,89,1,0.777856072,1.170500555,0.351150166,-1.7128963,0.610307471,0.610307471,0.351150166,1.170500555,1,0,1
4232,18,153,60,87,110,1,2516.337,100,2486.675,MORE,3534,624,4158,4,2,23,2.15603946,23,2.444506035,1.81326371,-1.292885095,197,87,110,0,0.737966017,0.273116796,1.170500555,-1.230955958,2.673749195,2.673749195,1.170500555,0.273116796,1,0,1
4233,18,154,52,110,105,1,5471.705,64,1221.634,MORE,1378,1858,3236,8,2,-5,-0.46870423,5,-0.698430296,0.467104709,0.330047531,215,110,105,1,1.096976512,1.170500555,0.975417129,0.696805412,0.842975385,0.842975385,0.975417129,1.170500555,1,1,1
4234,18,155,30,80,96,1,3739.22,64,1318.869,MORE,1282,1148,2430,6,2,16,1.499853537,16,1.222253018,0.467104709,-0.621342087,176,80,96,0,0.31912044,0,0.624266962,-0.267075273,0.7614567,0.7614567,0.624266962,0,1,0,1
4235,18,156,24,80,86,1,5058.54,64,935.057,MORE,1184,1930,3114,6,2,6,0.562445076,6,-0.523822722,0.467104709,0.103159049,166,80,86,0,0.119670165,0,0.234100111,-0.267075273,0.678239708,0.678239708,0.234100111,0,1,0,1
4236,18,157,5,50,55,1,2488.417,54,3109.567,MORE,882,796,1678,4,2,5,0.46870423,5,-0.698430296,0.093171653,-1.30821729,105,50,55,0,-1.096976512,-1.170500555,-0.975417129,-1.230955958,0.421795511,0.421795511,-0.975417129,-1.170500555,0,0,1
4237,18,158,34,80,74,1,3917.856,84,2476.952,MORE,2064,1518,3582,6,2,-6,-0.562445076,6,-0.523822722,1.214970821,-0.523244593,154,80,74,1,-0.119670165,0,-0.234100111,-0.267075273,1.425494325,1.425494325,-0.234100111,0,1,0,1
4238,18,159,15,45,50,1,2324.17,94,1884.26,MORE,1504,756,2260,4,2,5,0.46870423,5,-0.698430296,1.588903877,-1.398413102,95,45,50,0,-1.296426786,-1.36558398,-1.170500555,-1.230955958,0.94996866,0.94996866,-1.170500555,-1.36558398,1,0,1
4239,18,160,37,69,80,1,3251.904,74,3132.287,MORE,1308,1680,2988,6,2,11,1.031149307,11,0.349215148,0.841037765,-0.888950397,149,69,80,0,-0.219395302,-0.429183537,0,-0.267075273,0.783534677,0.783534677,0,-0.429183537,1,0,1
4240,18,161,3,50,53,1,6017.063,14,2156.036,LESS,-292,3180,2888,7,1,3,0.281222538,3,-1.047645444,-1.402560571,0.629529453,103,50,53,1,-1.136866566,-1.170500555,-1.053450499,0.214865069,-0.57511008,0.57511008,-1.053450499,-1.170500555,0,1,0
4241,18,162,20,50,40,1,2575.931,64,1739.507,LESS,1188,608,1796,4,2,-10,-0.937408461,10,0.174607574,0.467104709,-1.260159206,90,50,40,0,-1.396151924,-1.170500555,-1.560667406,-1.230955958,0.68163632,0.68163632,-1.560667406,-1.170500555,1,0,1
4242,18,163,25,80,88,0,2723.84,54,2559.601,LESS,-588,1678,1090,5,1,8,0.749926769,8,-0.174607574,0.093171653,-1.178935364,168,80,88,1,0.15956022,0,0.312133481,-0.749015615,-0.82645936,0.82645936,0.312133481,0,1,0,0
4243,18,164,42,115,110,0,5661.448,4,2570.266,LESS,-2204,4380,2176,9,1,-5,-0.46870423,5,-0.698430296,-1.776493627,0.434244404,225,115,110,0,1.296426786,1.36558398,1.170500555,1.178745754,-2.198690564,2.198690564,1.170500555,1.36558398,0,1,0
4244,18,165,53,103,110,0,5683.16,54,1917.416,LESS,-538,2938,2400,7,1,7,0.656185922,7,-0.349215148,0.093171653,0.446167492,213,103,110,1,1.057086457,0.897383758,1.170500555,0.214865069,-0.784001711,0.784001711,1.170500555,0.897383758,1,1,0
4245,18,166,26,90,80,0,5453.071,24,2226.477,LESS,538,2360,2898,8,1,-10,-0.937408461,10,0.174607574,-1.028627515,0.319814718,170,90,80,0,0.199450275,0.390166852,0,0.696805412,0.129686888,0.129686888,0,0.390166852,0,1,1
4246,18,167,35,80,72,1,8881.82,74,2091.707,LESS,3318,2804,6122,12,2,-8,-0.749926769,8,-0.174607574,0.841037765,2.202703285,152,80,72,0,-0.15956022,0,-0.312133481,2.624566781,2.490332153,2.490332153,-0.312133481,0,1,1,1
4247,18,168,28,93,80,1,2949.378,64,2051.21,LESS,1670,670,2340,4,2,-13,-1.218630999,13,0.698430296,0.467104709,-1.05508176,173,93,80,0,0.259285357,0.507216907,0,-1.230955958,1.090928053,1.090928053,0,0.507216907,1,0,1
4248,18,169,26,80,90,0,4752.435,44,1833.408,LESS,-922,2684,1762,7,1,10,0.937408461,10,0.174607574,-0.280761403,-0.064937713,170,80,90,1,0.199450275,0,0.390166852,0.214865069,-1.110076453,1.110076453,0.390166852,0,0,1,0
4249,18,170,25,88,80,1,3419.387,64,1331.843,LESS,796,1200,1996,6,2,-8,-0.749926769,8,-0.174607574,0.467104709,-0.796977544,168,88,80,0,0.15956022,0.312133481,0,-0.267075273,0.348768355,0.348768355,0,0.312133481,1,0,1
4250,18,171,36,80,70,1,3879.152,44,1413.625,LESS,1582,1140,2722,6,2,-10,-0.937408461,10,0.174607574,-0.280761403,-0.544498794,150,80,70,0,-0.199450275,0,-0.390166852,-0.267075273,1.016202592,1.016202592,-0.390166852,0,1,0,1
4251,18,172,28,80,93,0,8826.808,0,2301.072,LESS,-1286,5018,3732,13,1,13,1.218630999,13,0.698430296,-1.926066849,2.172493589,173,80,93,1,0.259285357,0,0.507216907,3.106507123,-1.419168135,1.419168135,0.507216907,0,0,1,0
4252,18,173,21,82,80,1,3863.504,14,1508.245,LESS,424,1714,2138,5,1,-2,-0.187481692,2,-1.222253018,-1.402560571,-0.553091852,162,82,80,0,0.039890055,0.07803337,0,-0.749015615,0.032883449,0.032883449,0,0.07803337,0,0,1
4253,18,174,19,50,41,0,5034.392,34,1893.863,LESS,-1076,3074,1998,7,1,-9,-0.843667615,9,0,-0.654694459,0.089898238,91,50,41,0,-1.376206896,-1.170500555,-1.521650721,0.214865069,-1.240846011,1.240846011,-1.521650721,-1.170500555,0,0,0
4254,18,175,56,96,110,0,6175.267,64,1601.397,LESS,-732,2952,2220,6,2,14,1.312371845,14,0.87303787,0.467104709,0.716406767,206,96,110,1,0.917471264,0.624266962,1.170500555,-0.267075273,-0.948737388,0.948737388,1.170500555,0.624266962,1,0,0
4255,18,176,23,80,85,0,4978.406,84,1262.632,LESS,764,2344,3108,7,2,5,0.46870423,5,-0.698430296,1.214970821,0.059153672,165,80,85,1,0.099725137,0,0.195083426,0.214865069,0.32159546,0.32159546,0.195083426,0,1,1,1
4256,18,177,10,60,50,1,4372.513,74,2000.103,LESS,2010,1106,3116,6,2,-10,-0.937408461,10,0.174607574,0.841037765,-0.273570888,110,60,50,0,-0.997251374,-0.780333703,-1.170500555,-0.267075273,1.379640064,1.379640064,-1.170500555,-0.780333703,1,0,1
4257,18,178,19,41,50,0,4613.582,54,1321.117,LESS,-124,2286,2162,7,2,9,0.843667615,9,0,0.093171653,-0.141188476,91,41,50,1,-1.376206896,-1.521650721,-1.170500555,0.214865069,-0.43245238,0.43245238,-1.170500555,-1.521650721,1,1,0
4258,18,179,56,110,96,1,2679.603,64,2111.611,LESS,994,872,1866,4,2,-14,-1.312371845,14,0.87303787,0.467104709,-1.203227997,206,110,96,0,0.917471264,1.170500555,0.624266962,-1.230955958,0.516900643,0.516900643,0.624266962,1.170500555,1,0,1
4259,18,180,35,72,80,0,3975.951,84,1199.218,LESS,620,2000,2620,7,2,8,0.749926769,8,-0.174607574,1.214970821,-0.491341876,152,72,80,1,-0.15956022,-0.312133481,0,0.214865069,0.199317432,0.199317432,0,-0.312133481,1,1,1
4260,18,181,11,49,50,0,4491.586,14,2375.832,LESS,-1768,3614,1846,7,1,1,0.093740846,1,-1.396860592,-1.402560571,-0.208182261,99,49,50,1,-1.216646676,-1.20951724,-1.170500555,0.214865069,-1.828459868,1.828459868,-1.170500555,-1.20951724,0,1,0
4261,18,182,17,43,50,0,4356.596,24,1116.619,LESS,-496,1954,1458,5,1,7,0.656185922,7,-0.349215148,-1.028627515,-0.282311667,93,43,50,1,-1.336316841,-1.443617351,-1.170500555,-0.749015615,-0.748337286,0.748337286,-1.170500555,-1.443617351,0,0,0
4262,18,183,1,51,50,0,6134.14,34,1287.95,LESS,342,2660,3002,7,1,-1,-0.093740846,1,-1.396860592,-0.654694459,0.693821982,101,51,50,0,-1.176756621,-1.131483869,-1.170500555,0.214865069,-0.036747095,0.036747095,-1.170500555,-1.131483869,0,1,0
4263,18,184,41,112,110,1,4599.457,34,2853.482,LESS,1072,1652,2724,6,2,-2,-0.187481692,2,-1.222253018,-0.654694459,-0.148945183,222,112,110,0,1.236591704,1.248533925,1.170500555,-0.267075273,0.583134575,0.583134575,1.170500555,1.248533925,0,0,1
4264,18,185,20,40,50,0,3430.558,74,1786.151,LESS,-608,1986,1378,5,2,10,0.937408461,10,0.174607574,0.841037765,-0.790843019,90,40,50,1,-1.396151924,-1.560667406,-1.170500555,-0.749015615,-0.843442419,0.843442419,-1.170500555,-1.560667406,1,0,0
4265,18,186,1,50,51,0,8016.204,4,2517.612,LESS,-2090,5548,3458,11,1,1,0.093740846,1,-1.396860592,-1.776493627,1.727352517,101,50,51,1,-1.176756621,-1.170500555,-1.131483869,2.142626439,-2.101887125,2.101887125,-1.131483869,-1.170500555,0,1,0
4266,18,187,23,85,80,1,5871.492,24,2397.388,LESS,604,2166,2770,6,2,-5,-0.46870423,5,-0.698430296,-1.028627515,0.549589518,165,85,80,0,0.099725137,0.195083426,0,-0.267075273,0.185730984,0.185730984,0,0.195083426,0,0,1
4267,18,188,11,50,49,1,4372.459,34,1483.192,LESS,806,1732,2538,6,2,-1,-0.093740846,1,-1.396860592,-0.654694459,-0.273600542,99,50,49,0,-1.216646676,-1.170500555,-1.20951724,-0.267075273,0.357259885,0.357259885,-1.20951724,-1.170500555,0,0,1
4268,18,189,17,50,43,1,3623.74,64,1499.676,LESS,1644,950,2594,6,2,-7,-0.656185922,7,-0.349215148,0.467104709,-0.684757627,93,50,43,0,-1.336316841,-1.170500555,-1.443617351,-0.267075273,1.068850076,1.068850076,-1.443617351,-1.170500555,1,0,1
4269,18,190,21,80,82,0,6436.606,30,2256.549,LESS,-2394,4814,2420,9,1,2,0.187481692,2,-1.222253018,-0.804267681,0.859920397,162,80,82,1,0.039890055,0,0.07803337,1.178745754,-2.360029629,2.360029629,0.07803337,0,0,1,0
4270,18,191,10,50,60,0,2586.793,84,1562.135,LESS,750,1458,2208,5,2,10,0.937408461,10,0.174607574,1.214970821,-1.254194367,110,50,60,1,-0.997251374,-1.170500555,-0.780333703,-0.749015615,0.309707318,0.309707318,-0.780333703,-1.170500555,1,0,1
4271,18,192,3,53,50,0,3935.492,24,1626.97,LESS,-1780,3298,1518,5,1,-3,-0.281222538,3,-1.047645444,-1.028627515,-0.51355983,103,53,50,0,-1.136866566,-1.053450499,-1.170500555,-0.749015615,-1.838649704,1.838649704,-1.170500555,-1.053450499,0,0,0
4272,18,193,45,122,110,1,3661.471,34,2266.363,LESS,1416,1110,2526,6,2,-12,-1.124890153,12,0.523822722,-0.654694459,-0.664037747,232,122,110,0,1.436041979,1.638700776,1.170500555,-0.267075273,0.875243198,0.875243198,1.170500555,1.638700776,0,0,1
4273,18,194,38,67,80,0,3447.305,44,2615.057,LESS,-1322,2584,1262,5,1,13,1.218630999,13,0.698430296,-0.280761403,-0.781646447,147,67,80,1,-0.259285357,-0.507216907,0,-0.749015615,-1.449737642,1.449737642,0,-0.507216907,0,0,0
4274,18,195,38,80,67,1,6868.153,24,2522.622,LESS,990,2926,3916,8,2,-13,-1.218630999,13,0.698430296,-1.028627515,1.096903306,147,80,67,0,-0.259285357,0,-0.507216907,0.696805412,0.513504032,0.513504032,-0.507216907,0,0,1,1
4275,18,196,36,70,80,0,3567.491,34,1269.976,LESS,-716,2114,1398,5,1,10,0.937408461,10,0.174607574,-0.654694459,-0.715646619,150,70,80,1,-0.199450275,-0.390166852,0,-0.749015615,-0.93515094,0.93515094,0,-0.390166852,0,0,0
4276,18,197,45,110,122,1,1691.779,64,1261.538,LESS,1292,322,1614,2,2,12,1.124890153,12,0.523822722,0.467104709,-1.745688969,232,110,122,1,1.436041979,1.170500555,1.638700776,-2.194836642,0.769948229,0.769948229,1.638700776,1.170500555,1,0,1
4277,18,198,42,110,115,0,2812.001,44,1845.755,LESS,-530,1660,1130,5,1,5,0.46870423,5,-0.698430296,-0.280761403,-1.130521981,225,110,115,1,1.296426786,1.170500555,1.36558398,-0.749015615,-0.777208487,0.777208487,1.36558398,1.170500555,0,0,0
4278,18,199,41,110,112,0,3308.412,44,2087.043,LESS,-1064,2188,1124,5,1,2,0.187481692,2,-1.222253018,-0.280761403,-0.857919176,222,110,112,1,1.236591704,1.170500555,1.248533925,-0.749015615,-1.230656175,1.230656175,1.248533925,1.170500555,0,0,0
4279,18,200,53,110,103,1,4751.335,54,1692.418,LESS,1182,1816,2998,7,2,-7,-0.656185922,7,-0.349215148,0.093171653,-0.065541775,213,110,103,0,1.057086457,1.170500555,0.897383758,0.214865069,0.676541402,0.676541402,0.897383758,1.170500555,1,1,1
4280,18,201,3,50,53,1,4483.769,44,1852.436,MORE,904,1554,2458,6,1,3,0.281222538,3,-1.047645444,-0.280761403,-0.212474946,103,50,53,0,-1.136866566,-1.170500555,-1.053450499,-0.267075273,0.440476876,0.440476876,-1.053450499,-1.170500555,0,0,1
4281,18,202,20,50,40,0,4823.128,24,1601.541,MORE,-814,2512,1698,7,1,-10,-0.937408461,10,0.174607574,-1.028627515,-0.026116837,90,50,40,1,-1.396151924,-1.170500555,-1.560667406,0.214865069,-1.018367932,1.018367932,-1.560667406,-1.170500555,0,1,0
4282,18,203,25,80,88,1,4383.019,44,3006.177,MORE,2418,1136,3554,6,2,8,0.749926769,8,-0.174607574,-0.280761403,-0.267801546,168,80,88,0,0.15956022,0,0.312133481,-0.267075273,1.726094477,1.726094477,0.312133481,0,0,0,1
4283,18,204,42,115,110,0,3856.271,74,2523,MORE,-146,2124,1978,7,2,-5,-0.46870423,5,-0.698430296,0.841037765,-0.557063835,225,115,110,1,1.296426786,1.36558398,1.170500555,0.214865069,-0.451133746,0.451133746,1.170500555,1.36558398,1,1,0
4284,18,205,53,103,110,1,6145.383,24,1770.188,MORE,692,2456,3148,8,2,7,0.656185922,7,-0.349215148,-1.028627515,0.699996046,213,103,110,0,1.057086457,0.897383758,1.170500555,0.696805412,0.260456446,0.260456446,1.170500555,0.897383758,0,1,0
4285,18,206,26,90,80,0,6684.002,84,1690.187,MORE,1658,2948,4606,9,2,-10,-0.937408461,10,0.174607574,1.214970821,0.995777265,170,90,80,1,0.199450275,0.390166852,0,1.178745754,1.080738218,1.080738218,0,0.390166852,1,1,1
4286,18,207,35,80,72,0,4152.188,24,1938.872,MORE,-140,2178,2038,5,1,-8,-0.749926769,8,-0.174607574,-1.028627515,-0.394561787,152,80,72,1,-0.15956022,0,-0.312133481,-0.749015615,-0.446038828,0.446038828,-0.312133481,0,0,0,0
4287,18,208,28,93,80,0,5040.329,54,1156.432,MORE,-336,2480,2144,7,1,-13,-1.218630999,13,0.698430296,0.093171653,0.093158526,173,93,80,1,0.259285357,0.507216907,0,0.214865069,-0.612472811,0.612472811,0,0.507216907,0,1,0
4288,18,209,26,80,90,1,3192.435,84,2213.572,MORE,1586,1000,2586,4,2,10,0.937408461,10,0.174607574,1.214970821,-0.921607643,170,80,90,0,0.199450275,0,0.390166852,-1.230955958,1.019599204,1.019599204,0.390166852,0,1,0,1
4289,18,210,25,88,80,1,5972.841,64,2635.056,MORE,954,2316,3270,10,2,-8,-0.749926769,8,-0.174607574,0.467104709,0.605245057,168,88,80,1,0.15956022,0.312133481,0,1.660686096,0.482934525,0.482934525,0,0.312133481,1,1,1
4290,18,211,36,80,70,0,4411.7,94,2616.311,MORE,344,2580,2924,7,2,-10,-0.937408461,10,0.174607574,1.588903877,-0.252051449,150,80,70,1,-0.199450275,0,-0.390166852,0.214865069,-0.035048789,0.035048789,-0.390166852,0,1,1,0
4291,18,212,28,80,93,1,2609.029,84,1860.889,MORE,2316,784,3100,4,2,13,1.218630999,13,0.698430296,1.214970821,-1.241983525,173,80,93,0,0.259285357,0,0.507216907,-1.230955958,1.639480874,1.639480874,0.507216907,0,1,0,1
4292,18,213,21,82,80,1,6391.76,74,1748.969,MORE,2056,2026,4082,8,2,-2,-0.187481692,2,-1.222253018,0.841037765,0.835293333,162,82,80,1,0.039890055,0.07803337,0,0.696805412,1.418701101,1.418701101,0,0.07803337,1,1,1
4293,18,214,19,50,41,0,1840.682,54,1467.3,MORE,-500,1202,702,3,1,-9,-0.843667615,9,0,0.093171653,-1.663919276,91,50,41,1,-1.376206896,-1.170500555,-1.521650721,-1.7128963,-0.751733898,0.751733898,-1.521650721,-1.170500555,0,0,0
4294,18,215,56,96,110,1,2030.775,84,1503.476,MORE,1438,668,2106,4,2,14,1.312371845,14,0.87303787,1.214970821,-1.559530201,206,96,110,0,0.917471264,0.624266962,1.170500555,-1.230955958,0.893924564,0.893924564,1.170500555,0.624266962,1,0,1
4295,18,216,23,80,85,0,2881.835,54,1690.923,MORE,-574,1778,1204,5,2,5,0.46870423,5,-0.698430296,0.093171653,-1.092172822,165,80,85,0,0.099725137,0,0.195083426,-0.749015615,-0.814571218,0.814571218,0.195083426,0,0,0,0
4296,18,217,10,60,50,0,3080.954,44,2310.961,MORE,-418,1744,1326,5,1,-10,-0.937408461,10,0.174607574,-0.280761403,-0.982827143,110,60,50,1,-0.997251374,-0.780333703,-1.170500555,-0.749015615,-0.682103354,0.682103354,-1.170500555,-0.780333703,0,0,0
4297,18,218,19,41,50,1,3003.969,64,1555.687,MORE,1424,806,2230,4,2,9,0.843667615,9,0,0.467104709,-1.025103255,91,41,50,0,-1.376206896,-1.521650721,-1.170500555,-1.230955958,0.882036422,0.882036422,-1.170500555,-1.521650721,1,0,1
4298,18,219,56,110,96,0,5303.755,84,3359.031,MORE,1234,2248,3482,7,2,-14,-1.312371845,14,0.87303787,1.214970821,0.237818226,206,110,96,1,0.917471264,1.170500555,0.624266962,0.214865069,0.720697357,0.720697357,0.624266962,1.170500555,1,1,1
4299,18,220,35,72,80,1,5176.889,54,2472.515,MORE,1232,2068,3300,8,2,8,0.749926769,8,-0.174607574,0.093171653,0.168150093,152,72,80,0,-0.15956022,-0.312133481,0,0.696805412,0.718999051,0.718999051,0,-0.312133481,0,1,1
4300,18,221,11,49,50,1,3426.235,24,2157.574,MORE,1152,1070,2222,6,2,1,0.093740846,1,-1.396860592,-1.028627515,-0.793216983,99,49,50,0,-1.216646676,-1.20951724,-1.170500555,-0.267075273,0.651066813,0.651066813,-1.170500555,-1.20951724,0,1,1
4301,18,222,17,43,50,1,3665.522,44,1407.179,MORE,836,1324,2160,6,2,7,0.656185922,7,-0.349215148,-0.280761403,-0.661813151,93,43,50,0,-1.336316841,-1.443617351,-1.170500555,-0.267075273,0.382734474,0.382734474,-1.170500555,-1.443617351,0,0,1
4302,18,223,1,51,50,0,4475.915,24,1429.034,MORE,-1026,2674,1648,7,1,-1,-0.093740846,1,-1.396860592,-1.028627515,-0.21678795,101,51,50,1,-1.176756621,-1.131483869,-1.170500555,0.214865069,-1.198388362,1.198388362,-1.170500555,-1.131483869,0,1,0
4303,18,224,41,112,110,0,6056.958,54,1657.776,MORE,-668,3164,2496,8,1,-2,-0.187481692,2,-1.222253018,0.093171653,0.651437688,222,112,110,1,1.236591704,1.248533925,1.170500555,0.696805412,-0.894391598,0.894391598,1.170500555,1.248533925,0,1,0
4304,18,225,20,40,50,1,2049.054,64,1964.631,MORE,864,562,1426,4,2,10,0.937408461,10,0.174607574,0.467104709,-1.549492335,90,40,50,0,-1.396151924,-1.560667406,-1.170500555,-1.230955958,0.406510757,0.406510757,-1.170500555,-1.560667406,1,0,1
4305,18,226,1,50,51,1,5343.713,34,1324.888,MORE,766,1832,2598,7,2,1,0.093740846,1,-1.396860592,-0.654694459,0.259761058,101,50,51,0,-1.176756621,-1.170500555,-1.131483869,0.214865069,0.323293766,0.323293766,-1.131483869,-1.170500555,0,1,1
4306,18,227,23,85,80,1,8228.405,44,1730.403,MORE,1344,3234,4578,12,2,-5,-0.46870423,5,-0.698430296,-0.280761403,1.843882143,165,85,80,1,0.099725137,0.195083426,0,2.624566781,0.814104184,0.814104184,0,0.195083426,0,1,1
4307,18,228,11,50,49,0,5846.507,74,3643.275,MORE,-508,2938,2430,9,1,-1,-0.093740846,1,-1.396860592,0.841037765,0.535869071,99,50,49,1,-1.216646676,-1.170500555,-1.20951724,1.178745754,-0.758527122,0.758527122,-1.20951724,-1.170500555,1,1,0
4308,18,229,17,50,43,0,4909.27,84,2121.511,MORE,410,2896,3306,8,2,-7,-0.656185922,7,-0.349215148,1.214970821,0.021187818,93,50,43,1,-1.336316841,-1.170500555,-1.443617351,0.696805412,0.020995307,0.020995307,-1.443617351,-1.170500555,1,1,0
4309,18,230,21,80,82,0,5775.86,64,3452.095,MORE,-770,3048,2278,9,1,2,0.187481692,2,-1.222253018,0.467104709,0.497073455,162,80,82,0,0.039890055,0,0.07803337,1.178745754,-0.981005201,0.981005201,0.07803337,0,1,1,0
4310,18,231,10,50,60,1,4950.632,14,2973.032,MORE,768,2458,3226,8,1,10,0.937408461,10,0.174607574,-1.402560571,0.043901652,110,50,60,0,-0.997251374,-1.170500555,-0.780333703,0.696805412,0.324992072,0.324992072,-0.780333703,-1.170500555,0,1,1
4311,18,232,3,53,50,0,5227.608,64,3330.406,MORE,-150,2700,2550,7,1,-3,-0.281222538,3,-1.047645444,0.467104709,0.1960023,103,53,50,1,-1.136866566,-1.053450499,-1.170500555,0.214865069,-0.454530358,0.454530358,-1.170500555,-1.053450499,1,1,0
4312,18,233,45,122,110,0,4857.927,84,3418.042,MORE,748,2402,3150,7,2,-12,-1.124890153,12,0.523822722,1.214970821,-0.007007057,232,122,110,1,1.436041979,1.638700776,1.170500555,0.214865069,0.308009012,0.308009012,1.170500555,1.638700776,1,1,0
4313,18,234,38,67,80,1,2799.935,74,1547.925,MORE,1158,1026,2184,4,2,13,1.218630999,13,0.698430296,0.841037765,-1.137147994,147,67,80,0,-0.259285357,-0.507216907,0,-1.230955958,0.656161731,0.656161731,0,-0.507216907,1,0,1
4314,18,235,38,80,67,0,4223.308,54,1704.362,MORE,-1582,2840,1258,5,1,-13,-1.218630999,13,0.698430296,0.093171653,-0.355506425,147,80,67,1,-0.259285357,0,-0.507216907,-0.749015615,-1.670517415,1.670517415,-0.507216907,0,0,0,0
4315,18,236,36,70,80,1,3835.246,74,2797.432,MORE,1108,1420,2528,6,2,10,0.937408461,10,0.174607574,0.841037765,-0.568609659,150,70,80,0,-0.199450275,-0.390166852,0,-0.267075273,0.613704082,0.613704082,0,-0.390166852,1,0,1
4316,18,237,45,110,122,1,6018.67,74,3850.727,MORE,1094,2768,3862,8,2,12,1.124890153,12,0.523822722,0.841037765,0.630411933,232,110,122,0,1.436041979,1.170500555,1.638700776,0.696805412,0.601815941,0.601815941,1.638700776,1.170500555,1,1,1
4317,18,238,42,110,115,1,7156.798,24,2192.768,MORE,-180,3986,3806,9,1,5,0.46870423,5,-0.698430296,-1.028627515,1.255411955,225,110,115,0,1.296426786,1.170500555,1.36558398,1.178745754,-0.480004947,0.480004947,1.36558398,1.170500555,0,1,0
4318,18,239,41,110,112,0,9089.21,34,3370.28,MORE,44,4220,4264,11,2,2,0.187481692,2,-1.222253018,-0.654694459,2.316590962,222,110,112,0,1.236591704,1.170500555,1.248533925,2.142626439,-0.289794681,0.289794681,1.248533925,1.170500555,0,1,0
4319,18,240,53,110,103,0,2933.12,44,2234.341,MORE,-596,1746,1150,5,1,-7,-0.656185922,7,-0.349215148,-0.280761403,-1.064009798,213,110,103,1,1.057086457,1.170500555,0.897383758,-0.749015615,-0.833252584,0.833252584,0.897383758,1.170500555,0,0,0
4320,19,1,49,110,131,0,5250.488,64,1519.233,LESS,-1466,3152,1686,4,1,21,1.968557767,21,2.095290887,0.06443725,1.273621009,241,110,131,1,1.615547226,1.170500555,1.989850943,1.430193884,-1.890553705,1.890553705,1.989850943,1.170500555,0,1,0
4321,19,2,13,47,50,0,1981.468,64,896.034,LESS,-166,982,816,2,1,3,0.281222538,3,-1.047645444,0.06443725,-0.636149461,97,47,50,1,-1.256536731,-1.28755061,-1.170500555,-0.476731295,-0.052593926,0.052593926,-1.170500555,-1.28755061,1,1,1
4322,19,3,16,50,44,0,5031.873,24,1180.937,LESS,64,2402,2466,4,1,-6,-0.562445076,6,-0.523822722,-1.683013592,1.145905525,94,50,44,0,-1.316371814,-1.170500555,-1.404600665,1.430193884,0.272583573,0.272583573,-1.404600665,-1.170500555,0,1,1
4323,19,4,7,57,50,1,6773.9,0,1160.903,LESS,-144,3474,3330,5,1,-7,-0.656185922,7,-0.349215148,-2.731484096,2.163602487,107,57,50,0,-1.057086457,-0.897383758,-1.170500555,2.383656473,-0.021489991,0.021489991,-1.170500555,-0.897383758,0,1,1
4324,19,5,18,42,50,0,3211.765,24,2881.635,LESS,-158,1622,1464,4,1,8,0.749926769,8,-0.174607574,-1.683013592,0.082593428,92,42,50,1,-1.356261869,-1.482634036,-1.170500555,1.430193884,-0.041283404,0.041283404,-1.170500555,-1.482634036,0,1,1
4325,19,6,51,108,110,0,2708.039,64,1212.47,LESS,-368,1474,1106,4,1,2,0.187481692,2,-1.222253018,0.06443725,-0.211684685,218,108,110,1,1.156811594,1.092467184,1.170500555,1.430193884,-0.338184599,0.338184599,1.170500555,1.092467184,1,1,1
4326,19,7,31,78,80,0,3911.197,54,1084.257,LESS,-810,2160,1350,4,1,2,0.187481692,2,-1.222253018,-0.372425461,0.491203525,158,78,80,1,-0.039890055,-0.07803337,0,1.430193884,-0.963090924,0.963090924,0,-0.07803337,0,1,0
4327,19,8,58,110,92,1,3129.698,54,1549.07,LESS,502,1152,1654,3,2,-18,-1.687335229,18,1.571468165,-0.372425461,0.034649661,202,110,92,0,0.837691154,1.170500555,0.468200222,0.476731295,0.891834637,0.891834637,0.468200222,1.170500555,0,1,1
4328,19,9,12,50,48,0,2607.471,34,1246.274,LESS,-386,1366,980,2,1,-2,-0.187481692,2,-1.222253018,-1.246150881,-0.270436788,98,50,48,0,-1.236591704,-1.170500555,-1.248533925,-0.476731295,-0.363633273,0.363633273,-1.248533925,-1.170500555,0,0,0
4329,19,10,54,110,101,1,3674.246,24,1226.53,LESS,494,1506,2000,3,2,-9,-0.843667615,9,0,-1.683013592,0.3527761,211,110,101,0,1.017196402,1.170500555,0.819350388,0.476731295,0.880524116,0.880524116,0.819350388,1.170500555,0,1,1
4330,19,11,14,46,50,0,2795.76,84,1087.06,LESS,-222,1418,1196,4,2,4,0.374963384,4,-0.87303787,0.93816267,-0.160437836,96,46,50,1,-1.276481759,-1.326567295,-1.170500555,1.430193884,-0.131767578,0.131767578,-1.170500555,-1.326567295,1,1,1
4331,19,12,22,80,83,0,3918.31,74,1156.431,LESS,-266,1778,1512,4,1,3,0.281222538,3,-1.047645444,0.50129996,0.49535896,163,80,83,1,0.059835082,0,0.117050055,1.430193884,-0.193975447,0.193975447,0.117050055,0,1,1,1
4332,19,13,6,50,56,0,2001.567,64,1832.254,LESS,-466,1052,586,2,1,6,0.562445076,6,-0.523822722,0.06443725,-0.62440757,106,50,56,1,-1.077031484,-1.170500555,-0.936400444,-0.476731295,-0.47673849,0.47673849,-0.936400444,-1.170500555,1,0,0
4333,19,14,13,50,47,0,3428.448,64,1178.775,LESS,-500,1690,1190,4,1,-3,-0.281222538,3,-1.047645444,0.06443725,0.209180233,97,50,47,0,-1.256536731,-1.170500555,-1.28755061,1.430193884,-0.524808208,0.524808208,-1.28755061,-1.170500555,1,1,0
4334,19,15,46,110,124,0,1862.359,64,1447.546,LESS,-402,978,576,2,1,14,1.312371845,14,0.87303787,0.06443725,-0.705733266,234,110,124,1,1.475932034,1.170500555,1.716734147,-0.476731295,-0.386254317,0.386254317,1.716734147,1.170500555,1,1,0
4335,19,16,27,91,80,0,3863.608,14,1216.286,LESS,-2088,3146,1058,4,1,-11,-1.031149307,11,0.349215148,-2.119876302,0.463401901,171,91,80,0,0.219395302,0.429183537,0,1.430193884,-2.769946769,2.769946769,0,0.429183537,0,1,0
4336,19,17,40,64,80,0,5607.161,64,1645.826,LESS,-1130,3054,1924,4,1,16,1.499853537,16,1.222253018,0.06443725,1.481990356,144,64,80,1,-0.31912044,-0.624266962,0,1.430193884,-1.415511793,1.415511793,0,-0.624266962,0,1,0
4337,19,18,22,83,80,0,7464.362,54,2224.139,LESS,-1132,3882,2750,4,1,-3,-0.281222538,3,-1.047645444,-0.372425461,2.566972285,163,83,80,0,0.059835082,0.117050055,0,1.430193884,-1.418339423,1.418339423,0,0.117050055,0,1,0
4338,19,19,54,101,110,0,5934.56,64,883.438,LESS,-1436,3378,1942,4,1,9,0.843667615,9,0,0.06443725,1.673257752,211,101,110,1,1.017196402,0.819350388,1.170500555,1.430193884,-1.848139249,1.848139249,1.170500555,0.819350388,0,1,0
4339,19,20,6,56,50,0,4244.22,64,1151.596,LESS,150,1668,1818,2,1,-6,-0.562445076,6,-0.523822722,0.06443725,0.685756477,106,56,50,0,-1.077031484,-0.936400444,-1.170500555,-0.476731295,0.394171682,0.394171682,-1.170500555,-0.936400444,0,0,1
4340,19,21,18,50,42,1,3393.821,84,1134.981,LESS,816,1300,2116,3,2,-8,-0.749926769,8,-0.174607574,0.93816267,0.188951044,92,50,42,0,-1.356261869,-1.170500555,-1.482634036,0.476731295,1.335772615,1.335772615,-1.482634036,-1.170500555,1,1,1
4341,19,22,43,110,117,0,4506.252,64,1083.818,LESS,-820,2520,1700,4,1,7,0.656185922,7,-0.349215148,0.06443725,0.838836292,227,110,117,1,1.336316841,1.170500555,1.443617351,1.430193884,-0.977229076,0.977229076,1.443617351,1.170500555,0,1,0
4342,19,23,32,77,80,0,6678.861,64,1202.231,LESS,-2414,4266,1852,4,1,3,0.281222538,3,-1.047645444,0.06443725,2.108080442,157,77,80,1,-0.059835082,-0.117050055,0,1.430193884,-3.230850529,3.230850529,0,-0.117050055,0,1,0
4343,19,24,27,80,91,0,4279.275,64,1148.238,LESS,160,1756,1916,4,1,11,1.031149307,11,0.349215148,0.06443725,0.706235705,171,80,91,1,0.219395302,0,0.429183537,1.430193884,0.408309834,0.408309834,0.429183537,0,0,1,1
4344,19,25,16,44,50,0,2231.603,84,1589.55,LESS,54,1124,1178,2,2,6,0.562445076,6,-0.523822722,0.93816267,-0.490019906,94,44,50,1,-1.316371814,-1.404600665,-1.170500555,-0.476731295,0.258445421,0.258445421,-1.170500555,-1.404600665,1,0,1
4345,19,26,7,50,57,0,3026.398,70,1458.663,LESS,-482,1516,1034,4,1,7,0.656185922,7,-0.349215148,0.326554876,-0.025698483,107,50,57,1,-1.057086457,-1.170500555,-0.897383758,1.430193884,-0.499359534,0.499359534,-0.897383758,-1.170500555,1,1,0
4346,19,27,14,50,46,1,4290.022,34,1241.829,LESS,156,1936,2092,3,2,-4,-0.374963384,4,-0.87303787,-1.246150881,0.712514132,96,50,46,0,-1.276481759,-1.170500555,-1.326567295,0.476731295,0.402654573,0.402654573,-1.326567295,-1.170500555,0,1,1
4347,19,28,51,110,108,1,6269.315,74,764.99,LESS,-514,3126,2612,3,2,-2,-0.187481692,2,-1.222253018,0.50129996,1.868822543,218,110,108,0,1.156811594,1.170500555,1.092467184,0.476731295,-0.544601621,0.544601621,1.092467184,1.170500555,1,1,0
4348,19,29,50,133,110,1,3411.278,84,1019.982,LESS,778,1294,2072,3,2,-23,-2.15603946,23,2.444506035,0.93816267,0.199149471,243,133,110,0,1.655437281,2.067884313,1.170500555,0.476731295,1.282047637,1.282047637,1.170500555,2.067884313,1,1,1
4349,19,30,49,131,110,1,4039.778,84,1274.942,LESS,1054,1344,2398,3,2,-21,-1.968557767,21,2.095290887,0.93816267,0.566320899,241,131,110,0,1.615547226,1.989850943,1.170500555,0.476731295,1.672260636,1.672260636,1.170500555,1.989850943,1,1,1
4350,19,31,47,126,110,1,4837.984,74,2098.181,LESS,-480,2232,1752,3,2,-16,-1.499853537,16,1.222253018,0.50129996,1.032635038,236,126,110,0,1.515822089,1.794767517,1.170500555,0.476731295,-0.496531903,0.496531903,1.170500555,1.794767517,1,1,0
4351,19,32,50,110,133,0,2340.152,64,707.989,LESS,-348,1206,858,2,1,23,2.15603946,23,2.444506035,0.06443725,-0.426605282,243,110,133,1,1.655437281,1.170500555,2.067884313,-0.476731295,-0.309908295,0.309908295,2.067884313,1.170500555,0,0,1
4352,19,33,47,110,126,0,2047.578,100,1531.739,LESS,252,1240,1492,2,2,16,1.499853537,16,1.222253018,1.637143007,-0.597527817,236,110,126,1,1.515822089,1.170500555,1.794767517,-0.476731295,0.538380834,0.538380834,1.794767517,1.170500555,1,0,1
4353,19,34,12,48,50,0,2577.729,94,2746.796,LESS,240,1744,1984,2,2,2,0.187481692,2,-1.222253018,1.375025381,-0.287812146,98,48,50,1,-1.236591704,-1.248533925,-1.170500555,-0.476731295,0.521415051,0.521415051,-1.170500555,-1.248533925,1,0,1
4354,19,35,32,80,77,1,3224.245,84,918.9,LESS,934,1232,2166,3,2,-3,-0.281222538,3,-1.047645444,0.93816267,0.089884279,157,80,77,0,-0.059835082,0,-0.117050055,0.476731295,1.50260281,1.50260281,-0.117050055,0,1,1,1
4355,19,36,43,117,110,0,2181.192,64,1469.942,LESS,-684,1392,708,2,1,-7,-0.656185922,7,-0.349215148,0.06443725,-0.519470151,227,117,110,0,1.336316841,1.443617351,1.170500555,-0.476731295,-0.784950207,0.784950207,1.170500555,1.443617351,1,0,0
4356,19,37,40,80,64,1,3352.925,84,985.95,LESS,1120,1044,2164,3,2,-16,-1.499853537,16,1.222253018,0.93816267,0.165059488,144,80,64,0,-0.31912044,0,-0.624266962,0.476731295,1.76557244,1.76557244,-0.624266962,0,1,1,1
4357,19,38,31,80,78,0,3536.414,74,777.704,LESS,-560,1834,1274,4,1,-2,-0.187481692,2,-1.222253018,0.50129996,0.272254267,158,80,78,0,-0.039890055,0,-0.07803337,1.430193884,-0.609637121,0.609637121,-0.07803337,0,1,1,0
4358,19,39,46,124,110,0,6068.604,24,1253.598,LESS,58,2700,2758,4,1,-14,-1.312371845,14,0.87303787,-1.683013592,1.751566625,234,124,110,0,1.475932034,1.716734147,1.170500555,1.430193884,0.264100682,0.264100682,1.170500555,1.716734147,0,1,1
4359,19,40,58,92,110,0,3674.74,94,841.658,LESS,-604,2172,1568,4,2,18,1.687335229,18,1.571468165,1.375025381,0.353064696,202,92,110,1,0.837691154,0.468200222,1.170500555,1.430193884,-0.67184499,0.67184499,1.170500555,0.468200222,1,1,0
4360,19,41,49,110,131,1,6475.39,94,1025.321,MORE,-986,3880,2894,3,2,21,1.968557767,21,2.095290887,1.375025381,1.989212125,241,110,131,0,1.615547226,1.170500555,1.989850943,0.476731295,-1.211922402,1.211922402,1.989850943,1.170500555,1,1,0
4361,19,42,13,47,50,1,5457.523,44,1375.59,MORE,-932,2790,1858,3,2,3,0.281222538,3,-1.047645444,-0.809288171,1.394571425,97,47,50,0,-1.256536731,-1.28755061,-1.170500555,0.476731295,-1.135576381,1.135576381,-1.170500555,-1.28755061,0,1,0
4362,19,43,16,50,44,1,3612.663,54,1586.714,MORE,542,1326,1868,3,2,-6,-0.562445076,6,-0.523822722,-0.372425461,0.316799142,94,50,44,1,-1.316371814,-1.170500555,-1.404600665,0.476731295,0.948387246,0.948387246,-1.404600665,-1.170500555,0,1,1
4363,19,44,7,57,50,0,2453.851,60,1626.863,MORE,-258,1128,870,2,1,-7,-0.656185922,7,-0.349215148,-0.110307834,-0.360182014,107,57,50,1,-1.057086457,-0.897383758,-1.170500555,-0.476731295,-0.182664926,0.182664926,-1.170500555,-0.897383758,0,0,0
4364,19,45,18,42,50,1,2498.278,74,2615.904,MORE,1782,968,2750,3,2,8,0.749926769,8,-0.174607574,0.50129996,-0.334227638,92,42,50,0,-1.356261869,-1.482634036,-1.170500555,0.476731295,2.701518112,2.701518112,-1.170500555,-1.482634036,1,1,1
4365,19,46,51,108,110,0,3784.341,74,1565.462,MORE,76,1592,1668,3,2,2,0.187481692,2,-1.222253018,0.50129996,0.417093902,218,108,110,0,1.156811594,1.092467184,1.170500555,0.476731295,0.289549356,0.289549356,1.170500555,1.092467184,1,1,0
4366,19,47,31,78,80,1,3312.037,84,1384.756,MORE,1184,1028,2212,3,2,2,0.187481692,2,-1.222253018,0.93816267,0.141172606,158,78,80,0,-0.039890055,-0.07803337,0,0.476731295,1.856056614,1.856056614,0,-0.07803337,1,1,1
4367,19,48,58,110,92,0,2071.87,74,1569.747,MORE,-358,1188,830,2,2,-18,-1.687335229,18,1.571468165,0.50129996,-0.583336364,202,110,92,1,0.837691154,1.170500555,0.468200222,-0.476731295,-0.324046447,0.324046447,0.468200222,1.170500555,1,0,0
4368,19,49,12,50,48,1,2598.527,84,1289.139,MORE,1190,942,2132,3,2,-2,-0.187481692,2,-1.222253018,0.93816267,-0.275661897,98,50,48,1,-1.236591704,-1.170500555,-1.248533925,0.476731295,1.864539505,1.864539505,-1.248533925,-1.170500555,1,1,1
4369,19,50,54,110,101,1,8246.877,34,1344.452,MORE,-1522,4468,2946,7,2,-9,-0.843667615,9,0,-1.246150881,3.024119699,211,110,101,1,1.017196402,1.170500555,0.819350388,4.290581652,-1.969727357,1.969727357,0.819350388,1.170500555,0,1,0
4370,19,51,14,46,50,1,4932.687,84,1121.508,MORE,932,1756,2688,3,2,4,0.374963384,4,-0.87303787,0.93816267,1.087960791,96,46,50,0,-1.276481759,-1.326567295,-1.170500555,0.476731295,1.49977518,1.49977518,-1.170500555,-1.326567295,1,1,1
4371,19,52,22,80,83,0,5044.238,74,1286.59,MORE,-658,2772,2114,4,2,3,0.281222538,3,-1.047645444,0.50129996,1.153129192,163,80,83,0,0.059835082,0,0.117050055,1.430193884,-0.748191012,0.748191012,0.117050055,0,1,1,0
4372,19,53,6,50,56,1,3705.313,84,1008.355,MORE,1548,1112,2660,3,2,6,0.562445076,6,-0.523822722,0.93816267,0.370925527,106,50,56,0,-1.077031484,-1.170500555,-0.936400444,0.476731295,2.370685352,2.370685352,-0.936400444,-1.170500555,1,1,1
4373,19,54,13,50,47,1,5147.894,24,1279.433,MORE,394,2178,2572,3,2,-3,-0.281222538,3,-1.047645444,-1.683013592,1.213685312,97,50,47,1,-1.256536731,-1.170500555,-1.28755061,0.476731295,0.739142594,0.739142594,-1.28755061,-1.170500555,0,1,1
4374,19,55,46,110,124,1,2795.16,84,1771.841,MORE,1654,1104,2758,3,2,14,1.312371845,14,0.87303787,0.93816267,-0.160788358,234,110,124,0,1.475932034,1.170500555,1.716734147,0.476731295,2.520549765,2.520549765,1.716734147,1.170500555,1,1,1
4375,19,56,27,91,80,0,3196.865,24,1929.997,MORE,-358,1620,1262,2,1,-11,-1.031149307,11,0.349215148,-1.683013592,0.073888807,171,91,80,1,0.219395302,0.429183537,0,-0.476731295,-0.324046447,0.324046447,0,0.429183537,0,0,0
4376,19,57,40,64,80,1,1691.781,84,1094.282,MORE,492,516,1008,1,2,16,1.499853537,16,1.222253018,0.93816267,-0.805385403,144,64,80,0,-0.31912044,-0.624266962,0,-1.430193884,0.877696485,0.877696485,0,-0.624266962,1,0,1
4377,19,58,22,83,80,1,3112.119,84,723.818,MORE,-42,1498,1456,1,2,-3,-0.281222538,3,-1.047645444,0.93816267,0.024379961,163,83,80,1,0.059835082,0.117050055,0,-1.430193884,0.122719161,0.122719161,0,0.117050055,1,0,0
4378,19,59,54,101,110,1,4105.096,40,1706.416,MORE,402,1668,2070,3,1,9,0.843667615,9,0,-0.984033255,0.604479854,211,101,110,0,1.017196402,0.819350388,1.170500555,0.476731295,0.750453116,0.750453116,1.170500555,0.819350388,0,1,1
4379,19,60,6,56,50,0,2207.039,24,2056.543,MORE,-472,1208,736,2,1,-6,-0.562445076,6,-0.523822722,-1.683013592,-0.504370263,106,56,50,1,-1.077031484,-0.936400444,-1.170500555,-0.476731295,-0.485221382,0.485221382,-1.170500555,-0.936400444,0,0,0
4380,19,61,18,50,42,0,2066.628,64,1465.92,MORE,-394,1142,748,2,1,-8,-0.749926769,8,-0.174607574,0.06443725,-0.586398755,92,50,42,1,-1.356261869,-1.170500555,-1.482634036,-0.476731295,-0.374943795,0.374943795,-1.482634036,-1.170500555,0,0,0
4381,19,62,43,110,117,1,3205.343,74,1318.247,MORE,814,1238,2052,3,2,7,0.656185922,7,-0.349215148,0.50129996,0.078841678,227,110,117,0,1.336316841,1.170500555,1.443617351,0.476731295,1.332944985,1.332944985,1.443617351,1.170500555,1,1,1
4382,19,63,32,77,80,1,1857.539,84,874.959,MORE,538,734,1272,1,2,3,0.281222538,3,-1.047645444,0.93816267,-0.708549123,157,77,80,0,-0.059835082,-0.117050055,0,-1.430193884,0.942731985,0.942731985,0,-0.117050055,1,0,1
4383,19,64,27,80,91,1,4413.562,24,1039.724,MORE,-588,2280,1692,3,2,11,1.031149307,11,0.349215148,-1.683013592,0.784686539,171,80,91,0,0.219395302,0,0.429183537,0.476731295,-0.649223947,0.649223947,0.429183537,0,0,1,0
4384,19,65,16,44,50,1,1605.789,74,1248.102,MORE,348,478,826,1,2,6,0.562445076,6,-0.523822722,0.50129996,-0.855622165,94,44,50,0,-1.316371814,-1.404600665,-1.170500555,-1.430193884,0.674107094,0.674107094,-1.170500555,-1.404600665,1,0,1
4385,19,66,7,50,57,1,1532.701,74,1114.248,MORE,1266,428,1694,1,2,7,0.656185922,7,-0.349215148,0.50129996,-0.898320376,107,50,57,0,-1.057086457,-1.170500555,-0.897383758,-1.430193884,1.971989462,1.971989462,-0.897383758,-1.170500555,1,0,1
4386,19,67,14,50,46,0,2053.726,94,1065.148,MORE,102,1176,1278,2,2,-4,-0.374963384,4,-0.87303787,1.375025381,-0.593936139,96,50,46,1,-1.276481759,-1.170500555,-1.326567295,-0.476731295,0.326308552,0.326308552,-1.326567295,-1.170500555,1,1,1
4387,19,68,51,110,108,0,7380.932,74,949.727,MORE,-832,3708,2876,6,2,-2,-0.187481692,2,-1.222253018,0.50129996,2.51823225,218,110,108,1,1.156811594,1.170500555,1.092467184,3.337119062,-0.994194859,0.994194859,1.092467184,1.170500555,1,1,0
4388,19,69,50,133,110,0,2119.062,94,872.175,MORE,132,1104,1236,2,2,-23,-2.15603946,23,2.444506035,1.375025381,-0.555766668,243,133,110,1,1.655437281,2.067884313,1.170500555,-0.476731295,0.368723008,0.368723008,1.170500555,2.067884313,1,1,1
4389,19,70,49,131,110,0,3491.948,94,1220.279,MORE,202,1838,2040,4,2,-21,-1.968557767,21,2.095290887,1.375025381,0.246277107,241,131,110,1,1.615547226,1.989850943,1.170500555,1.430193884,0.467690073,0.467690073,1.170500555,1.989850943,1,1,1
4390,19,71,47,126,110,0,2192.829,94,1138.584,MORE,0,1280,1280,2,2,-16,-1.499853537,16,1.222253018,1.375025381,-0.512671784,236,126,110,1,1.515822089,1.794767517,1.170500555,-0.476731295,0.1820994,0.1820994,1.170500555,1.794767517,1,1,0
4391,19,72,50,110,133,1,2675.105,100,1365.138,MORE,788,1260,2048,3,2,23,2.15603946,23,2.444506035,1.637143007,-0.230924819,243,110,133,0,1.655437281,1.170500555,2.067884313,0.476731295,1.296185789,1.296185789,2.067884313,1.170500555,1,1,1
4392,19,73,47,110,126,0,4438.233,34,884.756,MORE,-612,2270,1658,4,1,16,1.499853537,16,1.222253018,-1.246150881,0.799099405,236,110,126,0,1.515822089,1.170500555,1.794767517,1.430193884,-0.683155512,0.683155512,1.794767517,1.170500555,0,1,0
4393,19,74,12,48,50,0,2502.728,74,971.176,MORE,-872,1572,700,2,2,2,0.187481692,2,-1.222253018,0.50129996,-0.331627936,98,48,50,0,-1.236591704,-1.248533925,-1.170500555,-0.476731295,-1.050747468,1.050747468,-1.170500555,-1.248533925,1,1,0
4394,19,75,32,80,77,0,2094.72,74,808.769,MORE,-468,1206,738,2,1,-3,-0.281222538,3,-1.047645444,0.50129996,-0.569987331,157,80,77,1,-0.059835082,0,-0.117050055,-0.476731295,-0.479566121,0.479566121,-0.117050055,0,1,1,0
4395,19,76,43,117,110,0,1977.153,84,1136.497,MORE,-240,1142,902,2,2,-7,-0.656185922,7,-0.349215148,0.93816267,-0.638670296,227,117,110,1,1.336316841,1.443617351,1.170500555,-0.476731295,-0.157216252,0.157216252,1.170500555,1.443617351,1,1,0
4396,19,77,40,80,64,0,3124.778,74,2043.655,MORE,-66,1928,1862,1,2,-16,-1.499853537,16,1.222253018,0.50129996,0.031775384,144,80,64,1,-0.31912044,0,-0.624266962,-1.430193884,0.088787595,0.088787595,-0.624266962,0,1,0,0
4397,19,78,31,80,78,1,3230.196,84,1412.955,MORE,-224,1682,1458,3,2,-2,-0.187481692,2,-1.222253018,0.93816267,0.093360869,158,80,78,1,-0.039890055,0,-0.07803337,0.476731295,-0.134595208,0.134595208,-0.07803337,0,1,1,0
4398,19,79,46,124,110,0,5512.344,74,1101.26,MORE,-672,2790,2118,4,1,-14,-1.312371845,14,0.87303787,0.50129996,1.426598004,234,124,110,1,1.475932034,1.716734147,1.170500555,1.430193884,-0.767984425,0.767984425,1.170500555,1.716734147,1,1,0
4399,19,80,58,92,110,1,5433.436,74,948.669,MORE,172,2708,2880,3,1,18,1.687335229,18,1.571468165,0.50129996,1.380499734,202,92,110,0,0.837691154,0.468200222,1.170500555,0.476731295,0.425275617,0.425275617,1.170500555,0.468200222,1,1,1
4400,19,81,48,128,110,1,6718.911,64,1136.472,LESS,-660,3314,2654,5,2,-18,-1.687335229,18,1.571468165,0.06443725,2.131477762,238,128,110,0,1.555712144,1.872800887,1.170500555,2.383656473,-0.751018642,0.751018642,1.170500555,1.872800887,1,1,0
4401,19,82,8,50,58,0,1726.19,84,1512.908,LESS,714,862,1576,2,2,8,0.749926769,8,-0.174607574,0.93816267,-0.78528357,108,50,58,1,-1.037141429,-1.170500555,-0.858367073,-0.476731295,1.191563463,1.191563463,-0.858367073,-1.170500555,1,1,1
4402,19,83,4,54,50,0,2436.73,74,1315.924,LESS,-276,1196,920,2,1,-4,-0.374963384,4,-0.87303787,0.50129996,-0.370184149,104,54,50,0,-1.116921539,-1.014433814,-1.170500555,-0.476731295,-0.2081136,0.2081136,-1.170500555,-1.014433814,1,1,1
4403,19,84,37,80,69,0,1861.533,84,1048.37,LESS,-480,1048,568,2,1,-11,-1.031149307,11,0.349215148,0.93816267,-0.706215818,149,80,69,0,-0.219395302,0,-0.429183537,-0.476731295,-0.496531903,0.496531903,-0.429183537,0,1,1,0
4404,19,85,52,105,110,0,2405.278,20,1156.009,LESS,-966,1872,906,2,1,5,0.46870423,5,-0.698430296,-1.857758676,-0.388558494,215,105,110,1,1.096976512,0.975417129,1.170500555,-0.476731295,-1.183646098,1.183646098,1.170500555,0.975417129,0,1,0
4405,19,86,5,55,50,0,1832.501,64,1705.352,LESS,-132,1090,958,2,1,-5,-0.46870423,5,-0.698430296,0.06443725,-0.723176392,105,55,50,0,-1.096976512,-0.975417129,-1.170500555,-0.476731295,-0.004524209,0.004524209,-1.170500555,-0.975417129,1,1,1
4406,19,87,30,96,80,0,2390.579,44,1971.697,LESS,-708,1626,918,2,1,-16,-1.499853537,16,1.222253018,-0.809288171,-0.39714569,176,96,80,0,0.31912044,0.624266962,0,-0.476731295,-0.818881772,0.818881772,0,0.624266962,0,1,0
4407,19,88,33,80,75,0,1867.803,74,865.55,LESS,-414,984,570,2,1,-5,-0.46870423,5,-0.698430296,0.50129996,-0.702552866,155,80,75,0,-0.099725137,0,-0.195083426,-0.476731295,-0.403220099,0.403220099,-0.195083426,0,1,1,0
4408,19,89,48,110,128,0,1857.648,74,2125.162,LESS,324,976,1300,2,2,18,1.687335229,18,1.571468165,0.50129996,-0.708485445,238,110,128,1,1.555712144,1.170500555,1.872800887,-0.476731295,0.640175529,0.640175529,1.872800887,1.170500555,1,0,1
4409,19,90,9,59,50,1,5911.942,64,4703.927,LESS,2084,1226,3310,3,2,-9,-0.843667615,9,0,0.06443725,1.660044254,109,59,50,0,-1.017196402,-0.819350388,-1.170500555,0.476731295,3.128490307,3.128490307,-1.170500555,-0.819350388,0,1,1
4410,19,91,44,110,119,0,6027.022,74,1523.828,LESS,-656,1362,706,2,1,9,0.843667615,9,0,0.50129996,1.727274306,229,110,119,1,1.376206896,1.170500555,1.521650721,-0.476731295,-0.745363381,0.745363381,1.521650721,1.170500555,1,0,0
4411,19,92,2,52,50,0,3998.225,64,1207.675,LESS,-706,1702,996,2,1,-2,-0.187481692,2,-1.222253018,0.06443725,0.542045522,102,52,50,0,-1.156811594,-1.092467184,-1.170500555,-0.476731295,-0.816054142,0.816054142,-1.170500555,-1.092467184,0,0,0
4412,19,93,8,58,50,0,3395.021,34,1729.04,LESS,-654,1398,744,1,1,-8,-0.749926769,8,-0.174607574,-1.246150881,0.189652087,108,58,50,0,-1.037141429,-0.858367073,-1.170500555,-1.430193884,-0.742535751,0.742535751,-1.170500555,-0.858367073,0,0,0
4413,19,94,44,119,110,0,5094.321,34,1670.846,LESS,502,1454,1956,2,2,-9,-0.843667615,9,0,-1.246150881,1.182387818,229,119,110,0,1.376206896,1.521650721,1.170500555,-0.476731295,0.891834637,0.891834637,1.170500555,1.521650721,0,0,1
4414,19,95,34,74,80,0,3976.193,74,3222.901,LESS,-474,1686,1212,2,1,6,0.562445076,6,-0.523822722,0.50129996,0.529174367,154,74,80,1,-0.119670165,-0.234100111,0,-0.476731295,-0.488049012,0.488049012,0,-0.234100111,1,0,0
4415,19,96,24,86,80,0,2346.636,74,1475.969,LESS,-606,1224,618,2,1,-6,-0.562445076,6,-0.523822722,0.50129996,-0.422817311,166,86,80,0,0.119670165,0.234100111,0,-0.476731295,-0.67467262,0.67467262,0,0.234100111,1,0,0
4416,19,97,39,66,80,0,1985.611,74,998.703,LESS,-558,980,422,2,1,14,1.312371845,14,0.87303787,0.50129996,-0.633729109,146,66,80,1,-0.279230385,-0.546233592,0,-0.476731295,-0.60680949,0.60680949,0,-0.546233592,1,0,0
4417,19,98,9,50,59,0,10616.105,74,1292.793,LESS,1254,3010,4264,4,1,9,0.843667615,9,0,0.50129996,4.40822921,109,50,59,1,-1.017196402,-1.170500555,-0.819350388,1.430193884,1.955023679,1.955023679,-0.819350388,-1.170500555,1,1,1
4418,19,99,57,94,110,0,3424.41,34,2114.686,LESS,-1768,2442,674,2,1,16,1.499853537,16,1.222253018,-1.246150881,0.206821222,204,94,110,1,0.877581209,0.546233592,1.170500555,-0.476731295,-2.3175259,2.3175259,1.170500555,0.546233592,0,0,0
4419,19,100,60,110,87,1,4641.089,74,1284.543,LESS,100,1712,1812,2,2,-23,-2.15603946,23,2.444506035,0.50129996,0.917608438,197,110,87,0,0.737966017,1.170500555,0.273116796,-0.476731295,0.323480921,0.323480921,0.273116796,1.170500555,1,0,1
4420,19,101,33,75,80,0,2079.65,94,1225.211,LESS,-474,1386,912,2,1,5,0.46870423,5,-0.698430296,1.375025381,-0.578791267,155,75,80,1,-0.099725137,-0.195083426,0,-0.476731295,-0.488049012,0.488049012,0,-0.195083426,1,0,0
4421,19,102,15,50,45,1,5748.041,74,1234.773,LESS,546,1608,2154,3,2,-5,-0.46870423,5,-0.698430296,0.50129996,1.564292839,95,50,45,0,-1.296426786,-1.170500555,-1.36558398,0.476731295,0.954042507,0.954042507,-1.36558398,-1.170500555,1,1,1
4422,19,103,59,89,110,0,2637.771,94,976.835,LESS,-620,1508,888,1,1,21,1.968557767,21,2.095290887,1.375025381,-0.252735444,199,89,110,1,0.777856072,0.351150166,1.170500555,-1.430193884,-0.694466034,0.694466034,1.170500555,0.351150166,1,0,0
4423,19,104,29,80,94,0,2630.658,84,1192.413,LESS,-946,1472,526,2,1,14,1.312371845,14,0.87303787,0.93816267,-0.256890878,174,80,94,1,0.279230385,0,0.546233592,-0.476731295,-1.155369794,1.155369794,0.546233592,0,1,0,0
4424,19,105,55,110,98,1,5044.573,24,1210.116,LESS,-620,2238,1618,3,2,-12,-1.124890153,12,0.523822722,-1.683013592,1.1533249,208,110,98,0,0.957361319,1.170500555,0.702300333,0.476731295,-0.694466034,0.694466034,0.702300333,1.170500555,0,1,0
4425,19,106,29,94,80,0,5757.966,84,1247.345,LESS,-626,2640,2014,3,1,-14,-1.312371845,14,0.87303787,0.93816267,1.570091052,174,94,80,0,0.279230385,0.546233592,0,0.476731295,-0.702948925,0.702948925,0,0.546233592,1,1,0
4426,19,107,57,110,94,1,2029.046,74,1747.898,LESS,822,534,1356,1,2,-16,-1.499853537,16,1.222253018,0.50129996,-0.608354262,204,110,94,0,0.877581209,1.170500555,0.546233592,-1.430193884,1.344255506,1.344255506,0.546233592,1.170500555,1,0,1
4427,19,108,39,80,66,0,5845.337,24,1673.826,LESS,-640,2794,2154,4,1,-14,-1.312371845,14,0.87303787,-1.683013592,1.62113343,146,80,66,0,-0.279230385,0,-0.546233592,1.430193884,-0.722742338,0.722742338,-0.546233592,0,0,1,0
4428,19,109,4,50,54,0,11578.54,24,1498.144,LESS,286,4496,4782,6,1,4,0.374963384,4,-0.87303787,-1.683013592,4.970486382,104,50,54,1,-1.116921539,-1.170500555,-1.014433814,3.337119062,0.586450551,0.586450551,-1.014433814,-1.170500555,0,1,1
4429,19,110,55,98,110,0,2576.067,64,2952.032,LESS,-1100,1766,666,2,1,12,1.124890153,12,0.523822722,0.06443725,-0.288783091,208,98,110,1,0.957361319,0.702300333,1.170500555,-0.476731295,-1.373097337,1.373097337,1.170500555,0.702300333,0,0,0
4430,19,111,2,50,52,0,3327.818,60,2046.219,LESS,-796,1724,928,2,1,2,0.187481692,2,-1.222253018,-0.110307834,0.15039191,102,50,52,1,-1.156811594,-1.170500555,-1.092467184,-0.476731295,-0.943297511,0.943297511,-1.092467184,-1.170500555,0,0,0
4431,19,112,59,110,89,1,2789.167,64,1373.071,LESS,942,948,1890,3,2,-21,-1.968557767,21,2.095290887,0.06443725,-0.164289485,199,110,89,0,0.777856072,1.170500555,0.351150166,0.476731295,1.513913332,1.513913332,0.351150166,1.170500555,0,1,1
4432,19,113,60,87,110,0,2646.031,64,1117.87,LESS,-990,1610,620,1,1,23,2.15603946,23,2.444506035,0.06443725,-0.24790993,197,87,110,1,0.737966017,0.273116796,1.170500555,-1.430193884,-1.217577663,1.217577663,1.170500555,0.273116796,0,0,0
4433,19,114,52,110,105,0,1783.19,70,1392.543,LESS,-448,1046,598,2,1,-5,-0.46870423,5,-0.698430296,0.326554876,-0.751984014,215,110,105,0,1.096976512,1.170500555,0.975417129,-0.476731295,-0.451289817,0.451289817,0.975417129,1.170500555,1,0,0
4434,19,115,30,80,96,0,1689.115,20,1216.579,LESS,-666,1286,620,2,1,16,1.499853537,16,1.222253018,-1.857758676,-0.806942887,176,80,96,1,0.31912044,0,0.624266962,-0.476731295,-0.759501533,0.759501533,0.624266962,0,0,0,0
4435,19,116,24,80,86,1,2818.893,74,972.208,LESS,188,1276,1464,3,2,6,0.562445076,6,-0.523822722,0.50129996,-0.146923474,166,80,86,1,0.119670165,0,0.234100111,0.476731295,0.44789666,0.44789666,0.234100111,0,1,1,1
4436,19,117,5,50,55,0,2723.774,64,1395.876,LESS,-758,1536,778,2,1,5,0.46870423,5,-0.698430296,0.06443725,-0.202492255,105,50,55,1,-1.096976512,-1.170500555,-0.975417129,-0.476731295,-0.889572533,0.889572533,-0.975417129,-1.170500555,0,0,0
4437,19,118,34,80,74,0,2757.361,74,825.033,LESS,-746,1610,864,2,1,-6,-0.562445076,6,-0.523822722,0.50129996,-0.182870637,154,80,74,0,-0.119670165,0,-0.234100111,-0.476731295,-0.872606751,0.872606751,-0.234100111,0,1,0,0
4438,19,119,15,45,50,0,1913.764,70,1415.294,LESS,-78,1076,998,2,2,5,0.46870423,5,-0.698430296,0.326554876,-0.675702324,95,45,50,1,-1.296426786,-1.36558398,-1.170500555,-0.476731295,0.071821813,0.071821813,-1.170500555,-1.36558398,1,0,1
4439,19,120,37,69,80,0,1948.715,84,965.91,LESS,-180,974,794,2,2,11,1.031149307,11,0.349215148,0.93816267,-0.655283854,149,69,80,1,-0.219395302,-0.429183537,0,-0.476731295,-0.072387339,0.072387339,0,-0.429183537,1,0,1
4440,19,121,48,128,110,0,4996.449,14,1013.63,MORE,-1104,2698,1594,4,1,-18,-1.687335229,18,1.571468165,-2.119876302,1.125210727,238,128,110,1,1.555712144,1.872800887,1.170500555,1.430193884,-1.378752597,1.378752597,1.170500555,1.872800887,0,1,0
4441,19,122,8,50,58,1,3088.427,64,1805.837,MORE,1500,1070,2570,3,2,8,0.749926769,8,-0.174607574,0.06443725,0.01053903,108,50,58,0,-1.037141429,-1.170500555,-0.858367073,0.476731295,2.302822222,2.302822222,-0.858367073,-1.170500555,0,1,1
4442,19,123,4,54,50,0,1749.507,14,1069.547,MORE,-270,1008,738,2,1,-4,-0.374963384,4,-0.87303787,-2.119876302,-0.771661715,104,54,50,1,-1.116921539,-1.014433814,-1.170500555,-0.476731295,-0.199630708,0.199630708,-1.170500555,-1.014433814,0,1,0
4443,19,124,37,80,69,0,2484.297,64,1367.071,MORE,-778,1430,652,2,1,-11,-1.031149307,11,0.349215148,0.06443725,-0.342395377,149,80,69,1,-0.219395302,0,-0.429183537,-0.476731295,-0.917848837,0.917848837,-0.429183537,0,0,0,0
4444,19,125,52,105,110,1,2170.206,84,831.836,MORE,766,762,1528,3,2,5,0.46870423,5,-0.698430296,0.93816267,-0.525888202,215,105,110,0,1.096976512,0.975417129,1.170500555,0.476731295,1.265081854,1.265081854,1.170500555,0.975417129,1,1,1
4445,19,126,5,55,50,0,2467.256,64,1087.058,MORE,-332,1196,864,2,1,-5,-0.46870423,5,-0.698430296,0.06443725,-0.352350776,105,55,50,1,-1.096976512,-0.975417129,-1.170500555,-0.476731295,-0.287287252,0.287287252,-1.170500555,-0.975417129,0,0,0
4446,19,127,30,96,80,0,2455.878,64,1571.75,MORE,-908,1600,692,2,1,-16,-1.499853537,16,1.222253018,0.06443725,-0.358997835,176,96,80,1,0.31912044,0.624266962,0,-0.476731295,-1.101644815,1.101644815,0,0.624266962,0,0,0
4447,19,128,33,80,75,1,2301.282,70,1224.391,MORE,486,906,1392,3,2,-5,-0.46870423,5,-0.698430296,0.326554876,-0.449313243,155,80,75,1,-0.099725137,0,-0.195083426,0.476731295,0.869213594,0.869213594,-0.195083426,0,0,1,1
4448,19,129,48,110,128,1,2820.303,74,1106.626,MORE,832,1158,1990,3,2,18,1.687335229,18,1.571468165,0.50129996,-0.146099748,238,110,128,0,1.555712144,1.170500555,1.872800887,0.476731295,1.358393658,1.358393658,1.872800887,1.170500555,1,1,1
4449,19,130,9,59,50,1,2337.382,4,714.684,MORE,-190,1268,1078,3,1,-9,-0.843667615,9,0,-2.556739012,-0.428223524,109,59,50,1,-1.017196402,-0.819350388,-1.170500555,0.476731295,-0.086525491,0.086525491,-1.170500555,-0.819350388,0,1,0
4450,19,131,44,110,119,1,2160.222,64,1440.116,MORE,240,950,1190,3,2,9,0.843667615,9,0,0.06443725,-0.531720883,229,110,119,0,1.376206896,1.170500555,1.521650721,0.476731295,0.521415051,0.521415051,1.521650721,1.170500555,0,1,1
4451,19,132,2,52,50,1,2275.866,84,640.929,MORE,402,830,1232,3,2,-2,-0.187481692,2,-1.222253018,0.93816267,-0.46416134,102,52,50,1,-1.156811594,-1.092467184,-1.170500555,0.476731295,0.750453116,0.750453116,-1.170500555,-1.092467184,1,1,1
4452,19,133,8,58,50,0,2485.773,84,1086.143,MORE,-416,1578,1162,2,2,-8,-0.749926769,8,-0.174607574,0.93816267,-0.341533094,108,58,50,1,-1.037141429,-0.858367073,-1.170500555,-0.476731295,-0.40604773,0.40604773,-1.170500555,-0.858367073,1,0,0
4453,19,134,44,119,110,0,2318.966,44,1216.867,MORE,-616,1290,674,2,1,-9,-0.843667615,9,0,-0.809288171,-0.438982202,229,119,110,1,1.376206896,1.521650721,1.170500555,-0.476731295,-0.688810773,0.688810773,1.170500555,1.521650721,0,0,0
4454,19,135,34,74,80,1,1684.058,84,809.543,MORE,576,444,1020,1,2,6,0.562445076,6,-0.523822722,0.93816267,-0.8098972,154,74,80,0,-0.119670165,-0.234100111,0,-1.430193884,0.996456963,0.996456963,0,-0.234100111,1,0,1
4455,19,136,24,86,80,0,3506.286,34,1364.918,MORE,-1286,2376,1090,2,1,-6,-0.562445076,6,-0.523822722,-1.246150881,0.254653406,166,86,80,1,0.119670165,0.234100111,0,-0.476731295,-1.636066967,1.636066967,0,0.234100111,0,0,0
4456,19,137,39,66,80,1,4650.377,74,1164.265,MORE,984,1250,2234,3,2,14,1.312371845,14,0.87303787,0.50129996,0.923034513,146,66,80,0,-0.279230385,-0.546233592,0,0.476731295,1.573293571,1.573293571,0,-0.546233592,1,1,1
4457,19,138,9,50,59,1,11545.02,24,1183.88,MORE,-742,4850,4108,5,2,9,0.843667615,9,0,-1.683013592,4.950903906,109,50,59,0,-1.017196402,-1.170500555,-0.819350388,2.383656473,-0.86695149,0.86695149,-0.819350388,-1.170500555,0,1,0
4458,19,139,57,94,110,1,2498.708,74,1275.876,MORE,250,992,1242,3,2,16,1.499853537,16,1.222253018,0.50129996,-0.333976431,204,94,110,0,0.877581209,0.546233592,1.170500555,0.476731295,0.535553203,0.535553203,1.170500555,0.546233592,1,1,1
4459,19,140,60,110,87,0,4453.313,74,3738.366,MORE,-1036,2448,1412,4,1,-23,-2.15603946,23,2.444506035,0.50129996,0.807909183,197,110,87,1,0.737966017,1.170500555,0.273116796,1.430193884,-1.282613163,1.282613163,0.273116796,1.170500555,1,1,0
4460,19,141,33,75,80,0,5902.98,84,1058.306,MORE,244,2550,2794,4,2,5,0.46870423,5,-0.698430296,0.93816267,1.654808629,155,75,80,0,-0.099725137,-0.195083426,0,1.430193884,0.527070312,0.527070312,0,-0.195083426,1,1,1
4461,19,142,15,50,45,0,1932.701,64,1768.536,MORE,-496,1190,694,2,2,-5,-0.46870423,5,-0.698430296,0.06443725,-0.664639276,95,50,45,1,-1.296426786,-1.170500555,-1.36558398,-0.476731295,-0.519152947,0.519152947,-1.36558398,-1.170500555,0,0,0
4462,19,143,59,89,110,1,3714.698,74,1009.687,MORE,272,912,1184,3,2,21,1.968557767,21,2.095290887,0.50129996,0.376408269,199,89,110,0,0.777856072,0.351150166,1.170500555,0.476731295,0.566657138,0.566657138,1.170500555,0.351150166,1,1,1
4463,19,144,29,80,94,1,2244.891,84,1632.23,MORE,430,974,1404,3,2,14,1.312371845,14,0.87303787,0.93816267,-0.48225702,174,80,94,0,0.279230385,0,0.546233592,0.476731295,0.790039942,0.790039942,0.546233592,0,1,1,1
4464,19,145,55,110,98,0,2143.856,74,1387.923,MORE,-926,1628,702,2,1,-12,-1.124890153,12,0.523822722,0.50129996,-0.541281945,208,110,98,1,0.957361319,1.170500555,0.702300333,-0.476731295,-1.127093489,1.127093489,0.702300333,1.170500555,1,0,0
4465,19,146,29,94,80,0,1826.174,34,1446.464,MORE,-586,1220,634,2,1,-14,-1.312371845,14,0.87303787,-1.246150881,-0.726872643,174,94,80,1,0.279230385,0.546233592,0,-0.476731295,-0.646396316,0.646396316,0,0.546233592,0,0,0
4466,19,147,57,110,94,1,2775.116,34,742.863,MORE,154,1122,1276,3,2,-16,-1.499853537,16,1.222253018,-1.246150881,-0.172498118,204,110,94,1,0.877581209,1.170500555,0.546233592,0.476731295,0.399826943,0.399826943,0.546233592,1.170500555,0,1,1
4467,19,148,39,80,66,0,2241.94,24,904.906,MORE,-736,1362,626,2,1,-14,-1.312371845,14,0.87303787,-1.683013592,-0.483981002,146,80,66,1,-0.279230385,0,-0.546233592,-0.476731295,-0.858468598,0.858468598,-0.546233592,0,0,0,0
4468,19,149,4,50,54,1,1525.192,74,1184.412,MORE,1184,444,1628,1,2,4,0.374963384,4,-0.87303787,0.50129996,-0.902707154,104,50,54,0,-1.116921539,-1.170500555,-1.014433814,-1.430193884,1.856056614,1.856056614,-1.014433814,-1.170500555,0,0,1
4469,19,150,55,98,110,1,1661.692,74,1415.895,MORE,444,606,1050,1,2,12,1.124890153,12,0.523822722,0.50129996,-0.822963479,208,98,110,0,0.957361319,0.702300333,1.170500555,-1.430193884,0.809833355,0.809833355,1.170500555,0.702300333,0,0,1
4470,19,151,2,50,52,1,1982.42,64,958.07,MORE,100,922,1022,3,2,2,0.187481692,2,-1.222253018,0.06443725,-0.6355933,102,50,52,0,-1.156811594,-1.170500555,-1.092467184,0.476731295,0.323480921,0.323480921,-1.092467184,-1.170500555,0,1,0
4471,19,152,59,110,89,0,2120.983,64,1460.406,MORE,-454,1158,704,2,1,-21,-1.968557767,21,2.095290887,0.06443725,-0.554644414,199,110,89,1,0.777856072,1.170500555,0.351150166,-0.476731295,-0.459772708,0.459772708,0.351150166,1.170500555,0,0,0
4472,19,153,60,87,110,1,1491.518,94,762.78,MORE,830,454,1284,1,2,23,2.15603946,23,2.444506035,1.375025381,-0.922379598,197,87,110,0,0.737966017,0.273116796,1.170500555,-1.430193884,1.355566028,1.355566028,1.170500555,0.273116796,1,0,1
4473,19,154,52,110,105,1,3125.084,24,1669.571,MORE,282,1264,1546,3,2,-5,-0.46870423,5,-0.698430296,-1.683013592,0.03195415,215,110,105,1,1.096976512,1.170500555,0.975417129,0.476731295,0.58079529,0.58079529,0.975417129,1.170500555,0,1,1
4474,19,155,30,80,96,1,2151.289,54,2026.108,MORE,-158,1108,950,3,1,16,1.499853537,16,1.222253018,-0.372425461,-0.536939566,176,80,96,0,0.31912044,0,0.624266962,0.476731295,-0.041283404,0.041283404,0.624266962,0,0,1,0
4475,19,156,24,80,86,1,2179.713,84,829.255,MORE,364,792,1156,3,2,6,0.562445076,6,-0.523822722,0.93816267,-0.520334187,166,80,86,0,0.119670165,0,0.234100111,0.476731295,0.696728138,0.696728138,0.234100111,0,1,1,1
4476,19,157,5,50,55,1,1432.141,70,1275.405,MORE,1110,462,1572,1,2,5,0.46870423,5,-0.698430296,0.326554876,-0.957067804,105,50,55,0,-1.096976512,-1.170500555,-0.975417129,-1.430193884,1.751434288,1.751434288,-0.975417129,-1.170500555,0,0,1
4477,19,158,34,80,74,1,1377.872,94,684.579,MORE,544,444,988,1,2,-6,-0.562445076,6,-0.523822722,1.375025381,-0.988771903,154,80,74,1,-0.119670165,0,-0.234100111,-1.430193884,0.951214877,0.951214877,-0.234100111,0,1,0,1
4478,19,159,15,45,50,1,2309.258,44,774.707,MORE,30,1032,1062,3,2,5,0.46870423,5,-0.698430296,-0.809288171,-0.444653642,95,45,50,0,-1.296426786,-1.36558398,-1.170500555,0.476731295,0.224513856,0.224513856,-1.170500555,-1.36558398,0,1,0
4479,19,160,37,69,80,1,1547.858,74,556.108,MORE,-200,1016,816,1,1,11,1.031149307,11,0.349215148,0.50129996,-0.889465615,149,69,80,0,-0.219395302,-0.429183537,0,-1.430193884,-0.100663643,0.100663643,0,-0.429183537,0,0,0
4480,19,161,3,50,53,0,3952.368,14,1404.368,LESS,96,1720,1816,3,1,3,0.281222538,3,-1.047645444,-2.119876302,0.515255737,103,50,53,1,-1.136866566,-1.170500555,-1.053450499,0.476731295,0.31782566,0.31782566,-1.053450499,-1.170500555,0,1,1
4481,19,162,20,50,40,0,1830.854,14,626.71,LESS,-382,1030,648,2,1,-10,-0.937408461,10,0.174607574,-2.119876302,-0.724138574,90,50,40,0,-1.396151924,-1.170500555,-1.560667406,-0.476731295,-0.357978012,0.357978012,-1.560667406,-1.170500555,0,0,0
4482,19,163,25,80,88,0,6182.783,14,932.046,LESS,-1572,3462,1890,4,1,8,0.749926769,8,-0.174607574,-2.119876302,1.818270311,168,80,88,1,0.15956022,0,0.312133481,1.430193884,-2.040418118,2.040418118,0.312133481,0,0,1,0
4483,19,164,42,115,110,0,1856.125,24,1797.202,LESS,-346,1016,670,2,1,-5,-0.46870423,5,-0.698430296,-1.683013592,-0.709375186,225,115,110,0,1.296426786,1.36558398,1.170500555,-0.476731295,-0.307080665,0.307080665,1.170500555,1.36558398,0,0,1
4484,19,165,53,103,110,0,2229.554,24,1181.062,LESS,-366,1170,804,2,1,7,0.656185922,7,-0.349215148,-1.683013592,-0.491216938,213,103,110,1,1.057086457,0.897383758,1.170500555,-0.476731295,-0.335356969,0.335356969,1.170500555,0.897383758,0,0,1
4485,19,166,26,90,80,1,3008.253,24,888.909,LESS,698,1114,1812,3,2,-10,-0.937408461,10,0.174607574,-1.683013592,-0.036298841,170,90,80,0,0.199450275,0.390166852,0,0.476731295,1.16894242,1.16894242,0,0.390166852,0,1,1
4486,19,167,35,80,72,0,2037.898,64,1343.965,LESS,-512,1128,616,2,1,-8,-0.749926769,8,-0.174607574,0.06443725,-0.6031829,152,80,72,0,-0.15956022,0,-0.312133481,-0.476731295,-0.54177399,0.54177399,-0.312133481,0,0,0,0
4487,19,168,28,93,80,1,3785.298,54,1065.749,LESS,468,1552,2020,3,2,-13,-1.218630999,13,0.698430296,-0.372425461,0.417652984,173,93,80,0,0.259285357,0.507216907,0,0.476731295,0.84376492,0.84376492,0,0.507216907,0,1,1
4488,19,169,26,80,90,0,2218.548,44,1433.594,LESS,-60,936,876,2,1,10,0.937408461,10,0.174607574,-0.809288171,-0.497646673,170,80,90,1,0.199450275,0,0.390166852,-0.476731295,0.097270487,0.097270487,0.390166852,0,0,0,1
4489,19,170,25,88,80,0,1848.757,30,1353.667,LESS,-1008,1602,594,2,1,-8,-0.749926769,8,-0.174607574,-1.420895965,-0.713679592,168,88,80,0,0.15956022,0.312133481,0,-0.476731295,-1.243026337,1.243026337,0,0.312133481,0,0,0
4490,19,171,36,80,70,1,2857.418,54,1422.499,LESS,426,1088,1514,3,2,-10,-0.937408461,10,0.174607574,-0.372425461,-0.124417063,150,80,70,0,-0.199450275,0,-0.390166852,0.476731295,0.784384681,0.784384681,-0.390166852,0,0,1,1
4491,19,172,28,80,93,0,1687.584,34,933.684,LESS,-388,974,586,2,1,13,1.218630999,13,0.698430296,-1.246150881,-0.807837302,173,80,93,1,0.259285357,0,0.507216907,-0.476731295,-0.366460904,0.366460904,0.507216907,0,0,0,0
4492,19,173,21,82,80,1,2839.998,34,1249.172,LESS,16,1338,1354,3,2,-2,-0.187481692,2,-1.222253018,-1.246150881,-0.134593875,162,82,80,0,0.039890055,0.07803337,0,0.476731295,0.204720443,0.204720443,0,0.07803337,0,1,1
4493,19,174,19,50,41,1,2783.62,14,694.504,LESS,198,1174,1372,3,1,-9,-0.843667615,9,0,-2.119876302,-0.167530058,91,50,41,0,-1.376206896,-1.170500555,-1.521650721,0.476731295,0.462034812,0.462034812,-1.521650721,-1.170500555,0,1,1
4494,19,175,56,96,110,0,2484.105,24,1810.997,LESS,-1140,1688,548,2,1,14,1.312371845,14,0.87303787,-1.683013592,-0.342507544,206,96,110,1,0.917471264,0.624266962,1.170500555,-0.476731295,-1.429649945,1.429649945,1.170500555,0.624266962,0,0,0
4495,19,176,23,80,85,0,5557.585,64,1469.48,LESS,-792,2944,2152,4,1,5,0.46870423,5,-0.698430296,0.06443725,1.453027921,165,80,85,1,0.099725137,0,0.195083426,1.430193884,-0.93764225,0.93764225,0.195083426,0,0,1,0
4496,19,177,10,60,50,0,2378.669,74,1133.674,LESS,-302,1220,918,2,1,-10,-0.937408461,10,0.174607574,0.50129996,-0.404103545,110,60,50,0,-0.997251374,-0.780333703,-1.170500555,-0.476731295,-0.244872795,0.244872795,-1.170500555,-0.780333703,1,0,1
4497,19,178,19,41,50,0,2282.908,64,1753.166,LESS,-874,1616,742,2,1,9,0.843667615,9,0,0.06443725,-0.460047384,91,41,50,1,-1.376206896,-1.521650721,-1.170500555,-0.476731295,-1.053575098,1.053575098,-1.170500555,-1.521650721,0,0,0
4498,19,179,56,110,96,0,1793.275,60,1553.192,LESS,-480,1358,878,2,1,-14,-1.312371845,14,0.87303787,-0.110307834,-0.746092329,206,110,96,0,0.917471264,1.170500555,0.624266962,-0.476731295,-0.496531903,0.496531903,0.624266962,1.170500555,0,0,0
4499,19,180,35,72,80,0,1625.402,74,1681.022,LESS,-30,1100,1070,2,2,8,0.749926769,8,-0.174607574,0.50129996,-0.844164197,152,72,80,1,-0.15956022,-0.312133481,0,-0.476731295,0.139684943,0.139684943,0,-0.312133481,1,0,1
4500,19,181,11,49,50,0,3139.988,64,1529.466,LESS,-114,1460,1346,4,1,1,0.093740846,1,-1.396860592,0.06443725,0.040661108,99,49,50,1,-1.216646676,-1.20951724,-1.170500555,1.430193884,0.020924465,0.020924465,-1.170500555,-1.20951724,0,1,1
4501,19,182,17,43,50,0,2142.799,54,781.222,LESS,-362,1180,818,2,1,7,0.656185922,7,-0.349215148,-0.372425461,-0.541899447,93,43,50,1,-1.336316841,-1.443617351,-1.170500555,-0.476731295,-0.329701708,0.329701708,-1.170500555,-1.443617351,0,0,1
4502,19,183,1,51,50,0,2098.373,64,922.101,LESS,-396,1154,758,2,1,-1,-0.093740846,1,-1.396860592,0.06443725,-0.567853239,101,51,50,0,-1.176756621,-1.131483869,-1.170500555,-0.476731295,-0.377771425,0.377771425,-1.170500555,-1.131483869,0,0,0
4503,19,184,41,112,110,0,1648.974,74,1433.904,LESS,-320,820,500,2,1,-2,-0.187481692,2,-1.222253018,0.50129996,-0.83039337,222,112,110,0,1.236591704,1.248533925,1.170500555,-0.476731295,-0.270321469,0.270321469,1.170500555,1.248533925,1,0,1
4504,19,185,20,40,50,0,1655.8,74,1553.697,LESS,396,770,1166,2,2,10,0.937408461,10,0.174607574,0.50129996,-0.826405602,90,40,50,1,-1.396151924,-1.560667406,-1.170500555,-0.476731295,0.741970225,0.741970225,-1.170500555,-1.560667406,1,0,1
4505,19,186,1,50,51,0,1556.447,74,751.726,LESS,-334,848,514,2,1,1,0.093740846,1,-1.396860592,0.50129996,-0.884447897,101,50,51,1,-1.176756621,-1.170500555,-1.131483869,-0.476731295,-0.290114882,0.290114882,-1.131483869,-1.170500555,1,0,1
4506,19,187,23,85,80,0,1820.525,70,1281.475,LESS,-296,930,634,2,2,-5,-0.46870423,5,-0.698430296,0.326554876,-0.730172804,165,85,80,0,0.099725137,0.195083426,0,-0.476731295,-0.236389904,0.236389904,0,0.195083426,1,0,1
4507,19,188,11,50,49,0,1524.926,74,1437.463,LESS,-338,832,494,2,1,-1,-0.093740846,1,-1.396860592,0.50129996,-0.902862552,99,50,49,0,-1.216646676,-1.170500555,-1.20951724,-0.476731295,-0.295770143,0.295770143,-1.20951724,-1.170500555,1,0,1
4508,19,189,17,50,43,0,1508.127,74,1509.575,LESS,-414,898,484,2,1,-7,-0.656185922,7,-0.349215148,0.50129996,-0.912676574,93,50,43,0,-1.336316841,-1.170500555,-1.443617351,-0.476731295,-0.403220099,0.403220099,-1.443617351,-1.170500555,1,0,0
4509,19,190,21,80,82,0,1634.522,74,1520.277,LESS,-346,874,528,2,1,2,0.187481692,2,-1.222253018,0.50129996,-0.838836268,162,80,82,1,0.039890055,0,0.07803337,-0.476731295,-0.307080665,0.307080665,0.07803337,0,1,0,1
4510,19,191,10,50,60,0,2090.5,74,1096.919,LESS,-446,1108,662,2,1,10,0.937408461,10,0.174607574,0.50129996,-0.572452667,110,50,60,1,-0.997251374,-1.170500555,-0.780333703,-0.476731295,-0.448462186,0.448462186,-0.780333703,-1.170500555,1,0,0
4511,19,192,3,53,50,0,2216.038,74,788.471,LESS,-414,1192,778,2,1,-3,-0.281222538,3,-1.047645444,0.50129996,-0.499113022,103,53,50,0,-1.136866566,-1.053450499,-1.170500555,-0.476731295,-0.403220099,0.403220099,-1.170500555,-1.053450499,1,0,0
4512,19,193,45,122,110,0,1694.099,74,829.428,LESS,28,800,828,2,2,-12,-1.124890153,12,0.523822722,0.50129996,-0.804031221,232,122,110,0,1.436041979,1.638700776,1.170500555,-0.476731295,0.221686226,0.221686226,1.170500555,1.638700776,1,0,1
4513,19,194,38,67,80,0,1569.817,84,621.119,LESS,-244,820,576,2,2,13,1.218630999,13,0.698430296,0.93816267,-0.876637107,147,67,80,1,-0.259285357,-0.507216907,0,-0.476731295,-0.162871513,0.162871513,0,-0.507216907,1,0,1
4514,19,195,38,80,67,1,2873.241,34,1059.623,LESS,86,1256,1342,3,2,-13,-1.218630999,13,0.698430296,-1.246150881,-0.115173223,147,80,67,0,-0.259285357,0,-0.507216907,0.476731295,0.303687508,0.303687508,-0.507216907,0,0,1,1
4515,19,196,36,70,80,0,1660.14,100,665.082,LESS,0,914,914,2,2,10,0.937408461,10,0.174607574,1.637143007,-0.823870162,150,70,80,1,-0.199450275,-0.390166852,0,-0.476731295,0.1820994,0.1820994,0,-0.390166852,1,0,1
4516,19,197,45,110,122,0,5719.129,54,1233.745,LESS,-1236,2994,1758,5,1,12,1.124890153,12,0.523822722,-0.372425461,1.54740237,232,110,122,1,1.436041979,1.170500555,1.638700776,2.383656473,-1.565376206,1.565376206,1.638700776,1.170500555,0,1,0
4517,19,198,42,110,115,0,2061.671,74,807.458,LESS,-718,1412,694,2,1,5,0.46870423,5,-0.698430296,0.50129996,-0.589294648,225,110,115,1,1.296426786,1.170500555,1.36558398,-0.476731295,-0.833019925,0.833019925,1.36558398,1.170500555,1,0,0
4518,19,199,41,110,112,0,2244.51,34,822.637,LESS,-444,1206,762,2,1,2,0.187481692,2,-1.222253018,-1.246150881,-0.482479601,222,110,112,1,1.236591704,1.170500555,1.248533925,-0.476731295,-0.445634556,0.445634556,1.248533925,1.170500555,0,0,0
4519,19,200,53,110,103,0,1632.625,64,1835.076,LESS,-2570,3186,616,2,1,-7,-0.656185922,7,-0.349215148,0.06443725,-0.8399445,213,110,103,0,1.057086457,1.170500555,0.897383758,-0.476731295,-3.451405702,3.451405702,0.897383758,1.170500555,0,0,0
4520,19,201,3,50,53,1,2820.587,64,1144.225,MORE,858,998,1856,3,2,3,0.281222538,3,-1.047645444,0.06443725,-0.145933834,103,50,53,0,-1.136866566,-1.170500555,-1.053450499,0.476731295,1.395152854,1.395152854,-1.053450499,-1.170500555,0,1,1
4521,19,202,20,50,40,0,1704.659,80,1121.67,MORE,686,972,1658,2,2,-10,-0.937408461,10,0.174607574,0.763417586,-0.79786204,90,50,40,1,-1.396151924,-1.170500555,-1.560667406,-0.476731295,1.151976637,1.151976637,-1.560667406,-1.170500555,1,0,1
4522,19,203,25,80,88,0,5033.169,34,1610.14,MORE,-924,2608,1684,4,1,8,0.749926769,8,-0.174607574,-1.246150881,1.146662652,168,80,88,0,0.15956022,0,0.312133481,1.430193884,-1.124265859,1.124265859,0.312133481,0,0,1,0
4523,19,204,42,115,110,0,2697.706,64,741.256,MORE,-240,1406,1166,2,1,-5,-0.46870423,5,-0.698430296,0.06443725,-0.217721252,225,115,110,1,1.296426786,1.36558398,1.170500555,-0.476731295,-0.157216252,0.157216252,1.170500555,1.36558398,0,0,0
4524,19,205,53,103,110,1,1747.092,74,849.95,MORE,704,504,1208,1,2,7,0.656185922,7,-0.349215148,0.50129996,-0.773072564,213,103,110,0,1.057086457,0.897383758,1.170500555,-1.430193884,1.177425311,1.177425311,1.170500555,0.897383758,0,0,1
4525,19,206,26,90,80,0,2692.379,60,1596.902,MORE,268,1272,1540,2,1,-10,-0.937408461,10,0.174607574,-0.110307834,-0.220833301,170,90,80,1,0.199450275,0.390166852,0,-0.476731295,0.561001877,0.561001877,0,0.390166852,0,0,1
4526,19,207,35,80,72,1,4167.55,74,1785.38,MORE,-44,1928,1884,3,2,-8,-0.749926769,8,-0.174607574,0.50129996,0.640965653,152,80,72,1,-0.15956022,0,-0.312133481,0.476731295,0.11989153,0.11989153,-0.312133481,0,1,1,0
4527,19,208,28,93,80,0,1764.523,64,813.532,MORE,-372,1088,716,2,1,-13,-1.218630999,13,0.698430296,0.06443725,-0.762889326,173,93,80,1,0.259285357,0.507216907,0,-0.476731295,-0.34383986,0.34383986,0,0.507216907,0,0,0
4528,19,209,26,80,90,1,1728.311,84,674.301,MORE,682,512,1194,1,2,10,0.937408461,10,0.174607574,0.93816267,-0.784044476,170,80,90,0,0.199450275,0,0.390166852,-1.430193884,1.146321376,1.146321376,0.390166852,0,1,0,1
4529,19,210,25,88,80,0,2294.46,64,1037.55,MORE,-782,1568,786,2,1,-8,-0.749926769,8,-0.174607574,0.06443725,-0.453298674,168,88,80,1,0.15956022,0.312133481,0,-0.476731295,-0.923504098,0.923504098,0,0.312133481,0,0,0
4530,19,211,36,80,70,0,2101.04,64,1079.706,MORE,-144,1014,870,2,1,-10,-0.937408461,10,0.174607574,0.06443725,-0.56629517,150,80,70,1,-0.199450275,0,-0.390166852,-0.476731295,-0.021489991,0.021489991,-0.390166852,0,0,0,0
4531,19,212,28,80,93,1,1214.529,80,1125.294,MORE,546,356,902,1,2,13,1.218630999,13,0.698430296,0.763417586,-1.084197333,173,80,93,0,0.259285357,0,0.507216907,-1.430193884,0.954042507,0.954042507,0.507216907,0,1,0,1
4532,19,213,21,82,80,0,2307.713,74,1110.097,MORE,-290,1188,898,2,1,-2,-0.187481692,2,-1.222253018,0.50129996,-0.445556235,162,82,80,1,0.039890055,0.07803337,0,-0.476731295,-0.227907013,0.227907013,0,0.07803337,0,1,0
4533,19,214,19,50,41,0,1943.765,64,815.402,MORE,-358,1080,722,2,1,-9,-0.843667615,9,0,0.06443725,-0.658175657,91,50,41,1,-1.376206896,-1.170500555,-1.521650721,-0.476731295,-0.324046447,0.324046447,-1.521650721,-1.170500555,0,1,0
4534,19,215,56,96,110,1,2984.033,64,1250.001,MORE,176,1260,1436,3,2,14,1.312371845,14,0.87303787,0.06443725,-0.050448232,206,96,110,0,0.917471264,0.624266962,1.170500555,0.476731295,0.430930877,0.430930877,1.170500555,0.624266962,0,1,1
4535,19,216,23,80,85,1,1332.618,84,632.831,MORE,380,448,828,1,2,5,0.46870423,5,-0.698430296,0.93816267,-1.015209414,165,80,85,0,0.099725137,0,0.195083426,-1.430193884,0.719349181,0.719349181,0.195083426,0,1,0,1
4536,19,217,10,60,50,0,1997.231,64,939.834,MORE,-480,1120,640,2,1,-10,-0.937408461,10,0.174607574,0.06443725,-0.626940673,110,60,50,1,-0.997251374,-0.780333703,-1.170500555,-0.476731295,-0.496531903,0.496531903,-1.170500555,-0.780333703,0,0,0
4537,19,218,19,41,50,1,1159.195,94,681.185,MORE,436,472,908,1,2,9,0.843667615,9,0,1.375025381,-1.116523608,91,41,50,0,-1.376206896,-1.521650721,-1.170500555,-1.430193884,0.798522833,0.798522833,-1.170500555,-1.521650721,1,0,1
4538,19,219,56,110,96,0,3082.875,14,984.416,MORE,-614,1924,1310,4,1,-14,-1.312371845,14,0.87303787,-2.119876302,0.007295536,206,110,96,1,0.917471264,1.170500555,0.624266962,1.430193884,-0.685983142,0.685983142,0.624266962,1.170500555,0,1,0
4539,19,220,35,72,80,1,1549.754,84,923.847,MORE,560,362,922,1,2,8,0.749926769,8,-0.174607574,0.93816267,-0.888357966,152,72,80,0,-0.15956022,-0.312133481,0,-1.430193884,0.97383592,0.97383592,0,-0.312133481,1,0,1
4540,19,221,11,49,50,1,1515.689,74,806.137,MORE,738,446,1184,1,2,1,0.093740846,1,-1.396860592,0.50129996,-0.908258833,99,49,50,0,-1.216646676,-1.20951724,-1.170500555,-1.430193884,1.225495028,1.225495028,-1.170500555,-1.20951724,0,0,1
4541,19,222,17,43,50,1,1488.156,64,656.8,MORE,426,486,912,1,2,7,0.656185922,7,-0.349215148,0.06443725,-0.924343687,93,43,50,0,-1.336316841,-1.443617351,-1.170500555,-1.430193884,0.784384681,0.784384681,-1.170500555,-1.443617351,0,0,1
4542,19,223,1,51,50,0,1897.56,4,701.878,MORE,-992,1692,700,2,1,-1,-0.093740846,1,-1.396860592,-2.556739012,-0.685168745,101,51,50,1,-1.176756621,-1.131483869,-1.170500555,-0.476731295,-1.220405293,1.220405293,-1.170500555,-1.131483869,0,0,0
4543,19,224,41,112,110,1,7088.219,64,1335.06,MORE,-680,3252,2572,2,2,-2,-0.187481692,2,-1.222253018,0.06443725,2.347228511,222,112,110,1,1.236591704,1.248533925,1.170500555,-0.476731295,-0.779294946,0.779294946,1.170500555,1.248533925,0,0,0
4544,19,225,20,40,50,1,1622.081,24,1778.505,MORE,302,442,744,1,2,10,0.937408461,10,0.174607574,-1.683013592,-0.846104334,90,40,50,0,-1.396151924,-1.560667406,-1.170500555,-1.430193884,0.609071595,0.609071595,-1.170500555,-1.560667406,0,0,1
4545,19,226,1,50,51,1,1302.495,74,1366.7,MORE,366,394,760,1,2,1,0.093740846,1,-1.396860592,0.50129996,-1.032807354,101,50,51,0,-1.176756621,-1.170500555,-1.131483869,-1.430193884,0.699555768,0.699555768,-1.131483869,-1.170500555,1,0,1
4546,19,227,23,85,80,0,2427.401,84,771.634,MORE,-584,1398,814,2,1,-5,-0.46870423,5,-0.698430296,0.93816267,-0.375634176,165,85,80,1,0.099725137,0.195083426,0,-0.476731295,-0.643568686,0.643568686,0,0.195083426,1,0,0
4547,19,228,11,50,49,1,1189.172,84,591.677,MORE,290,428,718,1,2,-1,-0.093740846,1,-1.396860592,0.93816267,-1.099010962,99,50,49,1,-1.216646676,-1.170500555,-1.20951724,-1.430193884,0.592105812,0.592105812,-1.20951724,-1.170500555,1,0,1
4548,19,229,17,50,43,0,2249.489,84,598.008,MORE,-550,1376,826,2,1,-7,-0.656185922,7,-0.349215148,0.93816267,-0.479570856,93,50,43,1,-1.336316841,-1.170500555,-1.443617351,-0.476731295,-0.595498968,0.595498968,-1.443617351,-1.170500555,1,0,0
4549,19,230,21,80,82,1,1565.388,94,581.323,MORE,582,584,1166,1,2,2,0.187481692,2,-1.222253018,1.375025381,-0.879224541,162,80,82,0,0.039890055,0,0.07803337,-1.430193884,1.004939855,1.004939855,0.07803337,0,1,0,1
4550,19,231,10,50,60,1,1388.035,84,884.98,MORE,706,468,1174,1,2,10,0.937408461,10,0.174607574,0.93816267,-0.982834651,110,50,60,0,-0.997251374,-1.170500555,-0.780333703,-1.430193884,1.180252941,1.180252941,-0.780333703,-1.170500555,1,0,1
4551,19,232,3,53,50,1,1375.454,100,570.006,MORE,600,400,1000,1,2,-3,-0.281222538,3,-1.047645444,1.637143007,-0.990184506,103,53,50,1,-1.136866566,-1.053450499,-1.170500555,-1.430193884,1.030388529,1.030388529,-1.170500555,-1.053450499,1,0,1
4552,19,233,45,122,110,0,3890.676,24,686.333,MORE,-602,1880,1278,4,1,-12,-1.124890153,12,0.523822722,-1.683013592,0.479215101,232,122,110,1,1.436041979,1.638700776,1.170500555,1.430193884,-0.66901736,0.66901736,1.170500555,1.638700776,0,1,0
4553,19,234,38,67,80,1,1456.266,74,1212.116,MORE,164,544,708,1,2,13,1.218630999,13,0.698430296,0.50129996,-0.942973913,147,67,80,0,-0.259285357,-0.507216907,0,-1.430193884,0.413965095,0.413965095,0,-0.507216907,1,0,1
4554,19,235,38,80,67,0,1537.374,34,1363.056,MORE,-418,1020,602,2,1,-13,-1.218630999,13,0.698430296,-1.246150881,-0.895590396,147,80,67,1,-0.259285357,0,-0.507216907,-0.476731295,-0.40887536,0.40887536,-0.507216907,0,0,0,0
4555,19,236,36,70,80,0,2288.943,34,1521.747,MORE,-522,1356,834,2,1,10,0.937408461,10,0.174607574,-1.246150881,-0.456521721,150,70,80,0,-0.199450275,-0.390166852,0,-0.476731295,-0.555912142,0.555912142,0,-0.390166852,0,0,0
4556,19,237,45,110,122,1,3323.84,34,753.888,MORE,-110,1562,1452,3,2,12,1.124890153,12,0.523822722,-1.246150881,0.148067951,232,110,122,0,1.436041979,1.170500555,1.638700776,0.476731295,0.026579726,0.026579726,1.638700776,1.170500555,0,1,0
4557,19,238,42,110,115,1,1529.707,74,1086.814,MORE,456,462,918,1,2,5,0.46870423,5,-0.698430296,0.50129996,-0.900069479,225,110,115,0,1.296426786,1.170500555,1.36558398,-1.430193884,0.826799138,0.826799138,1.36558398,1.170500555,1,0,1
4558,19,239,41,110,112,0,2465.503,64,977.661,MORE,-504,1208,704,2,1,2,0.187481692,2,-1.222253018,0.06443725,-0.353374883,222,110,112,0,1.236591704,1.170500555,1.248533925,-0.476731295,-0.530463469,0.530463469,1.248533925,1.170500555,0,0,0
4559,19,240,53,110,103,1,1531.841,64,986.281,MORE,608,416,1024,1,2,-7,-0.656185922,7,-0.349215148,0.06443725,-0.89882279,213,110,103,1,1.057086457,1.170500555,0.897383758,-1.430193884,1.04169905,1.04169905,0.897383758,1.170500555,0,0,1
4560,20,1,49,110,131,1,3096.527,80,2499.221,MORE,292,1160,1452,2,2,21,1.968557767,21,2.095290887,0.828339326,-0.345480707,241,110,131,0,1.615547226,1.170500555,1.989850943,-0.468439217,0.303522941,0.303522941,1.989850943,1.170500555,1,0,1
4561,20,2,13,47,50,1,4804.017,60,1153.926,MORE,1284,1404,2688,5,2,3,0.281222538,3,-1.047645444,0.120860898,0.2323102,97,47,50,0,-1.256536731,-1.28755061,-1.170500555,1.481134403,1.225453252,1.225453252,-1.170500555,-1.28755061,0,1,1
4562,20,3,16,50,44,0,4758.342,40,2161.592,MORE,62,2082,2144,4,1,-6,-0.562445076,6,-0.523822722,-0.58661753,0.216854415,94,50,44,1,-1.316371814,-1.170500555,-1.404600665,0.83127653,0.089768937,0.089768937,-1.404600665,-1.170500555,0,1,0
4563,20,4,7,57,50,0,11233.854,30,1965.888,MORE,-3164,6468,3304,5,1,-7,-0.656185922,7,-0.349215148,-0.940356744,2.408077762,107,57,50,1,-1.057086457,-0.897383758,-1.170500555,1.481134403,-2.908363307,2.908363307,-1.170500555,-0.897383758,0,1,0
4564,20,5,18,42,50,1,2826.187,80,722.235,MORE,236,1238,1474,1,2,8,0.749926769,8,-0.174607574,0.828339326,-0.436960009,92,42,50,0,-1.356261869,-1.482634036,-1.170500555,-1.11829709,0.251478488,0.251478488,-1.170500555,-1.482634036,1,0,1
4565,20,6,51,108,110,1,7828.68,10,2588.724,MORE,-1400,4064,2664,3,1,2,0.187481692,2,-1.222253018,-1.647835171,1.255814162,218,108,110,0,1.156811594,1.092467184,1.170500555,0.181418656,-1.268963035,1.268963035,1.170500555,1.092467184,0,1,0
4566,20,7,31,78,80,1,2204.878,80,1687.077,MORE,38,976,1014,0,2,2,0.187481692,2,-1.222253018,0.828339326,-0.647202348,158,78,80,0,-0.039890055,-0.07803337,0,-1.768154963,0.067464171,0.067464171,0,-0.07803337,1,0,0
4567,20,8,58,110,92,0,11649.615,20,2784.664,MORE,-4864,6576,1712,1,1,-18,-1.687335229,18,1.571468165,-1.294095958,2.548765512,202,110,92,1,0.837691154,1.170500555,0.468200222,-1.11829709,-4.488284204,4.488284204,0.468200222,1.170500555,0,0,0
4568,20,9,12,50,48,0,4665.718,50,1938.24,MORE,-452,2398,1946,4,1,-2,-0.187481692,2,-1.222253018,-0.232878316,0.185511739,98,50,48,1,-1.236591704,-1.170500555,-1.248533925,0.83127653,-0.387924793,0.387924793,-1.248533925,-1.170500555,0,1,0
4569,20,10,54,110,101,0,5082.372,60,2286.866,MORE,476,2018,2494,5,2,-9,-0.843667615,9,0,0.120860898,0.326501667,211,110,101,1,1.017196402,1.170500555,0.819350388,1.481134403,0.474526144,0.474526144,0.819350388,1.170500555,0,1,1
4570,20,11,14,46,50,0,8662.197,10,2686.308,MORE,-452,4518,4066,5,1,4,0.374963384,4,-0.87303787,-1.647835171,1.537864741,96,46,50,0,-1.276481759,-1.326567295,-1.170500555,1.481134403,-0.387924793,0.387924793,-1.170500555,-1.326567295,0,1,0
4571,20,12,22,80,83,1,4227.617,10,1101.33,MORE,-1154,2470,1316,0,1,3,0.281222538,3,-1.047645444,-1.647835171,0.037264444,163,80,83,0,0.059835082,0,0.117050055,-1.768154963,-1.040339187,1.040339187,0.117050055,0,0,0,0
4572,20,13,6,50,56,1,2754.283,100,2146.752,MORE,2152,694,2846,3,2,6,0.562445076,6,-0.523822722,1.535817754,-0.461291324,106,50,56,0,-1.077031484,-1.170500555,-0.936400444,0.181418656,2.032142275,2.032142275,-0.936400444,-1.170500555,1,0,1
4573,20,14,13,50,47,1,11298.604,20,2485.231,MORE,-748,5598,4850,8,1,-3,-0.281222538,3,-1.047645444,-1.294095958,2.429988263,97,50,47,1,-1.256536731,-1.170500555,-1.28755061,3.430708022,-0.663016902,0.663016902,-1.28755061,-1.170500555,0,1,0
4574,20,15,46,110,124,1,10917.788,40,2331.359,MORE,830,3858,4688,3,1,14,1.312371845,14,0.87303787,-0.58661753,2.301125416,234,110,124,0,1.475932034,1.170500555,1.716734147,0.181418656,0.803521436,0.803521436,1.716734147,1.170500555,0,0,1
4575,20,16,27,91,80,0,5971.618,40,3085.238,MORE,-1172,2948,1776,3,1,-11,-1.031149307,11,0.349215148,-0.58661753,0.627410167,171,91,80,1,0.219395302,0.429183537,0,0.181418656,-1.057067761,1.057067761,0,0.429183537,0,1,0
4576,20,17,40,64,80,1,1915.946,60,1076.33,MORE,272,686,958,1,2,16,1.499853537,16,1.222253018,0.120860898,-0.744972925,144,64,80,0,-0.31912044,-0.624266962,0,-1.11829709,0.284935636,0.284935636,0,-0.624266962,0,0,1
4577,20,18,22,83,80,0,6732.477,30,1893.434,MORE,-286,2782,2496,3,1,-3,-0.281222538,3,-1.047645444,-0.940356744,0.884874288,163,83,80,1,0.059835082,0.117050055,0,0.181418656,-0.233650164,0.233650164,0,0.117050055,0,1,0
4578,20,19,54,101,110,0,7365.374,10,1595.083,MORE,-1126,3456,2330,2,1,9,0.843667615,9,0,-1.647835171,1.099037845,211,101,110,0,1.017196402,0.819350388,1.170500555,-0.468439217,-1.014316961,1.014316961,1.170500555,0.819350388,0,0,0
4579,20,20,6,56,50,0,8669.064,10,1493.607,MORE,-3644,5926,2282,3,1,-6,-0.562445076,6,-0.523822722,-1.647835171,1.540188439,106,56,50,1,-1.077031484,-0.936400444,-1.170500555,0.181418656,-3.354458619,3.354458619,-1.170500555,-0.936400444,0,1,0
4580,20,21,18,50,42,1,1765.141,30,1340.215,MORE,150,830,980,2,1,-8,-0.749926769,8,-0.174607574,-0.940356744,-0.796003243,92,50,42,1,-1.356261869,-1.170500555,-1.482634036,-0.468439217,0.171553077,0.171553077,-1.482634036,-1.170500555,0,0,1
4581,20,22,43,110,117,1,6596.93,60,1715.831,MORE,422,2742,3164,4,2,7,0.656185922,7,-0.349215148,0.120860898,0.839007065,227,110,117,0,1.336316841,1.170500555,1.443617351,0.83127653,0.424340421,0.424340421,1.443617351,1.170500555,0,1,1
4582,20,23,32,77,80,1,2827.474,70,1463.479,MORE,476,1078,1554,3,2,3,0.281222538,3,-1.047645444,0.474600112,-0.436524506,157,77,80,0,-0.059835082,-0.117050055,0,0.181418656,0.474526144,0.474526144,0,-0.117050055,1,1,1
4583,20,24,27,80,91,1,4541.507,80,2056.011,MORE,250,1780,2030,4,2,11,1.031149307,11,0.349215148,0.828339326,0.143480461,171,80,91,0,0.219395302,0,0.429183537,0.83127653,0.264489601,0.264489601,0.429183537,0,1,1,1
4584,20,25,16,44,50,1,1557.143,30,3662.062,MORE,-624,2042,1418,3,1,6,0.562445076,6,-0.523822722,-0.940356744,-0.866386878,94,44,50,0,-1.316371814,-1.404600665,-1.170500555,0.181418656,-0.547775613,0.547775613,-1.170500555,-1.404600665,0,1,0
4585,20,26,7,50,57,1,10289.994,70,4833.236,MORE,2006,3288,5294,7,2,7,0.656185922,7,-0.349215148,0.474600112,2.088688644,107,50,57,0,-1.057086457,-1.170500555,-0.897383758,2.780850149,1.896454951,1.896454951,-0.897383758,-1.170500555,1,1,1
4586,20,27,14,50,46,0,7554.636,40,2548.979,MORE,1430,2368,3798,3,1,-4,-0.374963384,4,-0.87303787,-0.58661753,1.163081477,96,50,46,1,-1.276481759,-1.170500555,-1.326567295,0.181418656,1.361140576,1.361140576,-1.326567295,-1.170500555,0,1,1
4587,20,28,51,110,108,0,8190.703,30,1964.043,MORE,26,3632,3658,3,1,-2,-0.187481692,2,-1.222253018,-0.940356744,1.378317718,218,110,108,1,1.156811594,1.170500555,1.092467184,0.181418656,0.056311788,0.056311788,1.092467184,1.170500555,0,0,0
4588,20,29,50,133,110,0,4776.086,50,1683.885,MORE,-762,2494,1732,4,1,-23,-2.15603946,23,2.444506035,-0.232878316,0.222858738,243,133,110,1,1.655437281,2.067884313,1.170500555,0.83127653,-0.676028016,0.676028016,1.170500555,2.067884313,0,1,0
4589,20,30,49,131,110,0,8277.179,50,2769.336,MORE,-1456,4236,2780,3,2,-21,-1.968557767,21,2.095290887,-0.232878316,1.407579996,241,131,110,1,1.615547226,1.989850943,1.170500555,0.181418656,-1.321007488,1.321007488,1.170500555,1.989850943,0,1,0
4590,20,31,47,126,110,0,10069.583,50,1732.088,MORE,-584,4880,4296,5,1,-16,-1.499853537,16,1.222253018,-0.232878316,2.014104622,236,126,110,1,1.515822089,1.794767517,1.170500555,1.481134403,-0.510601004,0.510601004,1.170500555,1.794767517,0,1,0
4591,20,32,50,110,133,1,9180.159,10,2094.529,MORE,-558,4978,4420,2,1,23,2.15603946,23,2.444506035,-1.647835171,1.71313589,243,110,133,0,1.655437281,1.170500555,2.067884313,-0.468439217,-0.486437508,0.486437508,2.067884313,1.170500555,0,0,0
4592,20,33,47,110,126,1,11577.07,20,1337.638,MORE,-1950,5392,3442,4,1,16,1.499853537,16,1.222253018,-1.294095958,2.524217291,236,110,126,0,1.515822089,1.170500555,1.794767517,0.83127653,-1.780113913,1.780113913,1.794767517,1.170500555,0,1,0
4593,20,34,12,48,50,1,9246.755,80,1033.869,MORE,2716,2622,5338,4,2,2,0.187481692,2,-1.222253018,0.828339326,1.735671052,98,48,50,0,-1.236591704,-1.248533925,-1.170500555,0.83127653,2.556304267,2.556304267,-1.170500555,-1.248533925,1,1,1
4594,20,35,32,80,77,0,6187.412,40,1964.946,MORE,-2346,3980,1634,4,2,-3,-0.281222538,3,-1.047645444,-0.58661753,0.70043186,157,80,77,1,-0.059835082,0,-0.117050055,0.83127653,-2.148142546,2.148142546,-0.117050055,0,0,1,0
4595,20,36,43,117,110,0,9929.634,40,1371.287,MORE,-638,4232,3594,5,1,-7,-0.656185922,7,-0.349215148,-0.58661753,1.966747823,227,117,110,1,1.336316841,1.443617351,1.170500555,1.481134403,-0.560786727,0.560786727,1.170500555,1.443617351,0,1,0
4596,20,37,40,80,64,0,15696.76,10,3382.839,MORE,-3546,8360,4814,9,1,-16,-1.499853537,16,1.222253018,-1.647835171,3.918263185,144,80,64,1,-0.31912044,0,-0.624266962,4.080565896,-3.263380826,3.263380826,-0.624266962,0,0,1,0
4597,20,38,31,80,78,0,17802.511,20,2553.127,MORE,1178,6650,7828,6,1,-2,-0.187481692,2,-1.222253018,-1.294095958,4.630820085,158,80,78,1,-0.039890055,0,-0.07803337,2.130992276,1.126940538,1.126940538,-0.07803337,0,0,1,1
4598,20,39,46,124,110,0,8895.783,30,2144.357,MORE,-1274,4384,3110,5,1,-14,-1.312371845,14,0.87303787,-0.940356744,1.616907,234,124,110,1,1.475932034,1.716734147,1.170500555,1.481134403,-1.151863015,1.151863015,1.170500555,1.716734147,0,1,0
4599,20,40,58,92,110,1,5490.979,50,764.404,MORE,122,2122,2244,2,2,18,1.687335229,18,1.571468165,-0.232878316,0.464768603,202,92,110,0,0.837691154,0.468200222,1.170500555,-0.468439217,0.145530851,0.145530851,1.170500555,0.468200222,0,0,0
4600,20,41,49,110,131,0,4015.55,80,3086.612,LESS,-242,2054,1812,4,2,21,1.968557767,21,2.095290887,0.828339326,-0.034496084,241,110,131,1,1.615547226,1.170500555,1.989850943,0.83127653,-0.192758094,0.192758094,1.989850943,1.170500555,1,1,0
4601,20,42,13,47,50,0,7637.121,50,2349.714,LESS,-306,3428,3122,2,1,3,0.281222538,3,-1.047645444,-0.232878316,1.190993256,97,47,50,1,-1.256536731,-1.28755061,-1.170500555,-0.468439217,-0.252237469,0.252237469,-1.170500555,-1.28755061,0,0,0
4602,20,43,16,50,44,1,16415.783,60,2237.342,LESS,-1144,7294,6150,6,2,-6,-0.562445076,6,-0.523822722,0.120860898,4.161570584,94,50,44,0,-1.316371814,-1.170500555,-1.404600665,2.130992276,-1.031045535,1.031045535,-1.404600665,-1.170500555,1,1,0
4603,20,44,7,57,50,0,10304.574,40,1791.068,LESS,-588,4556,3968,6,1,-7,-0.656185922,7,-0.349215148,-0.58661753,2.093622313,107,57,50,0,-1.057086457,-0.897383758,-1.170500555,2.130992276,-0.514318465,0.514318465,-1.170500555,-0.897383758,0,1,0
4604,20,45,18,42,50,0,2612.929,70,993.105,LESS,-690,1306,616,1,1,8,0.749926769,8,-0.174607574,0.474600112,-0.509123555,92,42,50,1,-1.356261869,-1.482634036,-1.170500555,-1.11829709,-0.609113719,0.609113719,-1.170500555,-1.482634036,1,0,0
4605,20,46,51,108,110,1,15358.073,50,1343.045,LESS,-1524,7136,5612,4,1,2,0.187481692,2,-1.222253018,-0.232878316,3.803656207,218,108,110,1,1.156811594,1.092467184,1.170500555,0.83127653,-1.384204324,1.384204324,1.170500555,1.092467184,0,1,0
4606,20,47,31,78,80,0,2269.503,80,2945.513,LESS,-670,1552,882,2,2,2,0.187481692,2,-1.222253018,0.828339326,-0.625334145,158,78,80,1,-0.039890055,-0.07803337,0,-0.468439217,-0.590526414,0.590526414,0,-0.07803337,1,0,0
4607,20,48,58,110,92,1,9017.939,30,1028.366,LESS,670,3054,3724,5,2,-18,-1.687335229,18,1.571468165,-0.940356744,1.658242894,202,110,92,0,0.837691154,1.170500555,0.468200222,1.481134403,0.654822999,0.654822999,0.468200222,1.170500555,0,1,1
4608,20,49,12,50,48,0,8244.176,70,2528.173,LESS,-1664,4446,2782,6,1,-2,-0.187481692,2,-1.222253018,0.474600112,1.396412239,98,50,48,0,-1.236591704,-1.170500555,-1.248533925,2.130992276,-1.514315456,1.514315456,-1.248533925,-1.170500555,1,1,0
4609,20,50,54,110,101,1,3843.263,20,1800.498,LESS,-240,2288,2048,2,1,-9,-0.843667615,9,0,-1.294095958,-0.092795613,211,110,101,0,1.017196402,1.170500555,0.819350388,-0.468439217,-0.190899364,0.190899364,0.819350388,1.170500555,0,0,0
4610,20,51,14,46,50,0,1992.862,60,1603.083,LESS,-360,1188,828,2,2,4,0.374963384,4,-0.87303787,0.120860898,-0.718945618,96,46,50,1,-1.276481759,-1.326567295,-1.170500555,-0.468439217,-0.302423192,0.302423192,-1.170500555,-1.326567295,0,0,0
4611,20,52,22,80,83,0,2174.961,70,2432.388,LESS,-916,1514,598,1,1,3,0.281222538,3,-1.047645444,0.474600112,-0.657325845,163,80,83,1,0.059835082,0,0.117050055,-1.11829709,-0.819150262,0.819150262,0.117050055,0,1,0,0
4612,20,53,6,50,56,0,1999.148,60,1114.723,LESS,-696,1280,584,2,2,6,0.562445076,6,-0.523822722,0.120860898,-0.716818523,106,50,56,1,-1.077031484,-1.170500555,-0.936400444,-0.468439217,-0.61468991,0.61468991,-0.936400444,-1.170500555,0,0,0
4613,20,54,13,50,47,1,5489.294,20,1705.188,LESS,174,2752,2926,5,1,-3,-0.281222538,3,-1.047645444,-1.294095958,0.464198422,97,50,47,0,-1.256536731,-1.170500555,-1.28755061,1.481134403,0.193857843,0.193857843,-1.28755061,-1.170500555,0,1,1
4614,20,55,46,110,124,0,2903.708,70,1582.537,LESS,-922,1820,898,1,2,14,1.312371845,14,0.87303787,0.474600112,-0.410727979,234,110,124,1,1.475932034,1.170500555,1.716734147,-1.11829709,-0.824726453,0.824726453,1.716734147,1.170500555,1,0,0
4615,20,56,27,91,80,0,2567.135,70,1972.465,LESS,-944,1584,640,2,1,-11,-1.031149307,11,0.349215148,0.474600112,-0.524619609,171,91,80,0,0.219395302,0.429183537,0,-0.468439217,-0.845172488,0.845172488,0,0.429183537,1,0,0
4616,20,57,40,64,80,0,1695.776,80,2021.296,LESS,206,1152,1358,2,2,16,1.499853537,16,1.222253018,0.828339326,-0.819475396,144,64,80,1,-0.31912044,-0.624266962,0,-0.468439217,0.223597531,0.223597531,0,-0.624266962,1,0,1
4617,20,58,22,83,80,0,1742.103,80,1642.175,LESS,-98,1196,1098,2,2,-3,-0.281222538,3,-1.047645444,0.828339326,-0.803798982,163,83,80,0,0.059835082,0.117050055,0,-0.468439217,-0.058929501,0.058929501,0,0.117050055,1,0,0
4618,20,59,54,101,110,0,4612.399,70,1784.596,LESS,-894,2374,1480,4,2,9,0.843667615,9,0,0.474600112,0.16746933,211,101,110,1,1.017196402,0.819350388,1.170500555,0.83127653,-0.798704227,0.798704227,1.170500555,0.819350388,1,1,0
4619,20,60,6,56,50,0,13327.15,30,2476.546,LESS,384,5820,6204,7,1,-6,-0.562445076,6,-0.523822722,-0.940356744,3.116420063,106,56,50,0,-1.077031484,-0.936400444,-1.170500555,2.780850149,0.389024542,0.389024542,-1.170500555,-0.936400444,0,1,1
4620,20,61,18,50,42,0,2056.19,80,1534.688,LESS,-694,1598,904,2,2,-8,-0.749926769,8,-0.174607574,0.828339326,-0.697516303,92,50,42,0,-1.356261869,-1.170500555,-1.482634036,-0.468439217,-0.61283118,0.61283118,-1.482634036,-1.170500555,1,0,0
4621,20,62,43,110,117,0,2489.747,10,574.473,LESS,-810,1294,484,2,1,7,0.656185922,7,-0.349215148,-1.647835171,-0.550806634,227,110,117,1,1.336316841,1.170500555,1.443617351,-0.468439217,-0.720637547,0.720637547,1.443617351,1.170500555,0,0,0
4622,20,63,32,77,80,0,1697.034,80,1275.376,LESS,334,802,1136,2,2,3,0.281222538,3,-1.047645444,0.828339326,-0.819049706,157,77,80,1,-0.059835082,-0.117050055,0,-0.468439217,0.34255628,0.34255628,0,-0.117050055,1,0,1
4623,20,64,27,80,91,0,1307.224,80,917.791,LESS,-42,814,772,2,2,11,1.031149307,11,0.349215148,0.828339326,-0.950955997,171,80,91,1,0.219395302,0,0.429183537,-0.468439217,-0.006885047,0.006885047,0.429183537,0,1,0,1
4624,20,65,16,44,50,0,4163.257,40,2228.265,LESS,486,1256,1742,3,1,6,0.562445076,6,-0.523822722,-0.58661753,0.015485913,94,44,50,1,-1.316371814,-1.404600665,-1.170500555,0.181418656,0.483819796,0.483819796,-1.170500555,-1.404600665,0,1,1
4625,20,66,7,50,57,0,1602.711,90,1331.385,LESS,250,738,988,2,2,7,0.656185922,7,-0.349215148,1.18207854,-0.8509673,107,50,57,1,-1.057086457,-1.170500555,-0.897383758,-0.468439217,0.264489601,0.264489601,-0.897383758,-1.170500555,1,1,1
4626,20,67,14,50,46,0,2004.477,50,1835.966,LESS,-748,1220,472,1,1,-4,-0.374963384,4,-0.87303787,-0.232878316,-0.715015264,96,50,46,0,-1.276481759,-1.170500555,-1.326567295,-1.11829709,-0.663016902,0.663016902,-1.326567295,-1.170500555,0,0,0
4627,20,68,51,110,108,0,6172.716,40,1812.761,LESS,-2710,3686,976,4,1,-2,-0.187481692,2,-1.222253018,-0.58661753,0.695458937,218,110,108,0,1.156811594,1.170500555,1.092467184,0.83127653,-2.486431491,2.486431491,1.092467184,1.170500555,0,1,0
4628,20,69,50,133,110,1,3332.7,50,2765.128,LESS,868,984,1852,2,2,-23,-2.15603946,23,2.444506035,-0.232878316,-0.265563043,243,133,110,0,1.655437281,2.067884313,1.170500555,-0.468439217,0.838837315,0.838837315,1.170500555,2.067884313,0,1,1
4629,20,70,49,131,110,1,3759.427,50,1767.484,LESS,322,1448,1770,4,1,-21,-1.968557767,21,2.095290887,-0.232878316,-0.121164551,241,131,110,0,1.615547226,1.989850943,1.170500555,0.83127653,0.331403898,0.331403898,1.170500555,1.989850943,0,1,1
4630,20,71,47,126,110,1,8489.855,80,1052.804,LESS,-540,3914,3374,3,2,-16,-1.499853537,16,1.222253018,0.828339326,1.479546601,236,126,110,0,1.515822089,1.794767517,1.170500555,0.181418656,-0.469708934,0.469708934,1.170500555,1.794767517,1,1,0
4631,20,72,50,110,133,0,1852.57,60,1344.08,LESS,-676,1192,516,2,1,23,2.15603946,23,2.444506035,0.120860898,-0.766418483,243,110,133,1,1.655437281,1.170500555,2.067884313,-0.468439217,-0.596102606,0.596102606,2.067884313,1.170500555,1,1,0
4632,20,73,47,110,126,0,4752.365,20,1201.916,LESS,-724,2738,2014,6,1,16,1.499853537,16,1.222253018,-1.294095958,0.214831881,236,110,126,1,1.515822089,1.170500555,1.794767517,2.130992276,-0.640712137,0.640712137,1.794767517,1.170500555,0,1,0
4633,20,74,12,48,50,0,2084.81,80,2020.29,LESS,232,878,1110,2,2,2,0.187481692,2,-1.222253018,0.828339326,-0.687831692,98,48,50,1,-1.236591704,-1.248533925,-1.170500555,-0.468439217,0.247761027,0.247761027,-1.170500555,-1.248533925,1,1,1
4634,20,75,32,80,77,0,1728.627,90,1612.321,LESS,66,828,894,2,2,-3,-0.281222538,3,-1.047645444,1.18207854,-0.808359073,157,80,77,0,-0.059835082,0,-0.117050055,-0.468439217,0.093486398,0.093486398,-0.117050055,0,1,1,1
4635,20,76,43,117,110,1,3484.634,40,1543.772,LESS,902,1090,1992,2,2,-7,-0.656185922,7,-0.349215148,-0.58661753,-0.214150687,227,117,110,0,1.336316841,1.443617351,1.170500555,-0.468439217,0.870435733,0.870435733,1.170500555,1.443617351,0,0,1
4636,20,77,40,80,64,0,2587.182,70,1801.126,LESS,-604,1106,502,2,1,-16,-1.499853537,16,1.222253018,0.474600112,-0.517835983,144,80,64,0,-0.31912044,0,-0.624266962,-0.468439217,-0.529188309,0.529188309,-0.624266962,0,1,0,0
4637,20,78,31,80,78,0,1938.383,80,3506.527,LESS,-774,1484,710,3,2,-2,-0.187481692,2,-1.222253018,0.828339326,-0.737380556,158,80,78,0,-0.039890055,0,-0.07803337,0.181418656,-0.687180398,0.687180398,-0.07803337,0,1,1,0
4638,20,79,46,124,110,1,2779.519,10,2201.882,LESS,-720,2236,1516,3,1,-14,-1.312371845,14,0.87303787,-1.647835171,-0.452751812,234,124,110,0,1.475932034,1.716734147,1.170500555,0.181418656,-0.636994676,0.636994676,1.170500555,1.716734147,0,1,0
4639,20,80,58,92,110,0,2253.028,80,1708.894,LESS,50,1016,1066,2,2,18,1.687335229,18,1.571468165,0.828339326,-0.630909056,202,92,110,1,0.837691154,0.468200222,1.170500555,-0.468439217,0.078616554,0.078616554,1.170500555,0.468200222,1,0,1
4640,20,81,48,128,110,0,3294.411,60,2293.986,MORE,-102,1376,1274,4,1,-18,-1.687335229,18,1.571468165,0.120860898,-0.278519509,238,128,110,1,1.555712144,1.872800887,1.170500555,0.83127653,-0.062646961,0.062646961,1.170500555,1.872800887,0,1,0
4641,20,82,8,50,58,1,2209.852,90,1644.301,MORE,1294,820,2114,1,2,8,0.749926769,8,-0.174607574,1.18207854,-0.645519215,108,50,58,0,-1.037141429,-1.170500555,-0.858367073,-1.11829709,1.234746905,1.234746905,-0.858367073,-1.170500555,1,0,1
4642,20,83,4,54,50,0,3181.828,80,1615.647,MORE,726,1598,2324,4,2,-4,-0.374963384,4,-0.87303787,0.828339326,-0.316616033,104,54,50,1,-1.116921539,-1.014433814,-1.170500555,0.83127653,0.706867452,0.706867452,-1.170500555,-1.014433814,1,1,1
4643,20,84,37,80,69,0,5088.622,50,1677.809,MORE,-72,2446,2374,5,1,-11,-1.031149307,11,0.349215148,-0.232878316,0.328616581,149,80,69,1,-0.219395302,0,-0.429183537,1.481134403,-0.034766004,0.034766004,-0.429183537,0,0,1,0
4644,20,85,52,105,110,1,1506.849,80,2266.638,MORE,834,452,1286,1,2,5,0.46870423,5,-0.698430296,0.828339326,-0.883405669,215,105,110,0,1.096976512,0.975417129,1.170500555,-1.11829709,0.807238897,0.807238897,1.170500555,0.975417129,1,0,1
4645,20,86,5,55,50,1,1570.053,70,1025.037,MORE,376,376,752,1,2,-5,-0.46870423,5,-0.698430296,0.474600112,-0.862018313,105,55,50,1,-1.096976512,-0.975417129,-1.170500555,-1.11829709,0.38158962,0.38158962,-1.170500555,-0.975417129,1,0,1
4646,20,87,30,96,80,0,1812.311,90,1462.876,MORE,96,950,1046,2,2,-16,-1.499853537,16,1.222253018,1.18207854,-0.78004157,176,96,80,1,0.31912044,0.624266962,0,-0.468439217,0.121367355,0.121367355,0,0.624266962,1,0,0
4647,20,88,33,80,75,0,4295.981,60,2239.49,MORE,418,1300,1718,3,1,-5,-0.46870423,5,-0.698430296,0.120860898,0.060397872,155,80,75,1,-0.099725137,0,-0.195083426,0.181418656,0.42062296,0.42062296,-0.195083426,0,0,1,1
4648,20,89,48,110,128,1,2363.489,90,1679.751,MORE,804,860,1664,1,2,18,1.687335229,18,1.571468165,1.18207854,-0.593530588,238,110,128,0,1.555712144,1.170500555,1.872800887,-1.11829709,0.77935794,0.77935794,1.872800887,1.170500555,1,0,1
4649,20,90,9,59,50,0,2703.242,70,1139.148,MORE,-882,1626,744,2,1,-9,-0.843667615,9,0,0.474600112,-0.47856289,109,59,50,1,-1.017196402,-0.819350388,-1.170500555,-0.468439217,-0.787551844,0.787551844,-1.170500555,-0.819350388,1,0,0
4650,20,91,44,110,119,1,2496.354,70,2891.36,MORE,258,1164,1422,3,1,9,0.843667615,9,0,0.474600112,-0.548570917,229,110,119,0,1.376206896,1.170500555,1.521650721,0.181418656,0.271924523,0.271924523,1.521650721,1.170500555,1,1,1
4651,20,92,2,52,50,1,1525.454,70,2210.635,MORE,532,606,1138,2,1,-2,-0.187481692,2,-1.222253018,0.474600112,-0.877109996,102,52,50,1,-1.156811594,-1.092467184,-1.170500555,-0.468439217,0.526570597,0.526570597,-1.170500555,-1.092467184,1,0,1
4652,20,93,8,58,50,1,1282.81,70,1068.826,MORE,574,440,1014,1,2,-8,-0.749926769,8,-0.174607574,0.474600112,-0.959217356,108,58,50,1,-1.037141429,-0.858367073,-1.170500555,-1.11829709,0.565603936,0.565603936,-1.170500555,-0.858367073,1,0,1
4653,20,94,44,119,110,1,7640.016,80,885.395,MORE,1356,2570,3926,7,2,-9,-0.843667615,9,0,0.828339326,1.191972884,229,119,110,1,1.376206896,1.521650721,1.170500555,2.780850149,1.292367549,1.292367549,1.170500555,1.521650721,1,1,1
4654,20,95,34,74,80,1,1619.68,20,1279.638,MORE,354,416,770,1,2,6,0.562445076,6,-0.523822722,-1.294095958,-0.845225226,154,74,80,0,-0.119670165,-0.234100111,0,-1.11829709,0.361143585,0.361143585,0,-0.234100111,0,0,1
4655,20,96,24,86,80,1,3026.844,90,1736.184,MORE,920,1166,2086,3,2,-6,-0.562445076,6,-0.523822722,1.18207854,-0.369060467,166,86,80,1,0.119670165,0.234100111,0,0.181418656,0.887164307,0.887164307,0,0.234100111,1,1,1
4656,20,97,39,66,80,1,2465.649,50,1025.586,MORE,340,858,1198,3,2,14,1.312371845,14,0.87303787,-0.232878316,-0.558961062,146,66,80,0,-0.279230385,-0.546233592,0,0.181418656,0.348132472,0.348132472,0,-0.546233592,0,1,1
4657,20,98,9,50,59,1,1231.446,80,2299.405,MORE,376,630,1006,1,2,9,0.843667615,9,0,0.828339326,-0.97659822,109,50,59,0,-1.017196402,-1.170500555,-0.819350388,-1.11829709,0.38158962,0.38158962,-0.819350388,-1.170500555,1,0,1
4658,20,99,57,94,110,1,1580.251,90,1751.739,MORE,2108,240,2348,1,2,16,1.499853537,16,1.222253018,1.18207854,-0.858567452,204,94,110,0,0.877581209,0.546233592,1.170500555,-1.11829709,1.991250205,1.991250205,1.170500555,0.546233592,1,0,1
4659,20,100,60,110,87,0,3363.672,70,1755.78,MORE,142,1576,1718,1,1,-23,-2.15603946,23,2.444506035,0.474600112,-0.255082548,197,110,87,1,0.737966017,1.170500555,0.273116796,-1.11829709,0.164118156,0.164118156,0.273116796,1.170500555,1,0,0
4660,20,101,33,75,80,1,2525.554,90,2077.096,MORE,1706,428,2134,1,2,5,0.46870423,5,-0.698430296,1.18207854,-0.538690042,155,75,80,0,-0.099725137,-0.195083426,0,-1.11829709,1.617645381,1.617645381,0,-0.195083426,1,0,1
4661,20,102,15,50,45,0,4689.724,70,1785.424,MORE,-952,2622,1670,4,1,-5,-0.46870423,5,-0.698430296,0.474600112,0.193635036,95,50,45,1,-1.296426786,-1.170500555,-1.36558398,0.83127653,-0.85260741,0.85260741,-1.36558398,-1.170500555,1,1,0
4662,20,103,59,89,110,1,1496.447,90,1299.178,MORE,1254,396,1650,1,2,21,1.968557767,21,2.095290887,1.18207854,-0.886925562,199,89,110,0,0.777856072,0.351150166,1.170500555,-1.11829709,1.197572295,1.197572295,1.170500555,0.351150166,1,0,1
4663,20,104,29,80,94,1,3672.478,20,1653.217,MORE,908,1218,2126,3,1,14,1.312371845,14,0.87303787,-1.294095958,-0.150586886,174,80,94,0,0.279230385,0,0.546233592,0.181418656,0.876011925,0.876011925,0.546233592,0,0,1,1
4664,20,105,55,110,98,0,4749.541,40,2323.626,MORE,-586,2470,1884,4,1,-12,-1.124890153,12,0.523822722,-0.58661753,0.213876278,208,110,98,1,0.957361319,1.170500555,0.702300333,0.83127653,-0.512459735,0.512459735,0.702300333,1.170500555,0,1,0
4665,20,106,29,94,80,0,4006.099,60,2068.903,MORE,-732,2320,1588,4,1,-14,-1.312371845,14,0.87303787,0.120860898,-0.037694172,174,94,80,1,0.279230385,0.546233592,0,0.83127653,-0.648147059,0.648147059,0,0.546233592,0,1,0
4666,20,107,57,110,94,0,7331.998,50,1397.411,MORE,30,3058,3088,4,1,-16,-1.499853537,16,1.222253018,-0.232878316,1.08774387,204,110,94,1,0.877581209,1.170500555,0.546233592,0.83127653,0.060029249,0.060029249,0.546233592,1.170500555,0,1,0
4667,20,108,39,80,66,0,2698.953,80,1125.788,MORE,-154,1494,1340,2,2,-14,-1.312371845,14,0.87303787,0.828339326,-0.480014228,146,80,66,1,-0.279230385,0,-0.546233592,-0.468439217,-0.110973954,0.110973954,-0.546233592,0,1,0,0
4668,20,109,4,50,54,1,2591.545,80,2015.856,MORE,256,1212,1468,3,2,4,0.374963384,4,-0.87303787,0.828339326,-0.516359604,104,50,54,0,-1.116921539,-1.170500555,-1.014433814,0.181418656,0.270065792,0.270065792,-1.014433814,-1.170500555,1,1,1
4669,20,110,55,98,110,1,2714.388,100,2432.337,MORE,712,1244,1956,1,2,12,1.124890153,12,0.523822722,1.535817754,-0.474791238,208,98,110,0,0.957361319,0.702300333,1.170500555,-1.11829709,0.693856339,0.693856339,1.170500555,0.702300333,1,0,1
4670,20,111,2,50,52,1,1393.027,10,524.695,MORE,554,464,1018,1,2,2,0.187481692,2,-1.222253018,-1.647835171,-0.921921454,102,50,52,0,-1.156811594,-1.170500555,-1.092467184,-1.11829709,0.547016632,0.547016632,-1.092467184,-1.170500555,0,0,1
4671,20,112,59,110,89,0,2143.869,80,1730.603,MORE,-776,1396,620,2,1,-21,-1.968557767,21,2.095290887,0.828339326,-0.667846946,199,110,89,1,0.777856072,1.170500555,0.351150166,-0.468439217,-0.689039129,0.689039129,0.351150166,1.170500555,1,0,0
4672,20,113,60,87,110,1,1678.118,80,1862.228,MORE,1142,560,1702,1,2,23,2.15603946,23,2.444506035,0.828339326,-0.825450618,197,87,110,0,0.737966017,0.273116796,1.170500555,-1.11829709,1.093483389,1.093483389,1.170500555,0.273116796,1,0,1
4673,20,114,52,110,105,1,1719.466,80,2532.371,MORE,552,662,1214,1,1,-5,-0.46870423,5,-0.698430296,0.828339326,-0.811459029,215,110,105,1,1.096976512,1.170500555,0.975417129,-1.11829709,0.545157901,0.545157901,0.975417129,1.170500555,1,0,1
4674,20,115,30,80,96,1,2563.033,80,1340.479,MORE,700,996,1696,1,2,16,1.499853537,16,1.222253018,0.828339326,-0.526007669,176,80,96,0,0.31912044,0,0.624266962,-1.11829709,0.682703956,0.682703956,0.624266962,0,1,0,1
4675,20,116,24,80,86,1,3619.667,20,2001.123,MORE,702,992,1694,1,1,6,0.562445076,6,-0.523822722,-1.294095958,-0.168457395,166,80,86,0,0.119670165,0,0.234100111,-1.11829709,0.684562686,0.684562686,0.234100111,0,0,0,1
4676,20,117,5,50,55,1,1547.646,60,873.626,MORE,616,524,1140,1,2,5,0.46870423,5,-0.698430296,0.120860898,-0.869600531,105,50,55,0,-1.096976512,-1.170500555,-0.975417129,-1.11829709,0.604637276,0.604637276,-0.975417129,-1.170500555,0,0,1
4677,20,118,34,80,74,0,3393.361,70,2145.675,MORE,28,1442,1470,3,1,-6,-0.562445076,6,-0.523822722,0.474600112,-0.245036203,154,80,74,1,-0.119670165,0,-0.234100111,0.181418656,0.058170519,0.058170519,-0.234100111,0,1,1,0
4678,20,119,15,45,50,1,3168.93,30,1353.447,MORE,562,1100,1662,3,2,5,0.46870423,5,-0.698430296,-0.940356744,-0.320980537,95,45,50,0,-1.296426786,-1.36558398,-1.170500555,0.181418656,0.554451554,0.554451554,-1.170500555,-1.36558398,0,1,1
4679,20,120,37,69,80,0,3071.428,70,2063.387,MORE,-902,1792,890,2,1,11,1.031149307,11,0.349215148,0.474600112,-0.35397386,149,69,80,0,-0.219395302,-0.429183537,0,-0.468439217,-0.806139148,0.806139148,0,-0.429183537,1,0,0
4680,20,121,48,128,110,1,3124.094,80,5048.653,LESS,1646,950,2596,2,2,-18,-1.687335229,18,1.571468165,0.828339326,-0.336152417,238,128,110,0,1.555712144,1.872800887,1.170500555,-0.468439217,1.561883467,1.561883467,1.170500555,1.872800887,1,0,1
4681,20,122,8,50,58,0,1254.202,80,1846.708,LESS,458,646,1104,2,2,8,0.749926769,8,-0.174607574,0.828339326,-0.968897906,108,50,58,1,-1.037141429,-1.170500555,-0.858367073,-0.468439217,0.457797569,0.457797569,-0.858367073,-1.170500555,1,0,1
4682,20,123,4,54,50,1,3193.128,70,1978.408,LESS,934,944,1878,3,2,-4,-0.374963384,4,-0.87303787,0.474600112,-0.31279227,104,54,50,0,-1.116921539,-1.014433814,-1.170500555,0.181418656,0.900175421,0.900175421,-1.170500555,-1.014433814,1,1,1
4683,20,124,37,80,69,1,4459.433,90,1530.228,LESS,1956,1536,3492,3,2,-11,-1.031149307,11,0.349215148,1.18207854,0.115707759,149,80,69,0,-0.219395302,0,-0.429183537,0.181418656,1.849986689,1.849986689,-0.429183537,0,1,1,1
4684,20,125,52,105,110,1,4051.674,70,1461.986,LESS,244,1736,1980,3,2,5,0.46870423,5,-0.698430296,0.474600112,-0.022272224,215,105,110,1,1.096976512,0.975417129,1.170500555,0.181418656,0.258913409,0.258913409,1.170500555,0.975417129,1,1,1
4685,20,126,5,55,50,1,6400.453,60,1616.796,LESS,2716,1762,4478,3,2,-5,-0.46870423,5,-0.698430296,0.120860898,0.772521976,105,55,50,0,-1.096976512,-0.975417129,-1.170500555,0.181418656,2.556304267,2.556304267,-1.170500555,-0.975417129,1,1,1
4686,20,127,30,96,80,1,3182.051,100,2201.79,LESS,1930,982,2912,3,2,-16,-1.499853537,16,1.222253018,1.535817754,-0.316540573,176,96,80,0,0.31912044,0.624266962,0,0.181418656,1.825823193,1.825823193,0,0.624266962,1,1,1
4687,20,128,33,80,75,1,4598.638,80,2433.785,LESS,2864,1130,3994,3,2,-5,-0.46870423,5,-0.698430296,0.828339326,0.162812799,155,80,75,0,-0.099725137,0,-0.195083426,0.181418656,2.693850322,2.693850322,-0.195083426,0,1,1,1
4688,20,129,48,110,128,1,3294.045,0,1756.768,LESS,-1190,2532,1342,2,1,18,1.687335229,18,1.571468165,-2.001574385,-0.278643358,238,110,128,1,1.555712144,1.170500555,1.872800887,-0.468439217,-1.073796336,1.073796336,1.872800887,1.170500555,0,0,0
4689,20,130,9,59,50,1,6806.852,10,2101.245,LESS,18,3068,3086,4,1,-9,-0.843667615,9,0,-1.647835171,0.910041755,109,59,50,0,-1.017196402,-0.819350388,-1.170500555,0.83127653,0.048876867,0.048876867,-1.170500555,-0.819350388,0,1,1
4690,20,131,44,110,119,1,3292.094,20,1153.475,LESS,-58,1468,1410,3,1,9,0.843667615,9,0,-1.294095958,-0.27930355,229,110,119,1,1.376206896,1.170500555,1.521650721,0.181418656,-0.021754891,0.021754891,1.521650721,1.170500555,0,1,1
4691,20,132,2,52,50,1,6791.02,40,2117.633,LESS,-58,3102,3044,4,2,-2,-0.187481692,2,-1.222253018,-0.58661753,0.904684426,102,52,50,0,-1.156811594,-1.092467184,-1.170500555,0.83127653,-0.021754891,0.021754891,-1.170500555,-1.092467184,0,1,1
4692,20,133,8,58,50,1,3599.396,80,2351.798,LESS,528,1252,1780,3,2,-8,-0.749926769,8,-0.174607574,0.828339326,-0.17531682,108,58,50,0,-1.037141429,-0.858367073,-1.170500555,0.181418656,0.522853136,0.522853136,-1.170500555,-0.858367073,1,1,1
4693,20,134,44,119,110,1,3967.937,50,1763.42,LESS,490,1410,1900,2,2,-9,-0.843667615,9,0,-0.232878316,-0.050607663,229,119,110,0,1.376206896,1.521650721,1.170500555,-0.468439217,0.487537257,0.487537257,1.170500555,1.521650721,0,0,1
4694,20,135,34,74,80,0,2689.5,100,1422.183,LESS,-274,1766,1492,2,2,6,0.562445076,6,-0.523822722,1.535817754,-0.483212992,154,74,80,1,-0.119670165,-0.234100111,0,-0.468439217,-0.222497782,0.222497782,0,-0.234100111,1,0,0
4695,20,136,24,86,80,1,2853.552,20,1437.645,LESS,426,1188,1614,2,1,-6,-0.562445076,6,-0.523822722,-1.294095958,-0.427700073,166,86,80,0,0.119670165,0.234100111,0,-0.468439217,0.428057882,0.428057882,0,0.234100111,0,0,1
4696,20,137,39,66,80,0,3136.904,90,2832.524,LESS,-322,1908,1586,3,2,14,1.312371845,14,0.87303787,1.18207854,-0.331817691,146,66,80,1,-0.279230385,-0.546233592,0,0.181418656,-0.267107313,0.267107313,0,-0.546233592,1,1,0
4697,20,138,9,50,59,0,1642.807,70,2112.196,LESS,-344,1112,768,2,2,9,0.843667615,9,0,0.474600112,-0.83739937,109,50,59,1,-1.017196402,-1.170500555,-0.819350388,-0.468439217,-0.287553348,0.287553348,-0.819350388,-1.170500555,1,0,0
4698,20,139,57,94,110,0,2324.876,40,1138.663,LESS,-640,1534,894,3,2,16,1.499853537,16,1.222253018,-0.58661753,-0.606596691,204,94,110,1,0.877581209,0.546233592,1.170500555,0.181418656,-0.562645457,0.562645457,1.170500555,0.546233592,0,1,0
4699,20,140,60,110,87,1,3933.011,20,2096.633,LESS,-788,2186,1398,3,1,-23,-2.15603946,23,2.444506035,-1.294095958,-0.062426136,197,110,87,0,0.737966017,1.170500555,0.273116796,0.181418656,-0.700191512,0.700191512,0.273116796,1.170500555,0,1,0
4700,20,141,33,75,80,0,1878.314,70,2397.341,LESS,-588,1138,550,2,1,5,0.46870423,5,-0.698430296,0.474600112,-0.757707071,155,75,80,1,-0.099725137,-0.195083426,0,-0.468439217,-0.514318465,0.514318465,0,-0.195083426,1,0,0
4701,20,142,15,50,45,1,4850.387,60,2346.994,LESS,-140,2292,2152,5,1,-5,-0.46870423,5,-0.698430296,0.120860898,0.248001165,95,50,45,0,-1.296426786,-1.170500555,-1.36558398,1.481134403,-0.09796284,0.09796284,-1.36558398,-1.170500555,0,1,0
4702,20,143,59,89,110,0,2801.713,80,2863.731,LESS,-906,1898,992,1,1,21,1.968557767,21,2.095290887,0.828339326,-0.445241671,199,89,110,1,0.777856072,0.351150166,1.170500555,-1.11829709,-0.809856609,0.809856609,1.170500555,0.351150166,1,0,0
4703,20,144,29,80,94,0,3720.082,60,2004.703,LESS,-926,2360,1434,2,2,14,1.312371845,14,0.87303787,0.120860898,-0.134478353,174,80,94,1,0.279230385,0,0.546233592,-0.468439217,-0.828443914,0.828443914,0.546233592,0,0,0,0
4704,20,145,55,110,98,1,4276.25,30,1867.07,LESS,1320,1224,2544,2,2,-12,-1.124890153,12,0.523822722,-0.940356744,0.053721176,208,110,98,0,0.957361319,1.170500555,0.702300333,-0.468439217,1.258910401,1.258910401,0.702300333,1.170500555,0,0,1
4705,20,146,29,94,80,1,3891.52,60,1742.48,LESS,1522,1142,2664,2,2,-14,-1.312371845,14,0.87303787,0.120860898,-0.076466114,174,94,80,0,0.279230385,0.546233592,0,-0.468439217,1.446642178,1.446642178,0,0.546233592,0,0,1
4706,20,147,57,110,94,1,4596.197,90,2029.35,LESS,1714,1894,3608,3,2,-16,-1.499853537,16,1.222253018,1.18207854,0.161986798,204,110,94,0,0.877581209,1.170500555,0.546233592,0.181418656,1.625080303,1.625080303,0.546233592,1.170500555,1,1,1
4707,20,148,39,80,66,1,3366.531,80,1437.248,LESS,680,1404,2084,3,2,-14,-1.312371845,14,0.87303787,0.828339326,-0.254115102,146,80,66,0,-0.279230385,0,-0.546233592,0.181418656,0.664116651,0.664116651,-0.546233592,0,1,1,1
4708,20,149,4,50,54,0,2127.998,70,2620.436,LESS,-46,982,936,2,1,4,0.374963384,4,-0.87303787,0.474600112,-0.673217472,104,50,54,1,-1.116921539,-1.170500555,-1.014433814,-0.468439217,-0.010602508,0.010602508,-1.014433814,-1.170500555,1,0,1
4709,20,150,55,98,110,0,5089.17,0,2912.297,LESS,-1662,3466,1804,3,1,12,1.124890153,12,0.523822722,-2.001574385,0.328802016,208,98,110,1,0.957361319,0.702300333,1.170500555,0.181418656,-1.512456726,1.512456726,1.170500555,0.702300333,0,1,0
4710,20,151,2,50,52,0,4300.453,90,3532.88,LESS,-154,2390,2236,1,2,2,0.187481692,2,-1.222253018,1.18207854,0.061911135,102,50,52,1,-1.156811594,-1.170500555,-1.092467184,-1.11829709,-0.110973954,0.110973954,-1.092467184,-1.170500555,1,0,0
4711,20,152,59,110,89,1,4097.556,80,1976.637,LESS,1936,1178,3114,1,2,-21,-1.968557767,21,2.095290887,0.828339326,-0.006746393,199,110,89,0,0.777856072,1.170500555,0.351150166,-1.11829709,1.831399385,1.831399385,0.351150166,1.170500555,1,0,1
4712,20,153,60,87,110,0,4457.96,90,2348.632,LESS,1364,1800,3164,4,2,23,2.15603946,23,2.444506035,1.18207854,0.115209317,197,87,110,1,0.737966017,0.273116796,1.170500555,0.83127653,1.299802471,1.299802471,1.170500555,0.273116796,1,1,1
4713,20,154,52,110,105,1,8144.823,10,2527.076,LESS,356,3586,3942,5,1,-5,-0.46870423,5,-0.698430296,-1.647835171,1.362792563,215,110,105,0,1.096976512,1.170500555,0.975417129,1.481134403,0.363002316,0.363002316,0.975417129,1.170500555,0,1,1
4714,20,155,30,80,96,0,1909.219,70,2080.798,LESS,-62,1102,1040,2,1,16,1.499853537,16,1.222253018,0.474600112,-0.747249248,176,80,96,1,0.31912044,0,0.624266962,-0.468439217,-0.025472352,0.025472352,0.624266962,0,1,0,1
4715,20,156,24,80,86,0,4475.399,10,1887.047,LESS,-1184,3024,1840,4,1,6,0.562445076,6,-0.523822722,-1.647835171,0.121110432,166,80,86,1,0.119670165,0,0.234100111,0.83127653,-1.068220144,1.068220144,0.234100111,0,0,1,0
4716,20,157,5,50,55,0,1875.828,0,3479.897,LESS,-2056,2912,856,2,1,5,0.46870423,5,-0.698430296,-2.001574385,-0.758548299,105,50,55,1,-1.096976512,-1.170500555,-0.975417129,-0.468439217,-1.878626628,1.878626628,-0.975417129,-1.170500555,0,1,0
4717,20,158,34,80,74,1,3845.49,30,1695.835,LESS,1224,1004,2228,3,2,-6,-0.562445076,6,-0.523822722,-0.940356744,-0.092042027,154,80,74,0,-0.119670165,0,-0.234100111,0.181418656,1.169691338,1.169691338,-0.234100111,0,0,1,1
4718,20,159,15,45,50,1,6433.939,10,2233.093,LESS,-1150,3732,2582,3,1,5,0.46870423,5,-0.698430296,-1.647835171,0.783853174,95,45,50,1,-1.296426786,-1.36558398,-1.170500555,0.181418656,-1.036621726,1.036621726,-1.170500555,-1.36558398,0,1,0
4719,20,160,37,69,80,0,3046.212,30,1705.859,LESS,-1014,1870,856,2,1,11,1.031149307,11,0.349215148,-0.940356744,-0.362506604,149,69,80,1,-0.219395302,-0.429183537,0,-0.468439217,-0.910228055,0.910228055,0,-0.429183537,0,0,0
4720,20,161,3,50,53,0,2580.315,50,2034.98,MORE,-1046,2008,962,4,1,3,0.281222538,3,-1.047645444,-0.232878316,-0.52015968,103,50,53,0,-1.136866566,-1.170500555,-1.053450499,0.83127653,-0.939967742,0.939967742,-1.053450499,-1.170500555,0,1,0
4721,20,162,20,50,40,0,2722.576,80,1303.493,MORE,712,1108,1820,2,2,-10,-0.937408461,10,0.174607574,0.828339326,-0.472020533,90,50,40,1,-1.396151924,-1.170500555,-1.560667406,-0.468439217,0.693856339,0.693856339,-1.560667406,-1.170500555,1,0,1
4722,20,163,25,80,88,1,2938.429,100,1416.189,MORE,814,1404,2218,2,2,8,0.749926769,8,-0.174607574,1.535817754,-0.398978875,168,80,88,0,0.15956022,0,0.312133481,-0.468439217,0.788651593,0.788651593,0.312133481,0,1,0,1
4723,20,164,42,115,110,1,3295.707,10,1834.338,MORE,-816,2206,1390,3,1,-5,-0.46870423,5,-0.698430296,-1.647835171,-0.278080961,225,115,110,1,1.296426786,1.36558398,1.170500555,0.181418656,-0.726213738,0.726213738,1.170500555,1.36558398,0,1,0
4724,20,165,53,103,110,1,3683.539,20,3104.281,MORE,-1006,2928,1922,3,1,7,0.656185922,7,-0.349215148,-1.294095958,-0.146843997,213,103,110,0,1.057086457,0.897383758,1.170500555,0.181418656,-0.902793133,0.902793133,1.170500555,0.897383758,0,1,0
4725,20,166,26,90,80,0,8249.112,40,2135.872,MORE,-960,3558,2598,4,1,-10,-0.937408461,10,0.174607574,-0.58661753,1.398082513,170,90,80,1,0.199450275,0.390166852,0,0.83127653,-0.860042332,0.860042332,0,0.390166852,0,1,0
4726,20,167,35,80,72,0,2994.583,80,1827.536,MORE,-92,1756,1664,2,2,-8,-0.749926769,8,-0.174607574,0.828339326,-0.379977141,152,80,72,1,-0.15956022,0,-0.312133481,-0.468439217,-0.053353309,0.053353309,-0.312133481,0,1,0,0
4727,20,168,28,93,80,0,6765.163,10,1890.713,MORE,-2698,4688,1990,5,1,-13,-1.218630999,13,0.698430296,-1.647835171,0.895934776,173,93,80,1,0.259285357,0.507216907,0,1.481134403,-2.475279108,2.475279108,0,0.507216907,0,1,0
4728,20,169,26,80,90,1,1664.428,80,1827.835,MORE,684,720,1404,0,2,10,0.937408461,10,0.174607574,0.828339326,-0.830083124,170,80,90,0,0.199450275,0,0.390166852,-1.768154963,0.667834112,0.667834112,0.390166852,0,1,0,1
4729,20,170,25,88,80,1,7255.334,80,3488.357,MORE,-580,3510,2930,3,2,-8,-0.749926769,8,-0.174607574,0.828339326,1.061801836,168,88,80,1,0.15956022,0.312133481,0,0.181418656,-0.506883543,0.506883543,0,0.312133481,1,1,0
4730,20,171,36,80,70,1,2815.348,20,1931.219,MORE,-880,2232,1352,3,1,-10,-0.937408461,10,0.174607574,-1.294095958,-0.440627776,150,80,70,1,-0.199450275,0,-0.390166852,0.181418656,-0.785693113,0.785693113,-0.390166852,0,0,1,0
4731,20,172,28,80,93,1,1796.995,90,3252.766,MORE,700,1078,1778,0,2,13,1.218630999,13,0.698430296,1.18207854,-0.785224292,173,80,93,0,0.259285357,0,0.507216907,-1.768154963,0.682703956,0.682703956,0.507216907,0,1,0,1
4732,20,173,21,82,80,0,6647.187,0,2373.003,MORE,-1232,3988,2756,5,1,-2,-0.187481692,2,-1.222253018,-2.001574385,0.856013336,162,82,80,1,0.039890055,0.07803337,0,1.481134403,-1.112829675,1.112829675,0,0.07803337,0,1,0
4733,20,174,19,50,41,0,3679.261,90,2657.994,MORE,-238,2120,1882,2,2,-9,-0.843667615,9,0,1.18207854,-0.148291613,91,50,41,1,-1.376206896,-1.170500555,-1.521650721,-0.468439217,-0.189040633,0.189040633,-1.521650721,-1.170500555,1,0,0
4734,20,175,56,96,110,1,3383.786,90,1759.675,MORE,1530,1206,2736,3,2,14,1.312371845,14,0.87303787,1.18207854,-0.24827625,206,96,110,0,0.917471264,0.624266962,1.170500555,0.181418656,1.4540771,1.4540771,1.170500555,0.624266962,1,1,1
4735,20,176,23,80,85,1,2207.859,90,3640.195,MORE,552,1280,1832,2,2,5,0.46870423,5,-0.698430296,1.18207854,-0.646193619,165,80,85,0,0.099725137,0,0.195083426,-0.468439217,0.545157901,0.545157901,0.195083426,0,1,0,1
4736,20,177,10,60,50,0,2432.117,90,2651.297,MORE,102,1530,1632,2,2,-10,-0.937408461,10,0.174607574,1.18207854,-0.570307825,110,60,50,1,-0.997251374,-0.780333703,-1.170500555,-0.468439217,0.126943546,0.126943546,-1.170500555,-0.780333703,1,0,0
4737,20,178,19,41,50,1,1801.239,90,2132.695,MORE,1390,552,1942,1,2,9,0.843667615,9,0,1.18207854,-0.783788181,91,41,50,0,-1.376206896,-1.521650721,-1.170500555,-1.11829709,1.323965967,1.323965967,-1.170500555,-1.521650721,1,0,1
4738,20,179,56,110,96,0,3039.056,100,3286.116,MORE,-326,1956,1630,2,2,-14,-1.312371845,14,0.87303787,1.535817754,-0.364928095,206,110,96,1,0.917471264,1.170500555,0.624266962,-0.468439217,-0.270824774,0.270824774,0.624266962,1.170500555,1,0,0
4739,20,180,35,72,80,1,1626.926,70,2054.821,MORE,382,554,936,1,2,8,0.749926769,8,-0.174607574,0.474600112,-0.84277328,152,72,80,0,-0.15956022,-0.312133481,0,-1.11829709,0.387165812,0.387165812,0,-0.312133481,1,0,1
4740,20,181,11,49,50,1,1264.083,20,2552.559,MORE,-54,918,864,2,1,1,0.093740846,1,-1.396860592,-1.294095958,-0.965554313,99,49,50,0,-1.216646676,-1.20951724,-1.170500555,-0.468439217,-0.01803743,0.01803743,-1.170500555,-1.20951724,0,0,0
4741,20,182,17,43,50,1,2635.446,90,2045.26,MORE,392,1490,1882,3,2,7,0.656185922,7,-0.349215148,1.18207854,-0.501504115,93,43,50,0,-1.336316841,-1.443617351,-1.170500555,0.181418656,0.396459464,0.396459464,-1.170500555,-1.443617351,1,0,1
4742,20,183,1,51,50,1,2029.802,20,2083.8,MORE,-70,1166,1096,2,1,-1,-0.093740846,1,-1.396860592,-1.294095958,-0.706445635,101,51,50,1,-1.176756621,-1.131483869,-1.170500555,-0.468439217,-0.032907274,0.032907274,-1.170500555,-1.131483869,0,0,0
4743,20,184,41,112,110,0,9669.532,0,2180.421,MORE,-402,4506,4104,7,1,-2,-0.187481692,2,-1.222253018,-2.001574385,1.878732918,222,112,110,1,1.236591704,1.248533925,1.170500555,2.780850149,-0.341456532,0.341456532,1.170500555,1.248533925,0,1,0
4744,20,185,20,40,50,1,3250.198,90,3161.325,MORE,2092,950,3042,3,2,10,0.937408461,10,0.174607574,1.18207854,-0.293480574,90,40,50,0,-1.396151924,-1.560667406,-1.170500555,0.181418656,1.976380361,1.976380361,-1.170500555,-1.560667406,1,1,1
4745,20,186,1,50,51,1,3584.592,60,1556.428,MORE,416,1482,1898,4,1,1,0.093740846,1,-1.396860592,0.120860898,-0.180326288,101,50,51,0,-1.176756621,-1.170500555,-1.131483869,0.83127653,0.41876423,0.41876423,-1.131483869,-1.170500555,0,1,1
4746,20,187,23,85,80,0,9227.558,80,2516.972,MORE,-1814,4632,2818,2,2,-5,-0.46870423,5,-0.698430296,0.828339326,1.729175053,165,85,80,1,0.099725137,0.195083426,0,-0.468439217,-1.653720241,1.653720241,0,0.195083426,1,0,0
4747,20,188,11,50,49,0,4733.854,70,2041.743,MORE,-158,2092,1934,4,2,-1,-0.093740846,1,-1.396860592,0.474600112,0.208568015,99,50,49,1,-1.216646676,-1.170500555,-1.20951724,0.83127653,-0.114691415,0.114691415,-1.20951724,-1.170500555,1,1,0
4748,20,189,17,50,43,0,4125.917,10,2760.643,MORE,-1276,2672,1396,2,1,-7,-0.656185922,7,-0.349215148,-1.647835171,0.002850576,93,50,43,1,-1.336316841,-1.170500555,-1.443617351,-0.468439217,-1.153721746,1.153721746,-1.443617351,-1.170500555,0,0,0
4749,20,190,21,80,82,1,3572.783,90,1525.313,MORE,804,1632,2436,4,2,2,0.187481692,2,-1.222253018,1.18207854,-0.184322289,162,80,82,0,0.039890055,0,0.07803337,0.83127653,0.77935794,0.77935794,0.07803337,0,1,1,1
4750,20,191,10,50,60,1,3036.824,90,1178.25,MORE,1106,1122,2228,3,2,10,0.937408461,10,0.174607574,1.18207854,-0.365683373,110,50,60,0,-0.997251374,-1.170500555,-0.780333703,0.181418656,1.060026241,1.060026241,-0.780333703,-1.170500555,1,1,1
4751,20,192,3,53,50,0,4321.795,50,2534.352,MORE,-1108,2616,1508,4,1,-3,-0.281222538,3,-1.047645444,-0.232878316,0.069132971,103,53,50,1,-1.136866566,-1.053450499,-1.170500555,0.83127653,-0.997588387,0.997588387,-1.170500555,-1.053450499,0,1,0
4752,20,193,45,122,110,0,6443.981,80,2308.899,MORE,454,2760,3214,5,2,-12,-1.124890153,12,0.523822722,0.828339326,0.787251247,232,122,110,1,1.436041979,1.638700776,1.170500555,1.481134403,0.454080108,0.454080108,1.170500555,1.638700776,1,1,1
4753,20,194,38,67,80,1,1617.978,90,1875.736,MORE,744,540,1284,1,2,13,1.218630999,13,0.698430296,1.18207854,-0.845801159,147,67,80,0,-0.259285357,-0.507216907,0,-1.11829709,0.723596026,0.723596026,0,-0.507216907,1,0,1
4754,20,195,38,80,67,1,1749.96,90,1544.087,MORE,812,682,1494,1,2,-13,-1.218630999,13,0.698430296,1.18207854,-0.801140282,147,80,67,1,-0.259285357,0,-0.507216907,-1.11829709,0.786792862,0.786792862,-0.507216907,0,1,0,1
4755,20,196,36,70,80,1,1634.681,100,982.437,MORE,1070,470,1540,1,2,10,0.937408461,10,0.174607574,1.535817754,-0.840149095,150,70,80,0,-0.199450275,-0.390166852,0,-1.11829709,1.026569092,1.026569092,0,-0.390166852,1,0,1
4756,20,197,45,110,122,1,1437.083,100,1474.329,MORE,878,572,1450,2,2,12,1.124890153,12,0.523822722,1.535817754,-0.907013515,232,110,122,0,1.436041979,1.170500555,1.638700776,-0.468439217,0.848130968,0.848130968,1.638700776,1.170500555,1,0,1
4757,20,198,42,110,115,0,3759.423,90,1653.869,MORE,-272,2334,2062,2,2,5,0.46870423,5,-0.698430296,1.18207854,-0.121165905,225,110,115,0,1.296426786,1.170500555,1.36558398,-0.468439217,-0.220639051,0.220639051,1.36558398,1.170500555,1,0,0
4758,20,199,41,110,112,1,3647.604,40,1836.884,MORE,-344,1774,1430,2,1,2,0.187481692,2,-1.222253018,-0.58661753,-0.159003902,222,110,112,0,1.236591704,1.170500555,1.248533925,-0.468439217,-0.287553348,0.287553348,1.248533925,1.170500555,0,0,0
4759,20,200,53,110,103,1,1670.559,50,1695.321,MORE,124,844,968,1,2,-7,-0.656185922,7,-0.349215148,-0.232878316,-0.828008478,213,110,103,1,1.057086457,1.170500555,0.897383758,-1.11829709,0.147389581,0.147389581,0.897383758,1.170500555,0,0,0
4760,20,201,3,50,53,1,3193.177,60,1281.594,LESS,1280,1002,2282,3,2,3,0.281222538,3,-1.047645444,0.120860898,-0.312775689,103,50,53,1,-1.136866566,-1.170500555,-1.053450499,0.181418656,1.221735791,1.221735791,-1.053450499,-1.170500555,1,1,1
4761,20,202,20,50,40,0,4568.54,20,2162.528,LESS,-1852,3262,1410,4,1,-10,-0.937408461,10,0.174607574,-1.294095958,0.152628053,90,50,40,0,-1.396151924,-1.170500555,-1.560667406,0.83127653,-1.68903612,1.68903612,-1.560667406,-1.170500555,0,1,0
4762,20,203,25,80,88,0,2149.355,30,1161.097,LESS,-1030,1654,624,2,1,8,0.749926769,8,-0.174607574,-0.940356744,-0.66599056,168,80,88,1,0.15956022,0,0.312133481,-0.468439217,-0.925097898,0.925097898,0.312133481,0,0,0,0
4763,20,204,42,115,110,1,3421.588,50,2071.937,LESS,-380,1982,1602,3,1,-5,-0.46870423,5,-0.698430296,-0.232878316,-0.235484578,225,115,110,0,1.296426786,1.36558398,1.170500555,0.181418656,-0.321010496,0.321010496,1.170500555,1.36558398,0,1,0
4764,20,205,53,103,110,0,1821.59,80,1808.178,LESS,-128,1370,1242,2,2,7,0.656185922,7,-0.349215148,0.828339326,-0.776901685,213,103,110,1,1.057086457,0.897383758,1.170500555,-0.468439217,-0.086810458,0.086810458,1.170500555,0.897383758,1,0,0
4765,20,206,26,90,80,0,1493.02,80,1645.035,LESS,728,906,1634,2,2,-10,-0.937408461,10,0.174607574,0.828339326,-0.888085211,170,90,80,0,0.199450275,0.390166852,0,-0.468439217,0.708726182,0.708726182,0,0.390166852,1,0,1
4766,20,207,35,80,72,1,1677.622,10,2641.259,LESS,-36,1078,1042,1,1,-8,-0.749926769,8,-0.174607574,-1.647835171,-0.825618457,152,80,72,0,-0.15956022,0,-0.312133481,-1.11829709,-0.001308856,0.001308856,-0.312133481,0,0,0,1
4767,20,208,28,93,80,0,2038.466,0,1439.497,LESS,-1498,2070,572,1,1,-13,-1.218630999,13,0.698430296,-2.001574385,-0.703513858,173,93,80,0,0.259285357,0.507216907,0,-1.11829709,-1.360040828,1.360040828,0,0.507216907,0,0,0
4768,20,209,26,80,90,0,1666.171,100,1538.583,LESS,324,1216,1540,2,2,10,0.937408461,10,0.174607574,1.535817754,-0.829493317,170,80,90,1,0.199450275,0,0.390166852,-0.468439217,0.333262628,0.333262628,0.390166852,0,1,0,1
4769,20,210,25,88,80,0,1792.346,60,2979.942,LESS,26,942,968,1,1,-8,-0.749926769,8,-0.174607574,0.120860898,-0.786797449,168,88,80,0,0.15956022,0.312133481,0,-1.11829709,0.056311788,0.056311788,0,0.312133481,0,0,1
4770,20,211,36,80,70,0,1698.057,80,2097.3,LESS,1242,644,1886,1,2,-10,-0.937408461,10,0.174607574,0.828339326,-0.818703537,150,80,70,0,-0.199450275,0,-0.390166852,-1.11829709,1.186419913,1.186419913,-0.390166852,0,1,0,1
4771,20,212,28,80,93,0,1938.372,80,2111.363,LESS,1046,592,1638,1,2,13,1.218630999,13,0.698430296,0.828339326,-0.737384278,173,80,93,1,0.259285357,0,0.507216907,-1.11829709,1.004264327,1.004264327,0.507216907,0,1,0,1
4772,20,213,21,82,80,0,1712.332,70,1874.46,LESS,310,630,940,1,2,-2,-0.187481692,2,-1.222253018,0.474600112,-0.813873075,162,82,80,0,0.039890055,0.07803337,0,-1.11829709,0.320251515,0.320251515,0,0.07803337,1,0,1
4773,20,214,19,50,41,1,1719.949,80,1247.527,LESS,1454,546,2000,1,2,-9,-0.843667615,9,0,0.828339326,-0.811295588,91,50,41,0,-1.376206896,-1.170500555,-1.521650721,-1.11829709,1.383445342,1.383445342,-1.521650721,-1.170500555,1,0,1
4774,20,215,56,96,110,0,2345.002,50,1883.404,LESS,-692,1434,742,2,1,14,1.312371845,14,0.87303787,-0.232878316,-0.599786332,206,96,110,1,0.917471264,0.624266962,1.170500555,-0.468439217,-0.610972449,0.610972449,1.170500555,0.624266962,0,0,0
4775,20,216,23,80,85,0,1547.602,70,1835.248,LESS,568,854,1422,2,2,5,0.46870423,5,-0.698430296,0.474600112,-0.86961542,165,80,85,1,0.099725137,0,0.195083426,-0.468439217,0.560027745,0.560027745,0.195083426,0,1,0,1
4776,20,217,10,60,50,0,5882.052,0,1738.537,LESS,-1626,3602,1976,5,1,-10,-0.937408461,10,0.174607574,-2.001574385,0.597102276,110,60,50,0,-0.997251374,-0.780333703,-1.170500555,1.481134403,-1.478999578,1.478999578,-1.170500555,-0.780333703,0,1,0
4777,20,218,19,41,50,0,1820.025,60,1935.532,LESS,344,684,1028,0,2,9,0.843667615,9,0,0.120860898,-0.777431259,91,41,50,1,-1.376206896,-1.521650721,-1.170500555,-1.768154963,0.351849933,0.351849933,-1.170500555,-1.521650721,0,0,1
4778,20,219,56,110,96,1,5016.392,80,1228.18,LESS,10,2286,2296,5,2,-14,-1.312371845,14,0.87303787,0.828339326,0.304174952,206,110,96,0,0.917471264,1.170500555,0.624266962,1.481134403,0.041441945,0.041441945,0.624266962,1.170500555,1,1,1
4779,20,220,35,72,80,0,1697.219,90,1296.029,LESS,92,1130,1222,2,2,8,0.749926769,8,-0.174607574,1.18207854,-0.818987105,152,72,80,1,-0.15956022,-0.312133481,0,-0.468439217,0.117649894,0.117649894,0,-0.312133481,1,0,1
4780,20,221,11,49,50,0,1449.739,60,1864.728,LESS,302,842,1144,3,2,1,0.093740846,1,-1.396860592,0.120860898,-0.9027309,99,49,50,1,-1.216646676,-1.20951724,-1.170500555,0.181418656,0.312816593,0.312816593,-1.170500555,-1.20951724,0,1,1
4781,20,222,17,43,50,0,1712.516,60,1932.671,LESS,904,456,1360,1,2,7,0.656185922,7,-0.349215148,0.120860898,-0.813810812,93,43,50,1,-1.336316841,-1.443617351,-1.170500555,-1.11829709,0.872294464,0.872294464,-1.170500555,-1.443617351,0,0,1
4782,20,223,1,51,50,1,7505.361,60,2363.386,LESS,-718,3398,2680,5,2,-1,-0.093740846,1,-1.396860592,0.120860898,1.146407502,101,51,50,0,-1.176756621,-1.131483869,-1.170500555,1.481134403,-0.635135945,0.635135945,-1.170500555,-1.131483869,1,1,0
4783,20,224,41,112,110,0,2245.645,20,2491.594,LESS,-926,1728,802,2,1,-2,-0.187481692,2,-1.222253018,-1.294095958,-0.633407361,222,112,110,0,1.236591704,1.248533925,1.170500555,-0.468439217,-0.828443914,0.828443914,1.170500555,1.248533925,0,1,0
4784,20,225,20,40,50,0,1769.582,10,1690.614,LESS,-1256,1890,634,2,1,10,0.937408461,10,0.174607574,-1.647835171,-0.79450047,90,40,50,1,-1.396151924,-1.560667406,-1.170500555,-0.468439217,-1.135134441,1.135134441,-1.170500555,-1.560667406,0,1,0
4785,20,226,1,50,51,0,5769.417,40,1547.676,LESS,776,2092,2868,6,1,1,0.093740846,1,-1.396860592,-0.58661753,0.558988156,101,50,51,1,-1.176756621,-1.170500555,-1.131483869,2.130992276,0.753335714,0.753335714,-1.131483869,-1.170500555,0,1,1
4786,20,227,23,85,80,1,4935.254,50,1462.348,LESS,250,1978,2228,4,2,-5,-0.46870423,5,-0.698430296,-0.232878316,0.276718979,165,85,80,0,0.099725137,0.195083426,0,0.83127653,0.264489601,0.264489601,0,0.195083426,0,1,1
4787,20,228,11,50,49,0,3703.142,80,1520.886,LESS,-286,1988,1702,1,2,-1,-0.093740846,1,-1.396860592,0.828339326,-0.140210614,99,50,49,0,-1.216646676,-1.170500555,-1.20951724,-1.11829709,-0.233650164,0.233650164,-1.20951724,-1.170500555,1,0,0
4788,20,229,17,50,43,1,3141.223,80,1356.08,LESS,1334,1120,2454,3,2,-7,-0.656185922,7,-0.349215148,0.828339326,-0.330356201,93,50,43,0,-1.336316841,-1.170500555,-1.443617351,0.181418656,1.271921514,1.271921514,-1.443617351,-1.170500555,1,1,1
4789,20,230,21,80,82,0,2066.702,30,2285.633,LESS,-624,1222,598,2,1,2,0.187481692,2,-1.222253018,-0.940356744,-0.693959188,162,80,82,1,0.039890055,0,0.07803337,-0.468439217,-0.547775613,0.547775613,0.07803337,0,0,0,0
4790,20,231,10,50,60,0,1497.401,30,1443.706,LESS,-34,530,496,1,2,10,0.937408461,10,0.174607574,-0.940356744,-0.886602741,110,50,60,1,-0.997251374,-1.170500555,-0.780333703,-1.11829709,0.000549874,0.000549874,-0.780333703,-1.170500555,0,0,1
4791,20,232,3,53,50,1,4243.157,10,1570.958,LESS,-860,2530,1670,3,1,-3,-0.281222538,3,-1.047645444,-1.647835171,0.042522964,103,53,50,0,-1.136866566,-1.053450499,-1.170500555,0.181418656,-0.767105809,0.767105809,-1.170500555,-1.053450499,0,1,0
4792,20,233,45,122,110,1,2831.132,60,3210.616,LESS,-146,1862,1716,4,1,-12,-1.124890153,12,0.523822722,0.120860898,-0.43528669,232,122,110,0,1.436041979,1.638700776,1.170500555,0.83127653,-0.103539032,0.103539032,1.170500555,1.638700776,1,1,0
4793,20,234,38,67,80,0,1711.913,80,3074.349,LESS,586,1076,1662,2,2,13,1.218630999,13,0.698430296,0.828339326,-0.814014859,147,67,80,1,-0.259285357,-0.507216907,0,-0.468439217,0.576756319,0.576756319,0,-0.507216907,1,0,1
4794,20,235,38,80,67,0,1567.025,30,2075.686,LESS,278,598,876,2,1,-13,-1.218630999,13,0.698430296,-0.940356744,-0.863042946,147,80,67,0,-0.259285357,0,-0.507216907,-0.468439217,0.290511827,0.290511827,-0.507216907,0,0,0,1
4795,20,236,36,70,80,1,3318.729,20,1670.304,LESS,-274,1762,1488,3,2,10,0.937408461,10,0.174607574,-1.294095958,-0.270290635,150,70,80,1,-0.199450275,-0.390166852,0,0.181418656,-0.222497782,0.222497782,0,-0.390166852,0,1,0
4796,20,237,45,110,122,0,2173.874,40,2010.016,LESS,-484,958,474,0,1,12,1.124890153,12,0.523822722,-0.58661753,-0.657693671,232,110,122,1,1.436041979,1.170500555,1.638700776,-1.768154963,-0.417664481,0.417664481,1.638700776,1.170500555,0,0,0
4797,20,238,42,110,115,1,3151.892,50,3934.451,LESS,-436,2056,1620,3,1,5,0.46870423,5,-0.698430296,-0.232878316,-0.32674596,225,110,115,1,1.296426786,1.170500555,1.36558398,0.181418656,-0.373054949,0.373054949,1.36558398,1.170500555,0,1,0
4798,20,239,41,110,112,0,1719.667,90,1806.462,LESS,402,818,1220,2,2,2,0.187481692,2,-1.222253018,1.18207854,-0.811391013,222,110,112,1,1.236591704,1.170500555,1.248533925,-0.468439217,0.405753116,0.405753116,1.248533925,1.170500555,1,0,1
4799,20,240,53,110,103,1,2800.157,20,1098.01,LESS,-716,1686,970,2,1,-7,-0.656185922,7,-0.349215148,-1.294095958,-0.4457682,213,110,103,0,1.057086457,1.170500555,0.897383758,-0.468439217,-0.633277215,0.633277215,0.897383758,1.170500555,0,0,0
4800,21,1,49,110,131,0,4788.804,14,1631.606,LESS,-1788,3168,1380,5,1,21,1.968557767,21,2.095290887,-1.400424439,0.650053964,241,110,131,1,1.615547226,1.170500555,1.989850943,0.382877485,-1.95360729,1.95360729,1.989850943,1.170500555,0,1,0
4801,21,2,13,47,50,0,3062.615,74,1181.769,LESS,-944,1942,998,4,2,3,0.281222538,3,-1.047645444,1.283380714,-0.378270422,97,47,50,1,-1.256536731,-1.28755061,-1.170500555,-0.136278427,-0.865446601,0.865446601,-1.170500555,-1.28755061,1,0,0
4802,21,3,16,50,44,1,2814.627,74,1260.574,LESS,1154,1168,2322,5,2,-6,-0.562445076,6,-0.523822722,1.283380714,-0.5260017,94,50,44,0,-1.316371814,-1.170500555,-1.404600665,0.382877485,1.839483644,1.839483644,-1.404600665,-1.170500555,1,1,1
4803,21,4,7,57,50,1,3524.661,44,2010.896,LESS,2,1250,1252,3,1,-7,-0.656185922,7,-0.349215148,-0.058521862,-0.103020626,107,57,50,0,-1.057086457,-0.897383758,-1.170500555,-0.655434338,0.354221661,0.354221661,-1.170500555,-0.897383758,1,0,1
4804,21,5,18,42,50,0,1745.811,34,1231.951,LESS,-958,1458,500,2,1,8,0.749926769,8,-0.174607574,-0.505822721,-1.162716195,92,42,50,1,-1.356261869,-1.482634036,-1.170500555,-1.174590249,-0.883496659,0.883496659,-1.170500555,-1.482634036,0,0,0
4805,21,6,51,108,110,1,5618.631,4,1769.939,LESS,-1134,3520,2386,8,1,2,0.187481692,2,-1.222253018,-1.847725297,1.144398059,218,108,110,1,1.156811594,1.092467184,1.170500555,1.940345219,-1.110411685,1.110411685,1.170500555,1.092467184,0,1,0
4806,21,7,31,78,80,0,3599.037,44,1639.708,LESS,-728,1850,1122,3,1,2,0.187481692,2,-1.222253018,-0.058521862,-0.058713395,158,78,80,1,-0.039890055,-0.07803337,0,-0.655434338,-0.586959979,0.586959979,0,-0.07803337,1,0,0
4807,21,8,58,110,92,1,3127.332,34,1262.297,LESS,-70,1634,1564,3,2,-18,-1.687335229,18,1.571468165,-0.505822721,-0.339717245,202,110,92,0,0.837691154,1.170500555,0.468200222,-0.655434338,0.261392787,0.261392787,0.468200222,1.170500555,0,0,1
4808,21,9,12,50,48,1,6084.625,14,1810.692,LESS,26,2730,2756,7,1,-2,-0.187481692,2,-1.222253018,-1.400424439,1.421999755,98,50,48,0,-1.236591704,-1.170500555,-1.248533925,1.421189307,0.385164619,0.385164619,-1.248533925,-1.170500555,0,1,1
4809,21,10,54,110,101,1,4577.884,4,3291.931,LESS,580,2200,2780,5,1,-9,-0.843667615,9,0,-1.847725297,0.524404815,211,110,101,0,1.017196402,1.170500555,0.819350388,0.382877485,1.099431232,1.099431232,0.819350388,1.170500555,0,1,1
4810,21,11,14,46,50,0,1707.37,74,1403.06,LESS,308,1124,1432,2,2,4,0.374963384,4,-0.87303787,1.283380714,-1.185616246,96,46,50,1,-1.276481759,-1.326567295,-1.170500555,-1.174590249,0.748744375,0.748744375,-1.170500555,-1.326567295,1,0,1
4811,21,12,22,80,83,1,4552.962,44,1457.919,LESS,716,1720,2436,7,2,3,0.281222538,3,-1.047645444,-0.058521862,0.509558294,163,80,83,1,0.059835082,0,0.117050055,1.421189307,1.274774661,1.274774661,0.117050055,0,1,1,1
4812,21,13,6,50,56,0,1743.274,44,1327.492,LESS,-650,1140,490,2,1,6,0.562445076,6,-0.523822722,-0.058521862,-1.164227535,106,50,56,1,-1.077031484,-1.170500555,-0.936400444,-1.174590249,-0.486395365,0.486395365,-0.936400444,-1.170500555,1,0,0
4813,21,14,13,50,47,0,3854.483,34,1177.385,LESS,-760,2156,1396,4,1,-3,-0.281222538,3,-1.047645444,-0.505822721,0.093460759,97,50,47,0,-1.256536731,-1.170500555,-1.28755061,-0.136278427,-0.628217256,0.628217256,-1.28755061,-1.170500555,0,0,0
4814,21,15,46,110,124,0,4319.938,4,2060.743,LESS,-882,2434,1552,6,1,14,1.312371845,14,0.87303787,-1.847725297,0.370741362,234,110,124,1,1.475932034,1.170500555,1.716734147,0.902033396,-0.785510626,0.785510626,1.716734147,1.170500555,0,1,0
4815,21,16,27,91,80,1,4980.693,4,1152.707,LESS,250,2462,2712,5,1,-11,-1.031149307,11,0.349215148,-1.847725297,0.764365976,171,91,80,0,0.219395302,0.429183537,0,0.382877485,0.67396556,0.67396556,0,0.429183537,0,1,1
4816,21,17,40,64,80,0,3518.896,74,1384.657,LESS,-262,1816,1554,4,2,16,1.499853537,16,1.222253018,1.283380714,-0.106454949,144,64,80,1,-0.31912044,-0.624266962,0,-0.136278427,0.013849123,0.013849123,0,-0.624266962,1,0,1
4817,21,18,22,83,80,0,2390.111,4,873.491,LESS,-1368,1956,588,2,1,-3,-0.281222538,3,-1.047645444,-1.847725297,-0.778894144,163,83,80,0,0.059835082,0.117050055,0,-1.174590249,-1.412105525,1.412105525,0,0.117050055,0,0,0
4818,21,19,54,101,110,0,1910.192,44,1095.119,LESS,-908,1314,406,2,1,9,0.843667615,9,0,-0.058521862,-1.064791233,211,101,110,1,1.017196402,0.819350388,1.170500555,-1.174590249,-0.819032164,0.819032164,1.170500555,0.819350388,1,0,0
4819,21,20,6,56,50,0,4397.571,54,1185.384,LESS,-630,2266,1636,6,1,-6,-0.562445076,6,-0.523822722,0.388778996,0.416988851,106,56,50,0,-1.077031484,-0.936400444,-1.170500555,0.902033396,-0.460609567,0.460609567,-1.170500555,-0.936400444,1,1,0
4820,21,21,18,50,42,1,2894.042,24,1799.432,LESS,492,1052,1544,3,2,-8,-0.749926769,8,-0.174607574,-0.95312358,-0.478692639,92,50,42,0,-1.356261869,-1.170500555,-1.482634036,-0.655434338,0.98597372,0.98597372,-1.482634036,-1.170500555,0,0,1
4821,21,22,43,110,117,0,7190.021,24,1357.509,LESS,-250,3008,2758,7,1,7,0.656185922,7,-0.349215148,-0.95312358,2.080505668,227,110,117,1,1.336316841,1.170500555,1.443617351,1.421189307,0.029320602,0.029320602,1.443617351,1.170500555,0,1,1
4822,21,23,32,77,80,1,3078.663,24,809.573,LESS,604,1094,1698,3,2,3,0.281222538,3,-1.047645444,-0.95312358,-0.368710316,157,77,80,1,-0.059835082,-0.117050055,0,-0.655434338,1.13037419,1.13037419,0,-0.117050055,0,0,1
4823,21,24,27,80,91,0,2594.918,74,1537.279,LESS,-708,1590,882,2,2,11,1.031149307,11,0.349215148,1.283380714,-0.656886628,171,80,91,1,0.219395302,0,0.429183537,-1.174590249,-0.56117418,0.56117418,0.429183537,0,1,0,0
4824,21,25,16,44,50,0,2040.314,74,1067.853,LESS,-256,1310,1054,2,2,6,0.562445076,6,-0.523822722,1.283380714,-0.987275025,94,44,50,1,-1.316371814,-1.404600665,-1.170500555,-1.174590249,0.021584862,0.021584862,-1.170500555,-1.404600665,1,0,1
4825,21,26,7,50,57,0,1951.661,94,1304.234,LESS,520,1206,1726,3,2,7,0.656185922,7,-0.349215148,2.177982431,-1.040087343,107,50,57,1,-1.057086457,-1.170500555,-0.897383758,-0.655434338,1.022073837,1.022073837,-0.897383758,-1.170500555,1,0,1
4826,21,27,14,50,46,1,4415.841,54,1620.662,LESS,-12,2142,2130,5,1,-4,-0.374963384,4,-0.87303787,0.388778996,0.427872645,96,50,46,0,-1.276481759,-1.170500555,-1.326567295,0.382877485,0.336171602,0.336171602,-1.326567295,-1.170500555,1,1,1
4827,21,28,51,110,108,0,6751.343,4,2868.791,LESS,-1560,4466,2906,4,1,-2,-0.187481692,2,-1.222253018,-1.847725297,1.819176645,218,110,108,0,1.156811594,1.170500555,1.092467184,-0.136278427,-1.659649189,1.659649189,1.092467184,1.170500555,0,0,0
4828,21,29,50,133,110,0,4986.175,14,1734.982,LESS,-518,2590,2072,4,1,-23,-2.15603946,23,2.444506035,-1.400424439,0.76763171,243,133,110,0,1.655437281,2.067884313,1.170500555,-0.136278427,-0.316209096,0.316209096,1.170500555,2.067884313,0,0,1
4829,21,30,49,131,110,1,4287.637,24,1752.411,LESS,180,1920,2100,3,2,-21,-1.968557767,21,2.095290887,-0.95312358,0.351499027,241,131,110,0,1.615547226,1.989850943,1.170500555,-0.655434338,0.583715266,0.583715266,1.170500555,1.989850943,0,0,1
4830,21,31,47,126,110,1,6453.49,14,1994.069,LESS,-942,3188,2246,6,1,-16,-1.499853537,16,1.222253018,-1.400424439,1.641739815,236,126,110,0,1.515822089,1.794767517,1.170500555,0.902033396,-0.862868021,0.862868021,1.170500555,1.794767517,0,1,0
4831,21,32,50,110,133,0,2378.002,74,2478.609,LESS,546,1248,1794,3,2,23,2.15603946,23,2.444506035,1.283380714,-0.786107711,243,110,133,1,1.655437281,1.170500555,2.067884313,-0.655434338,1.055595375,1.055595375,2.067884313,1.170500555,1,0,1
4832,21,33,47,110,126,0,2991.77,64,1422.496,LESS,-1210,2056,846,2,1,16,1.499853537,16,1.222253018,0.836079855,-0.420474167,236,110,126,1,1.515822089,1.170500555,1.794767517,-1.174590249,-1.208397718,1.208397718,1.794767517,1.170500555,1,0,0
4833,21,34,12,48,50,1,8537.773,4,917.98,LESS,454,3804,4258,8,1,2,0.187481692,2,-1.222253018,-1.847725297,2.883387766,98,48,50,1,-1.236591704,-1.248533925,-1.170500555,1.940345219,0.936980703,0.936980703,-1.170500555,-1.248533925,0,1,1
4834,21,35,32,80,77,0,2556.424,54,1228.523,LESS,-1678,2126,448,2,1,-3,-0.281222538,3,-1.047645444,0.388778996,-0.679818253,157,80,77,0,-0.059835082,0,-0.117050055,-1.174590249,-1.811785399,1.811785399,-0.117050055,0,1,0,0
4835,21,36,43,117,110,1,4994.751,24,1660.382,LESS,36,2206,2242,5,2,-7,-0.656185922,7,-0.349215148,-0.95312358,0.7727406,227,117,110,0,1.336316841,1.443617351,1.170500555,0.382877485,0.398057518,0.398057518,1.170500555,1.443617351,0,1,1
4836,21,37,40,80,64,1,5806.832,24,1881.394,LESS,116,2624,2740,7,2,-16,-1.499853537,16,1.222253018,-0.95312358,1.256513058,144,80,64,0,-0.31912044,0,-0.624266962,1.421189307,0.501200711,0.501200711,-0.624266962,0,0,1,1
4837,21,38,31,80,78,0,4867.023,34,3148.175,LESS,-868,2840,1972,7,2,-2,-0.187481692,2,-1.222253018,-0.505822721,0.696650545,158,80,78,0,-0.039890055,0,-0.07803337,1.421189307,-0.767460567,0.767460567,-0.07803337,0,1,1,0
4838,21,39,46,124,110,1,4425.743,24,1763.901,LESS,324,1886,2210,5,2,-14,-1.312371845,14,0.87303787,-0.95312358,0.43377146,234,124,110,0,1.475932034,1.716734147,1.170500555,0.382877485,0.769373014,0.769373014,1.170500555,1.716734147,0,1,1
4839,21,40,58,92,110,0,3045.637,70,1424.638,LESS,-120,1800,1680,4,2,18,1.687335229,18,1.571468165,1.10446037,-0.388384547,202,92,110,1,0.837691154,0.468200222,1.170500555,-0.136278427,0.196928291,0.196928291,1.170500555,0.468200222,1,0,1
4840,21,41,49,110,131,1,5262.202,74,2573.909,MORE,968,2264,3232,5,2,21,1.968557767,21,2.095290887,1.283380714,0.932066367,241,110,131,0,1.615547226,1.170500555,1.989850943,0.382877485,1.59967572,1.59967572,1.989850943,1.170500555,1,1,1
4841,21,42,13,47,50,1,3953.324,14,864.53,MORE,232,1834,2066,5,1,3,0.281222538,3,-1.047645444,-1.400424439,0.152342266,97,47,50,0,-1.256536731,-1.28755061,-1.170500555,0.382877485,0.650758341,0.650758341,-1.170500555,-1.28755061,0,1,1
4842,21,43,16,50,44,1,4835.736,20,1902.473,MORE,-940,3360,2420,6,1,-6,-0.562445076,6,-0.523822722,-1.132043923,0.67801227,94,50,44,1,-1.316371814,-1.170500555,-1.404600665,0.902033396,-0.860289441,0.860289441,-1.404600665,-1.170500555,0,1,0
4843,21,44,7,57,50,1,4328.684,44,1448.485,MORE,484,1862,2346,5,2,-7,-0.656185922,7,-0.349215148,-0.058521862,0.375951524,107,57,50,1,-1.057086457,-0.897383758,-1.170500555,0.382877485,0.9756594,0.9756594,-1.170500555,-0.897383758,0,1,1
4844,21,45,18,42,50,1,1911.698,74,1314.504,MORE,270,952,1222,2,2,8,0.749926769,8,-0.174607574,1.283380714,-1.06389408,92,42,50,0,-1.356261869,-1.482634036,-1.170500555,-1.174590249,0.699751358,0.699751358,-1.170500555,-1.482634036,1,0,1
4845,21,46,51,108,110,0,4664.565,54,871.492,MORE,-884,2406,1522,5,1,2,0.187481692,2,-1.222253018,0.388778996,0.576042373,218,108,110,0,1.156811594,1.092467184,1.170500555,0.382877485,-0.788089206,0.788089206,1.170500555,1.092467184,0,1,0
4846,21,47,31,78,80,1,2470.485,64,1349.949,MORE,1158,928,2086,3,2,2,0.187481692,2,-1.222253018,0.836079855,-0.731013788,158,78,80,0,-0.039890055,-0.07803337,0,-0.655434338,1.844640804,1.844640804,0,-0.07803337,1,0,1
4847,21,48,58,110,92,0,2263.966,74,980.358,MORE,-470,1366,896,2,2,-18,-1.687335229,18,1.571468165,1.283380714,-0.854041176,202,110,92,1,0.837691154,1.170500555,0.468200222,-1.174590249,-0.25432318,0.25432318,0.468200222,1.170500555,1,0,0
4848,21,49,12,50,48,0,3684.645,64,1488.479,MORE,-940,2230,1290,3,1,-2,-0.187481692,2,-1.222253018,0.836079855,-0.007715044,98,50,48,1,-1.236591704,-1.170500555,-1.248533925,-0.655434338,-0.860289441,0.860289441,-1.248533925,-1.170500555,1,0,0
4849,21,50,54,110,101,0,4214.283,44,1213.981,MORE,-708,2338,1630,4,1,-9,-0.843667615,9,0,-0.058521862,0.307800622,211,110,101,1,1.017196402,1.170500555,0.819350388,-0.136278427,-0.56117418,0.56117418,0.819350388,1.170500555,0,1,0
4850,21,51,14,46,50,1,4624.009,84,1253.301,MORE,1148,1786,2934,7,2,4,0.374963384,4,-0.87303787,1.730681573,0.551882375,96,46,50,0,-1.276481759,-1.326567295,-1.170500555,1.421189307,1.831747905,1.831747905,-1.170500555,-1.326567295,1,1,1
4851,21,52,22,80,83,1,3334.248,34,1812.776,MORE,-1234,2450,1216,3,2,3,0.281222538,3,-1.047645444,-0.505822721,-0.216453357,163,80,83,0,0.059835082,0,0.117050055,-0.655434338,-1.239340676,1.239340676,0.117050055,0,0,0,0
4852,21,53,6,50,56,1,1743.815,74,1656.027,MORE,316,754,1070,1,2,6,0.562445076,6,-0.523822722,1.283380714,-1.163905251,106,50,56,0,-1.077031484,-1.170500555,-0.936400444,-1.693746161,0.759058694,0.759058694,-0.936400444,-1.170500555,1,0,1
4853,21,54,13,50,47,1,4974.428,34,996.492,MORE,-670,2666,1996,6,1,-3,-0.281222538,3,-1.047645444,-0.505822721,0.760633794,97,50,47,1,-1.256536731,-1.170500555,-1.28755061,0.902033396,-0.512181163,0.512181163,-1.28755061,-1.170500555,0,1,0
4854,21,55,46,110,124,1,2620.409,44,1290.81,MORE,-130,1392,1262,4,1,14,1.312371845,14,0.87303787,-0.058521862,-0.641701143,234,110,124,0,1.475932034,1.170500555,1.716734147,-0.136278427,0.184035392,0.184035392,1.716734147,1.170500555,0,1,0
4855,21,56,27,91,80,0,3978.578,74,1134.076,MORE,-44,2190,2146,4,2,-11,-1.031149307,11,0.349215148,1.283380714,0.167386566,171,91,80,1,0.219395302,0.429183537,0,-0.136278427,0.294914324,0.294914324,0,0.429183537,1,1,1
4856,21,57,40,64,80,1,2625.949,74,893.382,MORE,596,1014,1610,3,2,16,1.499853537,16,1.222253018,1.283380714,-0.638400857,144,64,80,0,-0.31912044,-0.624266962,0,-0.655434338,1.120059871,1.120059871,0,-0.624266962,1,0,1
4857,21,58,22,83,80,1,3474.8,54,1573.573,MORE,-580,1944,1364,3,1,-3,-0.281222538,3,-1.047645444,0.388778996,-0.132723795,163,83,80,1,0.059835082,0.117050055,0,-0.655434338,-0.396145071,0.396145071,0,0.117050055,0,0,0
4858,21,59,54,101,110,0,5071.145,34,1697.185,MORE,-640,2754,2114,6,2,9,0.843667615,9,0,-0.505822721,0.818249993,211,101,110,0,1.017196402,0.819350388,1.170500555,0.902033396,-0.473502466,0.473502466,1.170500555,0.819350388,0,1,0
4859,21,60,6,56,50,1,1460.254,74,1007.067,MORE,374,544,918,1,2,-6,-0.562445076,6,-0.523822722,1.283380714,-1.332828057,106,56,50,1,-1.077031484,-0.936400444,-1.170500555,-1.693746161,0.83383751,0.83383751,-1.170500555,-0.936400444,1,0,1
4860,21,61,18,50,42,0,3064.178,44,1602.358,MORE,-470,1568,1098,4,1,-8,-0.749926769,8,-0.174607574,-0.058521862,-0.377339312,92,50,42,1,-1.356261869,-1.170500555,-1.482634036,-0.136278427,-0.25432318,0.25432318,-1.482634036,-1.170500555,0,1,0
4861,21,62,43,110,117,1,2287.493,54,1304.192,MORE,700,824,1524,3,2,7,0.656185922,7,-0.349215148,0.388778996,-0.840025684,227,110,117,0,1.336316841,1.170500555,1.443617351,-0.655434338,1.254146022,1.254146022,1.443617351,1.170500555,0,0,1
4862,21,63,32,77,80,1,7187.372,34,1230.559,MORE,-1234,3854,2620,7,2,3,0.281222538,3,-1.047645444,-0.505822721,2.078927607,157,77,80,0,-0.059835082,-0.117050055,0,1.421189307,-1.239340676,1.239340676,0,-0.117050055,0,1,0
4863,21,64,27,80,91,1,1755.19,44,1697.953,MORE,-528,1110,582,2,1,11,1.031149307,11,0.349215148,-0.058521862,-1.157128942,171,80,91,0,0.219395302,0,0.429183537,-1.174590249,-0.329101995,0.329101995,0.429183537,0,0,0,0
4864,21,65,16,44,50,1,1357.483,74,2274.615,MORE,354,490,844,1,2,6,0.562445076,6,-0.523822722,1.283380714,-1.394050743,94,44,50,0,-1.316371814,-1.404600665,-1.170500555,-1.693746161,0.808051711,0.808051711,-1.170500555,-1.404600665,1,0,1
4865,21,66,7,50,57,1,1727.756,54,971.972,MORE,176,666,842,1,2,7,0.656185922,7,-0.349215148,0.388778996,-1.173471909,107,50,57,0,-1.057086457,-1.170500555,-0.897383758,-1.693746161,0.578558106,0.578558106,-0.897383758,-1.170500555,1,0,1
4866,21,67,14,50,46,0,7173.995,54,962.294,MORE,-1820,4084,2264,6,1,-4,-0.374963384,4,-0.87303787,0.388778996,2.070958667,96,50,46,1,-1.276481759,-1.170500555,-1.326567295,0.902033396,-1.994864568,1.994864568,-1.326567295,-1.170500555,1,1,0
4867,21,68,51,110,108,1,4887.55,4,1033.512,MORE,-392,2496,2104,5,1,-2,-0.187481692,2,-1.222253018,-1.847725297,0.708878878,218,110,108,1,1.156811594,1.170500555,1.092467184,0.382877485,-0.153758567,0.153758567,1.092467184,1.170500555,0,1,0
4868,21,69,50,133,110,0,2929.147,64,1117.997,MORE,-1542,2214,672,2,1,-23,-2.15603946,23,2.444506035,0.836079855,-0.457779907,243,133,110,1,1.655437281,2.067884313,1.170500555,-1.174590249,-1.636441971,1.636441971,1.170500555,2.067884313,1,0,0
4869,21,70,49,131,110,0,2791.754,54,1302.177,MORE,-892,1716,824,4,1,-21,-1.968557767,21,2.095290887,0.388778996,-0.539627591,241,131,110,1,1.615547226,1.989850943,1.170500555,-0.136278427,-0.798403525,0.798403525,1.170500555,1.989850943,1,1,0
4870,21,71,47,126,110,0,3715.584,54,1319.246,MORE,-550,2118,1568,4,2,-16,-1.499853537,16,1.222253018,0.388778996,0.010715921,236,126,110,1,1.515822089,1.794767517,1.170500555,-0.136278427,-0.357466373,0.357466373,1.170500555,1.794767517,1,1,0
4871,21,72,50,110,133,1,2184.235,74,811.149,MORE,520,904,1424,3,2,23,2.15603946,23,2.444506035,1.283380714,-0.901538484,243,110,133,0,1.655437281,1.170500555,2.067884313,-0.655434338,1.022073837,1.022073837,2.067884313,1.170500555,1,0,1
4872,21,73,47,110,126,1,1333.074,74,848.148,MORE,782,432,1214,1,2,16,1.499853537,16,1.222253018,1.283380714,-1.408591659,236,110,126,0,1.515822089,1.170500555,1.794767517,-1.693746161,1.359867795,1.359867795,1.794767517,1.170500555,1,0,1
4873,21,74,12,48,50,1,3809.032,44,1353.929,MORE,26,1516,1542,5,2,2,0.187481692,2,-1.222253018,-0.058521862,0.066384713,98,48,50,0,-1.236591704,-1.248533925,-1.170500555,0.382877485,0.385164619,0.385164619,-1.170500555,-1.248533925,0,1,1
4874,21,75,32,80,77,1,3733.481,54,1253.146,MORE,136,1558,1694,5,2,-3,-0.281222538,3,-1.047645444,0.388778996,0.021377512,157,80,77,1,-0.059835082,0,-0.117050055,0.382877485,0.526986509,0.526986509,-0.117050055,0,0,1,1
4875,21,76,43,117,110,1,6625.593,34,1780.652,MORE,-210,3058,2848,5,2,-7,-0.656185922,7,-0.349215148,-0.505822721,1.744264922,227,117,110,1,1.336316841,1.443617351,1.170500555,0.382877485,0.080892198,0.080892198,1.170500555,1.443617351,0,1,0
4876,21,77,40,80,64,0,3065.924,64,1693.437,MORE,-534,1646,1112,4,2,-16,-1.499853537,16,1.222253018,0.836079855,-0.376299186,144,80,64,1,-0.31912044,0,-0.624266962,-0.136278427,-0.336837735,0.336837735,-0.624266962,0,1,1,0
4877,21,78,31,80,78,1,2294.965,54,1138.054,MORE,472,818,1290,3,2,-2,-0.187481692,2,-1.222253018,0.388778996,-0.835574468,158,80,78,1,-0.039890055,0,-0.07803337,-0.655434338,0.960187921,0.960187921,-0.07803337,0,1,0,1
4878,21,79,46,124,110,0,5545.179,34,1208.129,MORE,-400,2674,2274,6,1,-14,-1.312371845,14,0.87303787,-0.505822721,1.100641273,234,124,110,1,1.475932034,1.716734147,1.170500555,0.902033396,-0.164072886,0.164072886,1.170500555,1.716734147,0,1,0
4879,21,80,58,92,110,1,3858.118,84,3136.748,MORE,1518,2230,3748,3,2,18,1.687335229,18,1.571468165,1.730681573,0.095626199,202,92,110,0,0.837691154,0.468200222,1.170500555,-0.655434338,2.308785174,2.308785174,1.170500555,0.468200222,1,0,1
4880,21,81,48,128,110,1,2259.005,54,1652.707,LESS,476,724,1200,3,2,-18,-1.687335229,18,1.571468165,0.388778996,-0.85699654,238,128,110,0,1.555712144,1.872800887,1.170500555,-0.655434338,0.965345081,0.965345081,1.170500555,1.872800887,1,0,1
4881,21,82,8,50,58,0,2876.09,74,1687.511,LESS,-474,1408,934,3,2,8,0.749926769,8,-0.174607574,1.283380714,-0.489386995,108,50,58,1,-1.037141429,-1.170500555,-0.858367073,-0.655434338,-0.25948034,0.25948034,-0.858367073,-1.170500555,1,0,1
4882,21,83,4,54,50,1,3792.186,60,2344.205,LESS,-388,2086,1698,5,1,-4,-0.374963384,4,-0.87303787,0.657159512,0.056349223,104,54,50,0,-1.116921539,-1.014433814,-1.170500555,0.382877485,-0.148601407,0.148601407,-1.170500555,-1.014433814,1,1,1
4883,21,84,37,80,69,1,4953.383,64,1838.405,LESS,218,2298,2516,6,2,-11,-1.031149307,11,0.349215148,0.836079855,0.748096877,149,80,69,0,-0.219395302,0,-0.429183537,0.902033396,0.632708283,0.632708283,-0.429183537,0,1,1,1
4884,21,85,52,105,110,0,6086.174,14,1685.691,LESS,-294,2888,2594,6,1,5,0.46870423,5,-0.698430296,-1.400424439,1.422922525,215,105,110,1,1.096976512,0.975417129,1.170500555,0.902033396,-0.027408155,0.027408155,1.170500555,0.975417129,0,1,1
4885,21,86,5,55,50,0,1853.876,54,1613.654,LESS,10,1166,1176,2,2,-5,-0.46870423,5,-0.698430296,0.388778996,-1.098339771,105,55,50,0,-1.096976512,-0.975417129,-1.170500555,-1.174590249,0.36453598,0.36453598,-1.170500555,-0.975417129,1,0,1
4886,21,87,30,96,80,1,6288.181,14,1054.817,LESS,776,2482,3258,6,1,-16,-1.499853537,16,1.222253018,-1.400424439,1.543262026,176,96,80,0,0.31912044,0.624266962,0,0.902033396,1.352132056,1.352132056,0,0.624266962,0,1,1
4887,21,88,33,80,75,1,5492.658,14,1489.46,LESS,1118,2026,3144,7,1,-5,-0.46870423,5,-0.698430296,-1.400424439,1.069353491,155,80,75,0,-0.099725137,0,-0.195083426,1.421189307,1.793069207,1.793069207,-0.195083426,0,0,1,1
4888,21,89,48,110,128,0,5079.273,54,1121.91,LESS,-2030,3416,1386,4,1,18,1.687335229,18,1.571468165,0.388778996,0.823092001,238,110,128,1,1.555712144,1.170500555,1.872800887,-0.136278427,-2.26561545,2.26561545,1.872800887,1.170500555,1,1,0
4889,21,90,9,59,50,1,7720.113,14,1387.505,LESS,464,3374,3838,9,1,-9,-0.843667615,9,0,-1.400424439,2.39629179,109,59,50,0,-1.017196402,-0.819350388,-1.170500555,2.45950113,0.949873602,0.949873602,-1.170500555,-0.819350388,0,1,1
4890,21,91,44,110,119,0,2067.515,34,952.06,LESS,-708,1410,702,2,1,9,0.843667615,9,0,-0.505822721,-0.97107086,229,110,119,1,1.376206896,1.170500555,1.521650721,-1.174590249,-0.56117418,0.56117418,1.521650721,1.170500555,0,0,0
4891,21,92,2,52,50,0,3373.466,34,1187.903,LESS,-602,1942,1340,4,1,-2,-0.187481692,2,-1.222253018,-0.505822721,-0.193090431,102,52,50,0,-1.156811594,-1.092467184,-1.170500555,-0.136278427,-0.424509449,0.424509449,-1.170500555,-1.092467184,0,1,0
4892,21,93,8,58,50,1,4757.763,44,869.522,LESS,734,1784,2518,7,2,-8,-0.749926769,8,-0.174607574,-0.058521862,0.631562236,108,58,50,0,-1.037141429,-0.858367073,-1.170500555,1.421189307,1.297981879,1.297981879,-1.170500555,-0.858367073,1,1,1
4893,21,94,44,119,110,1,2216.41,24,802.005,LESS,490,824,1314,3,2,-9,-0.843667615,9,0,-0.95312358,-0.882371211,229,119,110,0,1.376206896,1.521650721,1.170500555,-0.655434338,0.98339514,0.98339514,1.170500555,1.521650721,0,0,1
4894,21,95,34,74,80,0,8953.307,24,5108.927,LESS,-2906,5544,2638,8,1,6,0.562445076,6,-0.523822722,-0.95312358,3.130929458,154,74,80,1,-0.119670165,-0.234100111,0,1.940345219,-3.395033417,3.395033417,0,-0.234100111,0,1,0
4895,21,96,24,86,80,0,5655.27,24,1517.093,LESS,-1094,3030,1936,6,1,-6,-0.562445076,6,-0.523822722,-0.95312358,1.166224625,166,86,80,0,0.119670165,0.234100111,0,0.902033396,-1.058840088,1.058840088,0,0.234100111,0,1,0
4896,21,97,39,66,80,0,1800.597,64,1341.701,LESS,-648,1188,540,2,1,14,1.312371845,14,0.87303787,0.836079855,-1.130079108,146,66,80,1,-0.279230385,-0.546233592,0,-1.174590249,-0.483816785,0.483816785,0,-0.546233592,1,0,0
4897,21,98,9,50,59,0,1809.005,64,851.172,LESS,-780,1194,414,2,1,9,0.843667615,9,0,0.836079855,-1.125070299,109,50,59,1,-1.017196402,-1.170500555,-0.819350388,-1.174590249,-0.654003054,0.654003054,-0.819350388,-1.170500555,1,0,0
4898,21,99,57,94,110,0,6087.993,54,1619.404,LESS,-860,3148,2288,8,1,16,1.499853537,16,1.222253018,0.388778996,1.424006138,204,94,110,1,0.877581209,0.546233592,1.170500555,1.940345219,-0.757146248,0.757146248,1.170500555,0.546233592,1,1,0
4899,21,100,60,110,87,1,2367.676,54,1309.566,LESS,110,1004,1114,3,2,-23,-2.15603946,23,2.444506035,0.388778996,-0.79225911,197,110,87,0,0.737966017,1.170500555,0.273116796,-0.655434338,0.493464972,0.493464972,0.273116796,1.170500555,1,0,1
4900,21,101,33,75,80,0,4641.306,54,1321.182,LESS,-996,2616,1620,6,1,5,0.46870423,5,-0.698430296,0.388778996,0.562186534,155,75,80,1,-0.099725137,-0.195083426,0,0.902033396,-0.932489676,0.932489676,0,-0.195083426,1,1,0
4901,21,102,15,50,45,1,5208.175,14,1197.475,LESS,1134,1768,2902,7,2,-5,-0.46870423,5,-0.698430296,-1.400424439,0.899881431,95,50,45,0,-1.296426786,-1.170500555,-1.36558398,1.421189307,1.813697846,1.813697846,-1.36558398,-1.170500555,0,1,1
4902,21,103,59,89,110,0,3285.998,44,1259.207,LESS,-748,1938,1190,4,1,21,1.968557767,21,2.095290887,-0.058521862,-0.245196821,199,89,110,1,0.777856072,0.351150166,1.170500555,-0.136278427,-0.612745777,0.612745777,1.170500555,0.351150166,1,0,0
4903,21,104,29,80,94,0,1911.852,44,1163.009,LESS,-612,1142,530,2,1,14,1.312371845,14,0.87303787,-0.058521862,-1.063802339,174,80,94,1,0.279230385,0,0.546233592,-1.174590249,-0.437402348,0.437402348,0.546233592,0,1,0,0
4904,21,105,55,110,98,1,4350.2,14,1079.905,LESS,280,1954,2234,5,1,-12,-1.124890153,12,0.523822722,-1.400424439,0.388769024,208,110,98,0,0.957361319,1.170500555,0.702300333,0.382877485,0.712644257,0.712644257,0.702300333,1.170500555,0,1,1
4905,21,106,29,94,80,1,4407.332,34,1984.327,LESS,-106,2228,2122,3,2,-14,-1.312371845,14,0.87303787,-0.505822721,0.422803669,174,94,80,0,0.279230385,0.546233592,0,-0.655434338,0.21497835,0.21497835,0,0.546233592,0,0,1
4906,21,107,57,110,94,1,7101.501,4,1132.947,LESS,-440,3704,3264,8,1,-16,-1.499853537,16,1.222253018,-1.847725297,2.027772581,204,110,94,0,0.877581209,1.170500555,0.546233592,1.940345219,-0.215644483,0.215644483,0.546233592,1.170500555,0,1,1
4907,21,108,39,80,66,1,3596.618,64,991.126,LESS,38,1602,1640,4,1,-14,-1.312371845,14,0.87303787,0.836079855,-0.060154441,146,80,66,0,-0.279230385,0,-0.546233592,-0.136278427,0.400636098,0.400636098,-0.546233592,0,1,0,1
4908,21,109,4,50,54,0,3515.558,44,1480.846,LESS,-792,2058,1266,4,1,4,0.374963384,4,-0.87303787,-0.058521862,-0.108443461,104,50,54,1,-1.116921539,-1.170500555,-1.014433814,-0.136278427,-0.669474533,0.669474533,-1.014433814,-1.170500555,1,0,0
4909,21,110,55,98,110,0,4197.757,14,833.809,LESS,-1568,2914,1346,4,1,12,1.124890153,12,0.523822722,-1.400424439,0.297955762,208,98,110,1,0.957361319,0.702300333,1.170500555,-0.136278427,-1.669963509,1.669963509,1.170500555,0.702300333,0,0,0
4910,21,111,2,50,52,0,6221.123,64,1661.593,LESS,-898,3296,2398,6,1,2,0.187481692,2,-1.222253018,0.836079855,1.503314271,102,50,52,1,-1.156811594,-1.170500555,-1.092467184,0.902033396,-0.806139264,0.806139264,-1.092467184,-1.170500555,1,1,0
4911,21,112,59,110,89,1,5153.19,44,1343.598,LESS,40,2396,2436,5,2,-21,-1.968557767,21,2.095290887,-0.058521862,0.867125796,199,110,89,0,0.777856072,1.170500555,0.351150166,0.382877485,0.403214677,0.403214677,0.351150166,1.170500555,1,1,1
4912,21,113,60,87,110,0,2283.474,14,840.182,LESS,-932,1654,722,2,1,23,2.15603946,23,2.444506035,-1.400424439,-0.84241988,197,87,110,1,0.737966017,0.273116796,1.170500555,-1.174590249,-0.849975122,0.849975122,1.170500555,0.273116796,0,0,0
4913,21,114,52,110,105,1,6055.583,34,1322.008,LESS,-1086,3446,2360,7,1,-5,-0.46870423,5,-0.698430296,-0.505822721,1.40469887,215,110,105,0,1.096976512,1.170500555,0.975417129,1.421189307,-1.048525769,1.048525769,0.975417129,1.170500555,0,1,0
4914,21,115,30,80,96,0,1957.349,74,1338.936,LESS,-656,1204,548,2,1,16,1.499853537,16,1.222253018,1.283380714,-1.036698891,176,80,96,1,0.31912044,0,0.624266962,-1.174590249,-0.494131105,0.494131105,0.624266962,0,1,0,0
4915,21,116,24,80,86,0,3033.6,54,1045.299,LESS,-308,1768,1460,5,2,6,0.562445076,6,-0.523822722,0.388778996,-0.395555222,166,80,86,1,0.119670165,0,0.234100111,0.382877485,-0.045458214,0.045458214,0.234100111,0,1,1,1
4916,21,117,5,50,55,0,3853.18,54,897.996,LESS,-1014,2232,1218,4,1,5,0.46870423,5,-0.698430296,0.388778996,0.092684536,105,50,55,1,-1.096976512,-1.170500555,-0.975417129,-0.136278427,-0.955696895,0.955696895,-0.975417129,-1.170500555,1,0,0
4917,21,118,34,80,74,1,2868.129,34,816.119,LESS,696,950,1646,3,2,-6,-0.562445076,6,-0.523822722,-0.505822721,-0.494129517,154,80,74,0,-0.119670165,0,-0.234100111,-0.655434338,1.248988863,1.248988863,-0.234100111,0,0,0,1
4918,21,119,15,45,50,0,3188.486,54,1072.74,LESS,-1100,1944,844,4,1,5,0.46870423,5,-0.698430296,0.388778996,-0.303286617,95,45,50,1,-1.296426786,-1.36558398,-1.170500555,-0.136278427,-1.066575828,1.066575828,-1.170500555,-1.36558398,1,0,0
4919,21,120,37,69,80,0,1792.103,54,1323.45,LESS,-126,886,760,3,2,11,1.031149307,11,0.349215148,0.388778996,-1.135139149,149,69,80,1,-0.219395302,-0.429183537,0,-0.655434338,0.189192551,0.189192551,0,-0.429183537,1,0,1
4920,21,121,48,128,110,0,3927.783,74,1621.094,MORE,-166,2106,1940,4,2,-18,-1.687335229,18,1.571468165,1.283380714,0.137126995,238,128,110,1,1.555712144,1.872800887,1.170500555,-0.136278427,0.137620955,0.137620955,1.170500555,1.872800887,1,1,0
4921,21,122,8,50,58,1,2346.591,54,1648.833,MORE,102,926,1028,3,2,8,0.749926769,8,-0.174607574,0.388778996,-0.804819855,108,50,58,0,-1.037141429,-1.170500555,-0.858367073,-0.655434338,0.483150652,0.483150652,-0.858367073,-1.170500555,1,0,1
4922,21,123,4,54,50,1,2281.117,44,1283.836,MORE,552,764,1316,3,2,-4,-0.374963384,4,-0.87303787,-0.058521862,-0.843823991,104,54,50,1,-1.116921539,-1.014433814,-1.170500555,-0.655434338,1.063331115,1.063331115,-1.170500555,-1.014433814,0,0,1
4923,21,124,37,80,69,0,2012.436,24,1150.821,MORE,-346,1502,1156,4,1,-11,-1.031149307,11,0.349215148,-0.95312358,-1.003882493,149,80,69,1,-0.219395302,0,-0.429183537,-0.136278427,-0.09445123,0.09445123,-0.429183537,0,0,1,0
4924,21,125,52,105,110,1,4045.193,64,1673.562,MORE,812,1840,2652,5,2,5,0.46870423,5,-0.698430296,0.836079855,0.207070418,215,105,110,0,1.096976512,0.975417129,1.170500555,0.382877485,1.398546493,1.398546493,1.170500555,0.975417129,1,1,1
4925,21,126,5,55,50,0,2741.112,54,748.666,MORE,-570,1572,1002,4,1,-5,-0.46870423,5,-0.698430296,0.388778996,-0.569796016,105,55,50,1,-1.096976512,-0.975417129,-1.170500555,-0.136278427,-0.383252172,0.383252172,-1.170500555,-0.975417129,1,1,0
4926,21,127,30,96,80,0,1764.354,74,733.854,MORE,-318,1010,692,2,2,-16,-1.499853537,16,1.222253018,1.283380714,-1.151669769,176,96,80,1,0.31912044,0.624266962,0,-1.174590249,-0.058351113,0.058351113,0,0.624266962,1,0,0
4927,21,128,33,80,75,0,5100.177,24,838.522,MORE,122,2300,2422,6,2,-5,-0.46870423,5,-0.698430296,-0.95312358,0.83554492,155,80,75,1,-0.099725137,0,-0.195083426,0.902033396,0.508936451,0.508936451,-0.195083426,0,0,1,1
4928,21,129,48,110,128,1,2564.103,74,1431.564,MORE,1232,856,2088,3,2,18,1.687335229,18,1.571468165,1.283380714,-0.675243723,238,110,128,0,1.555712144,1.170500555,1.872800887,-0.655434338,1.940048258,1.940048258,1.872800887,1.170500555,1,0,1
4929,21,130,9,59,50,0,3870.127,24,1137.972,MORE,-402,2148,1746,6,1,-9,-0.843667615,9,0,-0.95312358,0.102780194,109,59,50,1,-1.017196402,-0.819350388,-1.170500555,0.902033396,-0.166651466,0.166651466,-1.170500555,-0.819350388,0,1,0
4930,21,131,44,110,119,1,3701.464,64,1136.048,MORE,426,1428,1854,3,2,9,0.843667615,9,0,0.836079855,0.002304362,229,110,119,0,1.376206896,1.170500555,1.521650721,-0.655434338,0.900880585,0.900880585,1.521650721,1.170500555,1,0,1
4931,21,132,2,52,50,0,8908.739,14,1812.5,MORE,-484,4074,3590,9,1,-2,-0.187481692,2,-1.222253018,-1.400424439,3.104379433,102,52,50,1,-1.156811594,-1.092467184,-1.170500555,2.45950113,-0.272373239,0.272373239,-1.170500555,-1.092467184,0,1,0
4932,21,133,8,58,50,0,5423.255,24,1021.682,MORE,-618,2776,2158,6,1,-8,-0.749926769,8,-0.174607574,-0.95312358,1.028008773,108,58,50,1,-1.037141429,-0.858367073,-1.170500555,0.902033396,-0.445138088,0.445138088,-1.170500555,-0.858367073,0,1,0
4933,21,134,44,119,110,0,3533.67,44,1185.239,MORE,-1422,2264,842,4,1,-9,-0.843667615,9,0,-0.058521862,-0.09765379,229,119,110,1,1.376206896,1.521650721,1.170500555,-0.136278427,-1.481727181,1.481727181,1.170500555,1.521650721,0,1,0
4934,21,135,34,74,80,1,2659.023,54,891.301,MORE,402,970,1372,3,2,6,0.562445076,6,-0.523822722,0.388778996,-0.618698032,154,74,80,0,-0.119670165,-0.234100111,0,-0.655434338,0.869937627,0.869937627,0,-0.234100111,0,0,1
4935,21,136,24,86,80,0,2188.129,64,2173.324,MORE,-200,1314,1114,4,2,-6,-0.562445076,6,-0.523822722,0.836079855,-0.899218753,166,86,80,1,0.119670165,0.234100111,0,-0.136278427,0.093785097,0.093785097,0,0.234100111,1,1,0
4936,21,137,39,66,80,1,2611.263,54,1748.203,MORE,600,1054,1654,3,2,14,1.312371845,14,0.87303787,0.388778996,-0.647149593,146,66,80,0,-0.279230385,-0.546233592,0,-0.655434338,1.125217031,1.125217031,0,-0.546233592,0,0,1
4937,21,138,9,50,59,1,2174.234,54,1266.346,MORE,456,708,1164,3,2,9,0.843667615,9,0,0.388778996,-0.907496275,109,50,59,0,-1.017196402,-1.170500555,-0.819350388,-0.655434338,0.939559283,0.939559283,-0.819350388,-1.170500555,0,0,1
4938,21,139,57,94,110,1,2799.173,14,999.547,MORE,60,1360,1420,4,1,16,1.499853537,16,1.222253018,-1.400424439,-0.535207949,204,94,110,0,0.877581209,0.546233592,1.170500555,-0.136278427,0.429000476,0.429000476,1.170500555,0.546233592,0,1,1
4939,21,140,60,110,87,0,1889.209,64,1420.474,MORE,-318,1028,710,2,2,-23,-2.15603946,23,2.444506035,0.836079855,-1.077291215,197,110,87,1,0.737966017,1.170500555,0.273116796,-1.174590249,-0.058351113,0.058351113,0.273116796,1.170500555,1,0,0
4940,21,141,33,75,80,1,2365.461,34,1370.266,MORE,178,984,1162,3,2,5,0.46870423,5,-0.698430296,-0.505822721,-0.793578629,155,75,80,0,-0.099725137,-0.195083426,0,-0.655434338,0.581136686,0.581136686,0,-0.195083426,0,0,1
4941,21,142,15,50,45,0,4368.702,54,1465.853,MORE,-720,2416,1696,6,2,-5,-0.46870423,5,-0.698430296,0.388778996,0.399791026,95,50,45,1,-1.296426786,-1.170500555,-1.36558398,0.902033396,-0.576645659,0.576645659,-1.36558398,-1.170500555,0,1,0
4942,21,143,59,89,110,1,2463.41,70,1373.134,MORE,1176,906,2082,3,2,21,1.968557767,21,2.095290887,1.10446037,-0.735228503,199,89,110,0,0.777856072,0.351150166,1.170500555,-0.655434338,1.867848023,1.867848023,1.170500555,0.351150166,1,0,1
4943,21,144,29,80,94,1,2663.583,54,1266.593,MORE,460,1190,1650,5,2,14,1.312371845,14,0.87303787,0.388778996,-0.615981551,174,80,94,0,0.279230385,0,0.546233592,0.382877485,0.944716442,0.944716442,0.546233592,0,0,1,1
4944,21,145,55,110,98,1,2172.213,44,1434.837,MORE,354,754,1108,3,2,-12,-1.124890153,12,0.523822722,-0.058521862,-0.908700224,208,110,98,1,0.957361319,1.170500555,0.702300333,-0.655434338,0.808051711,0.808051711,0.702300333,1.170500555,0,0,1
4945,21,146,29,94,80,0,1703.131,64,1216.825,MORE,-294,1012,718,2,2,-14,-1.312371845,14,0.87303787,0.836079855,-1.188141501,174,94,80,1,0.279230385,0.546233592,0,-1.174590249,-0.027408155,0.027408155,0,0.546233592,1,0,0
4946,21,147,57,110,94,1,4571.52,54,1307.582,MORE,74,1932,2006,5,2,-16,-1.499853537,16,1.222253018,0.388778996,0.520613656,204,110,94,1,0.877581209,1.170500555,0.546233592,0.382877485,0.447050535,0.447050535,0.546233592,1.170500555,0,1,1
4947,21,148,39,80,66,0,3521.212,44,1706.901,MORE,-978,2136,1158,4,1,-14,-1.312371845,14,0.87303787,-0.058521862,-0.105075263,146,80,66,1,-0.279230385,0,-0.546233592,-0.136278427,-0.909282458,0.909282458,-0.546233592,0,0,1,0
4948,21,149,4,50,54,0,3895.733,34,1578.007,MORE,-1056,2310,1254,4,2,4,0.374963384,4,-0.87303787,-0.505822721,0.118034187,104,50,54,0,-1.116921539,-1.170500555,-1.014433814,-0.136278427,-1.009847071,1.009847071,-1.014433814,-1.170500555,0,1,0
4949,21,150,55,98,110,1,2916.412,54,2111.211,MORE,-134,1408,1274,3,1,12,1.124890153,12,0.523822722,0.388778996,-0.465366394,208,98,110,0,0.957361319,0.702300333,1.170500555,-0.655434338,0.178878232,0.178878232,1.170500555,0.702300333,1,0,0
4950,21,151,2,50,52,1,3362.676,40,1558.416,MORE,1112,1308,2420,4,1,2,0.187481692,2,-1.222253018,-0.237442206,-0.199518244,102,50,52,0,-1.156811594,-1.170500555,-1.092467184,-0.136278427,1.785333468,1.785333468,-1.092467184,-1.170500555,0,1,1
4951,21,152,59,110,89,0,1545.488,74,920.161,MORE,-404,866,462,2,1,-21,-1.968557767,21,2.095290887,1.283380714,-1.282052505,199,110,89,1,0.777856072,1.170500555,0.351150166,-1.174590249,-0.169230046,0.169230046,0.351150166,1.170500555,1,0,0
4952,21,153,60,87,110,1,2022.807,84,1155.826,MORE,574,864,1438,3,2,23,2.15603946,23,2.444506035,1.730681573,-0.997704286,197,87,110,0,0.737966017,0.273116796,1.170500555,-0.655434338,1.091695493,1.091695493,1.170500555,0.273116796,1,0,1
4953,21,154,52,110,105,1,2186.946,64,2094.386,MORE,92,1002,1094,4,1,-5,-0.46870423,5,-0.698430296,0.836079855,-0.899923489,215,110,105,1,1.096976512,1.170500555,0.975417129,-0.136278427,0.470257753,0.470257753,0.975417129,1.170500555,1,1,1
4954,21,155,30,80,96,1,1891.139,74,943.877,MORE,750,668,1418,3,2,16,1.499853537,16,1.222253018,1.283380714,-1.076141476,176,80,96,0,0.31912044,0,0.624266962,-0.655434338,1.318610518,1.318610518,0.624266962,0,1,0,1
4955,21,156,24,80,86,1,8029.44,34,2882.831,MORE,948,3272,4220,6,2,6,0.562445076,6,-0.523822722,-0.505822721,2.580563904,166,80,86,0,0.119670165,0,0.234100111,0.902033396,1.573889922,1.573889922,0.234100111,0,0,1,1
4956,21,157,5,50,55,1,2919.296,14,816.681,MORE,262,1240,1502,3,1,5,0.46870423,5,-0.698430296,-1.400424439,-0.46364834,105,50,55,0,-1.096976512,-1.170500555,-0.975417129,-0.655434338,0.689437039,0.689437039,-0.975417129,-1.170500555,0,0,1
4957,21,158,34,80,74,1,3110.724,24,1089.959,MORE,44,1416,1460,3,2,-6,-0.562445076,6,-0.523822722,-0.95312358,-0.349610954,154,80,74,1,-0.119670165,0,-0.234100111,-0.655434338,0.408371837,0.408371837,-0.234100111,0,0,0,1
4958,21,159,15,45,50,1,2221.779,54,852.76,MORE,322,852,1174,3,2,5,0.46870423,5,-0.698430296,0.388778996,-0.879172793,95,45,50,0,-1.296426786,-1.36558398,-1.170500555,-0.655434338,0.766794434,0.766794434,-1.170500555,-1.36558398,0,0,1
4959,21,160,37,69,80,1,3658.028,54,954.841,MORE,-1176,2248,1072,3,2,11,1.031149307,11,0.349215148,0.388778996,-0.023571309,149,69,80,0,-0.219395302,-0.429183537,0,-0.655434338,-1.164561861,1.164561861,0,-0.429183537,0,0,0
4960,21,161,3,50,53,0,3194.879,34,1402.296,LESS,-1668,2394,726,3,2,3,0.281222538,3,-1.047645444,-0.505822721,-0.299478183,103,50,53,1,-1.136866566,-1.170500555,-1.053450499,-0.655434338,-1.7988925,1.7988925,-1.053450499,-1.170500555,0,0,0
4961,21,162,20,50,40,1,2147.085,64,1061.002,LESS,684,840,1524,3,2,-10,-0.937408461,10,0.174607574,0.836079855,-0.923669462,90,50,40,0,-1.396151924,-1.170500555,-1.560667406,-0.655434338,1.233517384,1.233517384,-1.560667406,-1.170500555,1,0,1
4962,21,163,25,80,88,0,5070.572,4,1258.613,LESS,-1480,3250,1770,6,1,8,0.749926769,8,-0.174607574,-1.847725297,0.817908646,168,80,88,1,0.15956022,0,0.312133481,0.902033396,-1.556505996,1.556505996,0.312133481,0,0,1,0
4963,21,164,42,115,110,0,5417.065,0,1002.469,LESS,-1796,3618,1822,6,1,-5,-0.46870423,5,-0.698430296,-2.026645641,1.02432127,225,115,110,0,1.296426786,1.36558398,1.170500555,0.902033396,-1.96392161,1.96392161,1.170500555,1.36558398,0,1,0
4964,21,165,53,103,110,0,3136.464,44,1478.752,LESS,-1064,1972,908,4,1,7,0.656185922,7,-0.349215148,-0.058521862,-0.334277135,213,103,110,1,1.057086457,0.897383758,1.170500555,-0.136278427,-1.020161391,1.020161391,1.170500555,0.897383758,1,0,0
4965,21,166,26,90,80,1,5386.943,14,2184.527,LESS,-1258,3574,2316,9,1,-10,-0.937408461,10,0.174607574,-1.400424439,1.006377008,170,90,80,0,0.199450275,0.390166852,0,2.45950113,-1.270283634,1.270283634,0,0.390166852,0,1,0
4966,21,167,35,80,72,1,7266.773,34,2451.218,LESS,-2140,4556,2416,6,1,-8,-0.749926769,8,-0.174607574,-0.505822721,2.126228328,152,80,72,0,-0.15956022,0,-0.312133481,0.902033396,-2.407437341,2.407437341,-0.312133481,0,0,1,0
4967,21,168,28,93,80,1,2320.345,64,1381.411,LESS,28,1026,1054,3,2,-13,-1.218630999,13,0.698430296,0.836079855,-0.820455108,173,93,80,0,0.259285357,0.507216907,0,-0.655434338,0.387743198,0.387743198,0,0.507216907,1,0,1
4968,21,169,26,80,90,0,2738.326,24,1833.339,LESS,-138,1264,1126,4,1,10,0.937408461,10,0.174607574,-0.95312358,-0.571455691,170,80,90,1,0.199450275,0,0.390166852,-0.136278427,0.173721072,0.173721072,0.390166852,0,0,0,1
4969,21,170,25,88,80,1,3743,34,1607.588,LESS,332,1606,1938,5,2,-8,-0.749926769,8,-0.174607574,-0.505822721,0.027048166,168,88,80,0,0.15956022,0.312133481,0,0.382877485,0.779687333,0.779687333,0,0.312133481,0,1,1
4970,21,171,36,80,70,0,6684.261,0,1229.609,LESS,-726,3738,3012,8,1,-10,-0.937408461,10,0.174607574,-2.026645641,1.779214592,150,80,70,0,-0.199450275,0,-0.390166852,1.940345219,-0.584381399,0.584381399,-0.390166852,0,0,1,0
4971,21,172,28,80,93,0,5069.082,54,2849.533,LESS,-2186,3512,1326,4,1,13,1.218630999,13,0.698430296,0.388778996,0.817021024,173,80,93,1,0.259285357,0,0.507216907,-0.136278427,-2.466744677,2.466744677,0.507216907,0,1,1,0
4972,21,173,21,82,80,0,4317.218,44,1047.445,LESS,-798,2338,1540,4,1,-2,-0.187481692,2,-1.222253018,-0.058521862,0.369121005,162,82,80,0,0.039890055,0.07803337,0,-0.136278427,-0.677210273,0.677210273,0,0.07803337,1,1,0
4973,21,174,19,50,41,1,2187.661,14,910.625,LESS,52,1048,1100,4,1,-9,-0.843667615,9,0,-1.400424439,-0.899497549,91,50,41,0,-1.376206896,-1.170500555,-1.521650721,-0.136278427,0.418686156,0.418686156,-1.521650721,-1.170500555,0,1,1
4974,21,175,56,96,110,0,1780.706,64,1095.041,LESS,-636,1112,476,2,1,14,1.312371845,14,0.87303787,0.836079855,-1.141928564,206,96,110,1,0.917471264,0.624266962,1.170500555,-1.174590249,-0.468345306,0.468345306,1.170500555,0.624266962,1,0,0
4975,21,176,23,80,85,0,4697.693,34,2338.222,LESS,-1092,2948,1856,5,2,5,0.46870423,5,-0.698430296,-0.505822721,0.595777368,165,80,85,1,0.099725137,0,0.195083426,0.382877485,-1.056261508,1.056261508,0.195083426,0,0,1,0
4976,21,177,10,60,50,1,4615.715,24,1669.926,LESS,106,2136,2242,5,1,-10,-0.937408461,10,0.174607574,-0.95312358,0.546941478,110,60,50,0,-0.997251374,-0.780333703,-1.170500555,0.382877485,0.488307812,0.488307812,-1.170500555,-0.780333703,0,1,1
4977,21,178,19,41,50,0,3213.238,44,1010.195,LESS,-1004,2176,1172,5,2,9,0.843667615,9,0,-0.058521862,-0.288541369,91,41,50,1,-1.376206896,-1.521650721,-1.170500555,0.382877485,-0.942803996,0.942803996,-1.170500555,-1.521650721,1,1,0
4978,21,179,56,110,96,0,7377.466,0,2745.997,LESS,-1306,4270,2964,8,1,-14,-1.312371845,14,0.87303787,-2.026645641,2.192170302,206,110,96,0,0.917471264,1.170500555,0.624266962,1.940345219,-1.33216955,1.33216955,0.624266962,1.170500555,0,1,0
4979,21,180,35,72,80,0,3176.483,60,1455.059,LESS,-572,1944,1372,4,2,8,0.749926769,8,-0.174607574,0.657159512,-0.310437038,152,72,80,1,-0.15956022,-0.312133481,0,-0.136278427,-0.385830752,0.385830752,0,-0.312133481,1,1,0
4980,21,181,11,49,50,1,3459.488,14,1730.948,LESS,-260,1608,1348,3,2,1,0.093740846,1,-1.396860592,-1.400424439,-0.141845451,99,49,50,1,-1.216646676,-1.20951724,-1.170500555,-0.655434338,0.016427702,0.016427702,-1.170500555,-1.20951724,0,0,1
4981,21,182,17,43,50,0,2485.027,64,1559.095,LESS,236,1252,1488,2,2,7,0.656185922,7,-0.349215148,0.836079855,-0.722350835,93,43,50,1,-1.336316841,-1.443617351,-1.170500555,-1.174590249,0.655915501,0.655915501,-1.170500555,-1.443617351,1,0,1
4982,21,183,1,51,50,0,4340.71,34,1206.124,LESS,-1744,2864,1120,4,1,-1,-0.093740846,1,-1.396860592,-0.505822721,0.383115646,101,51,50,0,-1.176756621,-1.131483869,-1.170500555,-0.136278427,-1.896878534,1.896878534,-1.170500555,-1.131483869,0,0,0
4983,21,184,41,112,110,1,2234.861,34,1333.707,LESS,28,1160,1188,3,2,-2,-0.187481692,2,-1.222253018,-0.505822721,-0.871379591,222,112,110,0,1.236591704,1.248533925,1.170500555,-0.655434338,0.387743198,0.387743198,1.170500555,1.248533925,0,0,1
4984,21,185,20,40,50,0,1765.262,54,1158.84,LESS,-542,1064,522,2,1,10,0.937408461,10,0.174607574,0.388778996,-1.151128855,90,40,50,1,-1.396151924,-1.560667406,-1.170500555,-1.174590249,-0.347152054,0.347152054,-1.170500555,-1.560667406,1,0,0
4985,21,186,1,50,51,0,2333.864,54,1409.372,LESS,-398,1434,1036,2,2,1,0.093740846,1,-1.396860592,0.388778996,-0.812401577,101,50,51,1,-1.176756621,-1.170500555,-1.131483869,-1.174590249,-0.161494306,0.161494306,-1.131483869,-1.170500555,1,0,1
4986,21,187,23,85,80,0,3397.47,24,947.396,LESS,-576,1812,1236,4,1,-5,-0.46870423,5,-0.698430296,-0.95312358,-0.178790781,165,85,80,0,0.099725137,0.195083426,0,-0.136278427,-0.390987911,0.390987911,0,0.195083426,0,1,0
4987,21,188,11,50,49,1,5579.569,54,954.002,LESS,902,1854,2756,4,2,-1,-0.093740846,1,-1.396860592,0.388778996,1.121128066,99,50,49,0,-1.216646676,-1.170500555,-1.20951724,-0.136278427,1.514582585,1.514582585,-1.20951724,-1.170500555,1,0,1
4988,21,189,17,50,43,1,2468.565,54,1233.596,LESS,-76,1210,1134,3,2,-7,-0.656185922,7,-0.349215148,0.388778996,-0.732157569,93,50,43,0,-1.336316841,-1.170500555,-1.443617351,-0.655434338,0.253657047,0.253657047,-1.443617351,-1.170500555,1,0,1
4989,21,190,21,80,82,0,3862.368,14,842.38,LESS,-848,2192,1344,6,1,2,0.187481692,2,-1.222253018,-1.400424439,0.098158007,162,80,82,1,0.039890055,0,0.07803337,0.902033396,-0.741674769,0.741674769,0.07803337,0,0,1,0
4990,21,191,10,50,60,0,4770.802,24,1605.074,LESS,-1602,3226,1624,7,2,10,0.937408461,10,0.174607574,-0.95312358,0.639329822,110,50,60,1,-0.997251374,-1.170500555,-0.780333703,1.421189307,-1.713799366,1.713799366,-0.780333703,-1.170500555,0,1,0
4991,21,192,3,53,50,0,6413.825,54,1435.714,LESS,-828,3122,2294,6,1,-3,-0.281222538,3,-1.047645444,0.388778996,1.618110603,103,53,50,0,-1.136866566,-1.053450499,-1.170500555,0.902033396,-0.71588897,0.71588897,-1.170500555,-1.053450499,1,1,0
4992,21,193,45,122,110,1,3994.448,0,1838.84,LESS,-378,2412,2034,5,1,-12,-1.124890153,12,0.523822722,-2.026645641,0.176840633,232,122,110,0,1.436041979,1.638700776,1.170500555,0.382877485,-0.135708508,0.135708508,1.170500555,1.638700776,0,1,1
4993,21,194,38,67,80,0,1734.304,34,1262.324,LESS,-724,1162,438,2,1,13,1.218630999,13,0.698430296,-0.505822721,-1.169571138,147,67,80,1,-0.259285357,-0.507216907,0,-1.174590249,-0.581802819,0.581802819,0,-0.507216907,0,0,0
4994,21,195,38,80,67,1,4647.243,34,1889.793,LESS,644,1818,2462,5,2,-13,-1.218630999,13,0.698430296,-0.505822721,0.565723321,147,80,67,0,-0.259285357,0,-0.507216907,0.382877485,1.181945787,1.181945787,-0.507216907,0,0,1,1
4995,21,196,36,70,80,0,2337.373,94,998.005,LESS,-622,1606,984,2,2,10,0.937408461,10,0.174607574,2.177982431,-0.810311197,150,70,80,1,-0.199450275,-0.390166852,0,-1.174590249,-0.450295247,0.450295247,0,-0.390166852,1,0,0
4996,21,197,45,110,122,1,2315.217,24,1228.744,LESS,794,830,1624,3,2,12,1.124890153,12,0.523822722,-0.95312358,-0.823509958,232,110,122,1,1.436041979,1.170500555,1.638700776,-0.655434338,1.375339274,1.375339274,1.638700776,1.170500555,0,0,1
4997,21,198,42,110,115,0,3295.675,54,902.273,LESS,-800,1952,1152,5,2,5,0.46870423,5,-0.698430296,0.388778996,-0.239432043,225,110,115,1,1.296426786,1.170500555,1.36558398,0.382877485,-0.679788853,0.679788853,1.36558398,1.170500555,1,1,0
4998,21,199,41,110,112,0,3930.609,54,1089.317,LESS,-170,1876,1706,7,2,2,0.187481692,2,-1.222253018,0.388778996,0.138810499,222,110,112,1,1.236591704,1.170500555,1.248533925,1.421189307,0.132463795,0.132463795,1.248533925,1.170500555,1,1,1
4999,21,200,53,110,103,0,4819.176,74,1245.605,LESS,-1080,3162,2082,7,1,-7,-0.656185922,7,-0.349215148,1.283380714,0.668147155,213,110,103,0,1.057086457,1.170500555,0.897383758,1.421189307,-1.040790029,1.040790029,0.897383758,1.170500555,1,1,0
5000,21,201,3,50,53,1,2400.215,54,1444.41,MORE,220,1054,1274,3,1,3,0.281222538,3,-1.047645444,0.388778996,-0.772874995,103,50,53,0,-1.136866566,-1.170500555,-1.053450499,-0.655434338,0.635286862,0.635286862,-1.053450499,-1.170500555,1,0,1
5001,21,202,20,50,40,0,4795.18,34,1969.826,MORE,-470,2446,1976,6,1,-10,-0.937408461,10,0.174607574,-0.505822721,0.653852271,90,50,40,1,-1.396151924,-1.170500555,-1.560667406,0.902033396,-0.25432318,0.25432318,-1.560667406,-1.170500555,0,1,0
5002,21,203,25,80,88,1,2464.427,64,2300.42,MORE,-1500,2334,834,4,1,8,0.749926769,8,-0.174607574,0.836079855,-0.734622656,168,80,88,0,0.15956022,0,0.312133481,-0.136278427,-1.582291794,1.582291794,0.312133481,0,1,1,0
5003,21,204,42,115,110,0,2582.984,54,912.856,MORE,-1640,2196,556,2,1,-5,-0.46870423,5,-0.698430296,0.388778996,-0.663995944,225,115,110,1,1.296426786,1.36558398,1.170500555,-1.174590249,-1.762792383,1.762792383,1.170500555,1.36558398,1,0,0
5004,21,205,53,103,110,0,3333.14,14,1721.539,MORE,-1420,2736,1316,4,1,7,0.656185922,7,-0.349215148,-1.400424439,-0.217113414,213,103,110,0,1.057086457,0.897383758,1.170500555,-0.136278427,-1.479148601,1.479148601,1.170500555,0.897383758,0,1,0
5005,21,206,26,90,80,0,6205.311,64,1071.301,MORE,-1008,3380,2372,8,1,-10,-0.937408461,10,0.174607574,0.836079855,1.493894754,170,90,80,1,0.199450275,0.390166852,0,1.940345219,-0.947961155,0.947961155,0,0.390166852,1,1,0
5006,21,207,35,80,72,1,7904.323,24,2110.443,MORE,-240,3762,3522,10,2,-8,-0.749926769,8,-0.174607574,-0.95312358,2.506029272,152,80,72,1,-0.15956022,0,-0.312133481,2.978657041,0.042213501,0.042213501,-0.312133481,0,0,1,0
5007,21,208,28,93,80,1,3177.11,24,973.091,MORE,-554,1942,1388,6,1,-13,-1.218630999,13,0.698430296,-0.95312358,-0.310063522,173,93,80,1,0.259285357,0.507216907,0,0.902033396,-0.362623533,0.362623533,0,0.507216907,0,1,0
5008,21,209,26,80,90,1,2096.738,84,1369.626,MORE,872,752,1624,3,2,10,0.937408461,10,0.174607574,1.730681573,-0.95366215,170,80,90,0,0.199450275,0,0.390166852,-0.655434338,1.475903888,1.475903888,0.390166852,0,1,0,1
5009,21,210,25,88,80,1,1419.017,64,861.476,MORE,-418,940,522,2,1,-8,-0.749926769,8,-0.174607574,0.836079855,-1.357393741,168,88,80,1,0.15956022,0.312133481,0,-1.174590249,-0.187280104,0.187280104,0,0.312133481,1,0,0
5010,21,211,36,80,70,0,5425.377,64,883.084,MORE,-1090,3026,1936,6,1,-10,-0.937408461,10,0.174607574,0.836079855,1.02927289,150,80,70,1,-0.199450275,0,-0.390166852,0.902033396,-1.053682928,1.053682928,-0.390166852,0,1,1,0
5011,21,212,28,80,93,1,2963.507,64,1381.251,MORE,1372,758,2130,3,2,13,1.218630999,13,0.698430296,0.836079855,-0.437310986,173,80,93,0,0.259285357,0,0.507216907,-0.655434338,2.120548846,2.120548846,0.507216907,0,1,0,1
5012,21,213,21,82,80,1,3435.493,64,1119.754,MORE,462,1294,1756,5,2,-2,-0.187481692,2,-1.222253018,0.836079855,-0.156139739,162,82,80,1,0.039890055,0.07803337,0,0.382877485,0.947295022,0.947295022,0,0.07803337,1,1,1
5013,21,214,19,50,41,0,4322.837,44,961.12,MORE,-742,2550,1808,8,1,-9,-0.843667615,9,0,-0.058521862,0.372468352,91,50,41,1,-1.376206896,-1.170500555,-1.521650721,1.940345219,-0.605010037,0.605010037,-1.521650721,-1.170500555,0,1,0
5014,21,215,56,96,110,1,3453.615,74,1104.734,MORE,86,1484,1570,3,2,14,1.312371845,14,0.87303787,1.283380714,-0.145344111,206,96,110,0,0.917471264,0.624266962,1.170500555,-0.655434338,0.462522014,0.462522014,1.170500555,0.624266962,1,0,1
5015,21,216,23,80,85,1,3341.141,54,1341.168,MORE,550,1260,1810,3,2,5,0.46870423,5,-0.698430296,0.388778996,-0.212347062,165,80,85,0,0.099725137,0,0.195083426,-0.655434338,1.060752535,1.060752535,0.195083426,0,0,0,1
5016,21,217,10,60,50,0,3487.366,64,1408.425,MORE,-1088,2392,1304,3,1,-10,-0.937408461,10,0.174607574,0.836079855,-0.125237984,110,60,50,1,-0.997251374,-0.780333703,-1.170500555,-0.655434338,-1.051104349,1.051104349,-1.170500555,-0.780333703,1,0,0
5017,21,218,19,41,50,1,2448.685,74,1021.188,MORE,244,868,1112,3,2,9,0.843667615,9,0,1.283380714,-0.744000472,91,41,50,0,-1.376206896,-1.521650721,-1.170500555,-0.655434338,0.66622982,0.66622982,-1.170500555,-1.521650721,1,0,1
5018,21,219,56,110,96,0,1741.28,74,1381.537,MORE,-482,1012,530,2,1,-14,-1.312371845,14,0.87303787,1.283380714,-1.165415399,206,110,96,1,0.917471264,1.170500555,0.624266962,-1.174590249,-0.269794659,0.269794659,0.624266962,1.170500555,1,0,0
5019,21,220,35,72,80,1,2125.919,64,1122.591,MORE,570,734,1304,3,2,8,0.749926769,8,-0.174607574,0.836079855,-0.936278461,152,72,80,0,-0.15956022,-0.312133481,0,-0.655434338,1.086538333,1.086538333,0,-0.312133481,1,0,1
5020,21,221,11,49,50,0,2296.95,40,1954.714,MORE,-134,1426,1292,5,2,1,0.093740846,1,-1.396860592,-0.237442206,-0.834391965,99,49,50,0,-1.216646676,-1.20951724,-1.170500555,0.382877485,0.178878232,0.178878232,-1.170500555,-1.20951724,0,1,0
5021,21,222,17,43,50,0,3825.649,14,1836.194,MORE,-1414,2912,1498,7,1,7,0.656185922,7,-0.349215148,-1.400424439,0.076283784,93,43,50,0,-1.336316841,-1.443617351,-1.170500555,1.421189307,-1.471412861,1.471412861,-1.170500555,-1.443617351,0,1,0
5022,21,223,1,51,50,0,6548.938,14,1744.266,MORE,-1398,3766,2368,8,1,-1,-0.093740846,1,-1.396860592,-1.400424439,1.698600047,101,51,50,1,-1.176756621,-1.131483869,-1.170500555,1.940345219,-1.450784223,1.450784223,-1.170500555,-1.131483869,0,1,0
5023,21,224,41,112,110,1,3613.055,74,965.925,MORE,528,1364,1892,5,2,-2,-0.187481692,2,-1.222253018,1.283380714,-0.0503626,222,112,110,1,1.236591704,1.248533925,1.170500555,0.382877485,1.032388157,1.032388157,1.170500555,1.248533925,1,1,1
5024,21,225,20,40,50,1,1967.491,44,1007.561,MORE,288,700,988,3,2,10,0.937408461,10,0.174607574,-0.058521862,-1.030657104,90,40,50,0,-1.396151924,-1.560667406,-1.170500555,-0.655434338,0.722958577,0.722958577,-1.170500555,-1.560667406,0,0,1
5025,21,226,1,50,51,1,8515.563,14,1267.44,MORE,-768,4086,3318,9,1,1,0.093740846,1,-1.396860592,-1.400424439,2.870156837,101,50,51,0,-1.176756621,-1.170500555,-1.131483869,2.45950113,-0.638531575,0.638531575,-1.131483869,-1.170500555,0,1,0
5026,21,227,23,85,80,1,4615.47,64,956.997,MORE,-302,2230,1928,5,2,-5,-0.46870423,5,-0.698430296,0.836079855,0.546795526,165,85,80,1,0.099725137,0.195083426,0,0.382877485,-0.037722474,0.037722474,0,0.195083426,1,1,0
5027,21,228,11,50,49,0,1932.855,4,1128.198,MORE,-1154,1788,634,2,1,-1,-0.093740846,1,-1.396860592,-1.847725297,-1.051290443,99,50,49,1,-1.216646676,-1.170500555,-1.20951724,-1.174590249,-1.136197483,1.136197483,-1.20951724,-1.170500555,0,0,0
5028,21,229,17,50,43,1,2072.021,60,1396.505,MORE,104,796,900,3,2,-7,-0.656185922,7,-0.349215148,0.657159512,-0.968386548,93,50,43,1,-1.336316841,-1.170500555,-1.443617351,-0.655434338,0.485729232,0.485729232,-1.443617351,-1.170500555,1,0,1
5029,21,230,21,80,82,1,4164.697,34,1472.274,MORE,558,1534,2092,7,2,2,0.187481692,2,-1.222253018,-0.505822721,0.278261276,162,80,82,0,0.039890055,0,0.07803337,1.421189307,1.071066854,1.071066854,0.07803337,0,0,1,1
5030,21,231,10,50,60,1,2067.636,64,901.723,MORE,460,682,1142,3,2,10,0.937408461,10,0.174607574,0.836079855,-0.970998778,110,50,60,0,-0.997251374,-1.170500555,-0.780333703,-0.655434338,0.944716442,0.944716442,-0.780333703,-1.170500555,1,0,1
5031,21,232,3,53,50,1,8965.785,14,1176.3,MORE,-400,4328,3928,12,1,-3,-0.281222538,3,-1.047645444,-1.400424439,3.138362846,103,53,50,1,-1.136866566,-1.053450499,-1.170500555,4.016968864,-0.164072886,0.164072886,-1.170500555,-1.053450499,0,1,0
5032,21,233,45,122,110,0,1657.823,54,1038.049,MORE,-520,970,450,2,1,-12,-1.124890153,12,0.523822722,0.388778996,-1.215132359,232,122,110,1,1.436041979,1.638700776,1.170500555,-1.174590249,-0.318787676,0.318787676,1.170500555,1.638700776,0,0,0
5033,21,234,38,67,80,1,4773.458,54,1002.345,MORE,784,1756,2540,7,2,13,1.218630999,13,0.698430296,0.388778996,0.640912053,147,67,80,0,-0.259285357,-0.507216907,0,1.421189307,1.362446375,1.362446375,0,-0.507216907,0,1,1
5034,21,235,38,80,67,0,1700.826,64,790.106,MORE,-492,1014,522,2,1,-13,-1.218630999,13,0.698430296,0.836079855,-1.189514635,147,80,67,1,-0.259285357,0,-0.507216907,-1.174590249,-0.282687558,0.282687558,-0.507216907,0,1,0,0
5035,21,236,36,70,80,1,1956.149,50,1364.26,MORE,-100,1068,968,3,1,10,0.937408461,10,0.174607574,0.209858653,-1.037413754,150,70,80,0,-0.199450275,-0.390166852,0,-0.655434338,0.222714089,0.222714089,0,-0.390166852,0,0,0
5036,21,237,45,110,122,1,2339.862,84,852.632,MORE,642,964,1606,3,2,12,1.124890153,12,0.523822722,1.730681573,-0.808828451,232,110,122,0,1.436041979,1.170500555,1.638700776,-0.655434338,1.179367207,1.179367207,1.638700776,1.170500555,1,0,1
5037,21,238,42,110,115,1,2296.298,74,1862.313,MORE,928,1168,2096,3,1,5,0.46870423,5,-0.698430296,1.283380714,-0.834780374,225,110,115,0,1.296426786,1.170500555,1.36558398,-0.655434338,1.548104123,1.548104123,1.36558398,1.170500555,1,0,1
5038,21,239,41,110,112,1,2008.652,74,1301.031,MORE,264,750,1014,3,2,2,0.187481692,2,-1.222253018,1.283380714,-1.006136695,222,110,112,0,1.236591704,1.170500555,1.248533925,-0.655434338,0.692015619,0.692015619,1.248533925,1.170500555,1,0,1
5039,21,240,53,110,103,0,3618.108,60,1601.589,MORE,206,1654,1860,5,2,-7,-0.656185922,7,-0.349215148,0.657159512,-0.04735243,213,110,103,1,1.057086457,1.170500555,0.897383758,0.382877485,0.617236804,0.617236804,0.897383758,1.170500555,1,1,1
5040,22,1,49,110,131,1,4537.993,70,3246.516,MORE,1724,1238,2962,3,2,21,1.968557767,21,2.095290887,1.344587848,0.884557059,241,110,131,0,1.615547226,1.170500555,1.989850943,0.044564177,1.794504843,1.794504843,1.989850943,1.170500555,1,1,1
5041,22,2,13,47,50,1,2586.963,80,1570.013,MORE,652,662,1314,3,2,3,0.281222538,3,-1.047645444,1.899057063,-0.179643296,97,47,50,0,-1.256536731,-1.28755061,-1.170500555,0.044564177,0.680532711,0.680532711,-1.170500555,-1.28755061,1,1,1
5042,22,3,16,50,44,1,3177.974,60,1273.395,MORE,1274,906,2180,3,2,-6,-0.562445076,6,-0.523822722,0.790118632,0.142726998,94,50,44,1,-1.316371814,-1.170500555,-1.404600665,0.044564177,1.326885944,1.326885944,-1.404600665,-1.170500555,1,1,1
5043,22,4,7,57,50,0,1960.35,50,1549.136,MORE,-1128,1826,698,2,1,-7,-0.656185922,7,-0.349215148,0.235649417,-0.521432904,107,57,50,1,-1.057086457,-0.897383758,-1.170500555,-0.66846265,-1.169159822,1.169159822,-1.170500555,-0.897383758,0,0,0
5044,22,5,18,42,50,1,1274.41,90,1106.202,MORE,692,268,960,1,2,8,0.749926769,8,-0.174607574,2.453526279,-0.895582759,92,42,50,0,-1.356261869,-1.482634036,-1.170500555,-1.381489476,0.722098835,0.722098835,-1.170500555,-1.482634036,1,0,1
5045,22,6,51,108,110,0,1644.567,30,1791.91,MORE,-1090,1630,540,2,1,2,0.187481692,2,-1.222253018,-0.873289014,-0.693678528,218,108,110,0,1.156811594,1.092467184,1.170500555,-0.66846265,-1.129672004,1.129672004,1.170500555,1.092467184,0,0,0
5046,22,7,31,78,80,1,3871.098,50,1624.638,MORE,304,1798,2102,4,1,2,0.187481692,2,-1.222253018,0.235649417,0.520795407,158,78,80,0,-0.039890055,-0.07803337,0,0.757591003,0.318907429,0.318907429,0,-0.07803337,0,1,0
5047,22,8,58,110,92,0,3338.173,50,1354.688,MORE,-1780,2744,964,4,1,-18,-1.687335229,18,1.571468165,0.235649417,0.23010845,202,110,92,1,0.837691154,1.170500555,0.468200222,0.757591003,-1.846687648,1.846687648,0.468200222,1.170500555,1,1,0
5048,22,9,12,50,48,0,2504.418,60,408.624,MORE,-596,1510,914,4,1,-2,-0.187481692,2,-1.222253018,0.790118632,-0.224667934,98,50,48,1,-1.236591704,-1.170500555,-1.248533925,0.757591003,-0.616330368,0.616330368,-1.248533925,-1.170500555,1,1,0
5049,22,10,54,110,101,0,2644.842,70,2774.653,MORE,-644,1552,908,2,1,-9,-0.843667615,9,0,1.344587848,-0.148072868,211,110,101,1,1.017196402,1.170500555,0.819350388,-0.66846265,-0.666209717,0.666209717,0.819350388,1.170500555,1,0,0
5050,22,11,14,46,50,1,2817.484,40,1420.629,MORE,1140,818,1958,3,2,4,0.374963384,4,-0.87303787,-0.318819799,-0.053904312,96,46,50,0,-1.276481759,-1.326567295,-1.170500555,0.044564177,1.187639428,1.187639428,-1.170500555,-1.326567295,0,1,1
5051,22,12,22,80,83,1,3032.704,70,1067.13,MORE,1260,904,2164,3,2,3,0.281222538,3,-1.047645444,1.344587848,0.063488655,163,80,83,0,0.059835082,0,0.117050055,0.044564177,1.312337801,1.312337801,0.117050055,0,1,1,1
5052,22,13,6,50,56,1,2405.77,50,2548.558,MORE,752,730,1482,3,2,6,0.562445076,6,-0.523822722,0.235649417,-0.278476044,106,50,56,0,-1.077031484,-1.170500555,-0.936400444,0.044564177,0.784448022,0.784448022,-0.936400444,-1.170500555,1,1,1
5053,22,14,13,50,47,1,3382.378,40,1666.152,MORE,212,1394,1606,5,2,-3,-0.281222538,3,-1.047645444,-0.318819799,0.254220317,97,50,47,1,-1.256536731,-1.170500555,-1.28755061,1.47061783,0.223305343,0.223305343,-1.28755061,-1.170500555,0,1,0
5054,22,15,46,110,124,1,2201.455,60,919.364,MORE,512,720,1232,3,2,14,1.312371845,14,0.87303787,0.790118632,-0.389920817,234,110,124,0,1.475932034,1.170500555,1.716734147,0.044564177,0.535051276,0.535051276,1.716734147,1.170500555,1,1,1
5055,22,16,27,91,80,0,1647.607,40,3452.002,MORE,-822,1292,470,2,1,-11,-1.031149307,11,0.349215148,-0.318819799,-0.692020343,171,91,80,1,0.219395302,0.429183537,0,-0.66846265,-0.851178971,0.851178971,0,0.429183537,0,0,0
5056,22,17,40,64,80,1,4088.601,40,2717.131,MORE,216,2182,2398,3,1,16,1.499853537,16,1.222253018,-0.318819799,0.639433649,144,64,80,0,-0.31912044,-0.624266962,0,0.044564177,0.227461956,0.227461956,0,-0.624266962,0,0,0
5057,22,18,22,83,80,1,13138.447,60,1860.1,MORE,1802,4828,6630,8,2,-3,-0.281222538,3,-1.047645444,0.790118632,5.575723368,163,83,80,1,0.059835082,0.117050055,0,3.609698309,1.875558786,1.875558786,0,0.117050055,1,1,1
5058,22,19,54,101,110,0,1937.222,70,1110.566,MORE,-584,1166,582,2,1,9,0.843667615,9,0,1.344587848,-0.534048202,211,101,110,0,1.017196402,0.819350388,1.170500555,-0.66846265,-0.603860531,0.603860531,1.170500555,0.819350388,1,0,0
5059,22,20,6,56,50,1,1213.214,90,1690.661,MORE,1138,366,1504,1,2,-6,-0.562445076,6,-0.523822722,2.453526279,-0.928962463,106,56,50,1,-1.077031484,-0.936400444,-1.170500555,-1.381489476,1.185561122,1.185561122,-1.170500555,-0.936400444,1,0,1
5060,22,21,18,50,42,1,1389.508,50,2091.261,MORE,590,382,972,1,2,-8,-0.749926769,8,-0.174607574,0.235649417,-0.832801903,92,50,42,1,-1.356261869,-1.170500555,-1.482634036,-1.381489476,0.616105218,0.616105218,-1.482634036,-1.170500555,1,0,1
5061,22,22,43,110,117,1,3259.071,50,1801.941,MORE,432,1322,1754,3,2,7,0.656185922,7,-0.349215148,0.235649417,0.186961816,227,110,117,0,1.336316841,1.170500555,1.443617351,0.044564177,0.451919027,0.451919027,1.443617351,1.170500555,1,1,1
5062,22,23,32,77,80,1,1555.173,70,1299.765,MORE,672,400,1072,1,2,3,0.281222538,3,-1.047645444,1.344587848,-0.742438991,157,77,80,0,-0.059835082,-0.117050055,0,-1.381489476,0.701315773,0.701315773,0,-0.117050055,1,0,1
5063,22,24,27,80,91,1,5069.976,50,1390.35,MORE,428,2036,2464,3,2,11,1.031149307,11,0.349215148,0.235649417,1.174730197,171,80,91,0,0.219395302,0,0.429183537,0.044564177,0.447762415,0.447762415,0.429183537,0,1,1,1
5064,22,25,16,44,50,1,1336.313,50,3284.991,MORE,616,330,946,1,2,6,0.562445076,6,-0.523822722,0.235649417,-0.861817417,94,44,50,0,-1.316371814,-1.404600665,-1.170500555,-1.381489476,0.643123199,0.643123199,-1.170500555,-1.404600665,1,0,1
5065,22,26,7,50,57,1,1182.444,80,2358.155,MORE,336,386,722,1,2,7,0.656185922,7,-0.349215148,1.899057063,-0.945746134,107,50,57,0,-1.057086457,-1.170500555,-0.897383758,-1.381489476,0.352160329,0.352160329,-0.897383758,-1.170500555,1,0,1
5066,22,27,14,50,46,1,1338.95,90,1065.634,MORE,1082,364,1446,1,2,-4,-0.374963384,4,-0.87303787,2.453526279,-0.86037905,96,50,46,1,-1.276481759,-1.170500555,-1.326567295,-1.381489476,1.127368548,1.127368548,-1.326567295,-1.170500555,1,0,1
5067,22,28,51,110,108,0,1862.513,70,1229.999,MORE,-768,1350,582,2,1,-2,-0.187481692,2,-1.222253018,1.344587848,-0.574798649,218,110,108,1,1.156811594,1.170500555,1.092467184,-0.66846265,-0.795064703,0.795064703,1.092467184,1.170500555,1,0,0
5068,22,29,50,133,110,0,2617.658,60,1839.808,MORE,-576,1536,960,4,1,-23,-2.15603946,23,2.444506035,0.790118632,-0.162900535,243,133,110,1,1.655437281,2.067884313,1.170500555,0.757591003,-0.595547306,0.595547306,1.170500555,2.067884313,1,1,0
5069,22,30,49,131,110,1,4142.725,40,2182.558,MORE,-402,2520,2118,6,1,-21,-1.968557767,21,2.095290887,-0.318819799,0.668955891,241,131,110,1,1.615547226,1.989850943,1.170500555,2.183644656,-0.414734665,0.414734665,1.170500555,1.989850943,0,1,0
5070,22,31,47,126,110,1,1432.219,70,1293.419,MORE,642,364,1006,1,2,-16,-1.499853537,16,1.222253018,1.344587848,-0.809504947,236,126,110,1,1.515822089,1.794767517,1.170500555,-1.381489476,0.67014118,0.67014118,1.170500555,1.794767517,1,0,1
5071,22,32,50,110,133,1,3548.336,50,1366.234,MORE,1534,810,2344,3,2,23,2.15603946,23,2.444506035,0.235649417,0.344743047,243,110,133,0,1.655437281,1.170500555,2.067884313,0.044564177,1.597065752,1.597065752,2.067884313,1.170500555,1,1,1
5072,22,33,47,110,126,1,2776.543,70,1450.821,MORE,682,1220,1902,3,2,16,1.499853537,16,1.222253018,1.344587848,-0.076235813,236,110,126,0,1.515822089,1.170500555,1.794767517,0.044564177,0.711707304,0.711707304,1.794767517,1.170500555,1,1,1
5073,22,34,12,48,50,1,4499.653,30,1680.095,MORE,686,1972,2658,4,1,2,0.187481692,2,-1.222253018,-0.873289014,0.863644289,98,48,50,0,-1.236591704,-1.248533925,-1.170500555,0.757591003,0.715863917,0.715863917,-1.170500555,-1.248533925,0,1,1
5074,22,35,32,80,77,1,2747.788,60,1649.968,MORE,-262,1320,1058,3,2,-3,-0.281222538,3,-1.047645444,0.790118632,-0.09192039,157,80,77,1,-0.059835082,0,-0.117050055,0.044564177,-0.26925323,0.26925323,-0.117050055,0,1,1,0
5075,22,36,43,117,110,0,2167.218,80,946.009,MORE,-482,1204,722,2,1,-7,-0.656185922,7,-0.349215148,1.899057063,-0.408595582,227,117,110,1,1.336316841,1.443617351,1.170500555,-0.66846265,-0.497866914,0.497866914,1.170500555,1.443617351,1,0,0
5076,22,37,40,80,64,0,4105.584,60,1653.956,MORE,-850,2302,1452,4,1,-16,-1.499853537,16,1.222253018,0.790118632,0.648697123,144,80,64,1,-0.31912044,0,-0.624266962,0.757591003,-0.880275258,0.880275258,-0.624266962,0,1,1,0
5077,22,38,31,80,78,1,2361.564,40,1975.729,MORE,436,1082,1518,3,1,-2,-0.187481692,2,-1.222253018,-0.318819799,-0.302588457,158,80,78,1,-0.039890055,0,-0.07803337,0.044564177,0.45607564,0.45607564,-0.07803337,0,0,1,1
5078,22,39,46,124,110,0,1730.479,80,852.608,MORE,-750,1208,458,2,1,-14,-1.312371845,14,0.87303787,1.899057063,-0.646817342,234,124,110,1,1.475932034,1.716734147,1.170500555,-0.66846265,-0.776359947,0.776359947,1.170500555,1.716734147,1,0,0
5079,22,40,58,92,110,1,2481.226,60,1204.994,MORE,-2366,3762,1396,3,1,18,1.687335229,18,1.571468165,0.790118632,-0.237318142,202,92,110,0,0.837691154,0.468200222,1.170500555,0.044564177,-2.45563137,2.45563137,1.170500555,0.468200222,1,1,0
5080,22,41,49,110,131,0,2639.121,60,2346.203,LESS,-1034,1804,770,3,1,21,1.968557767,21,2.095290887,0.790118632,-0.15119342,241,110,131,1,1.615547226,1.170500555,1.989850943,0.044564177,-1.07147943,1.07147943,1.989850943,1.170500555,1,0,0
5081,22,42,13,47,50,1,3490.418,40,1839.189,LESS,134,1458,1592,3,1,3,0.281222538,3,-1.047645444,-0.318819799,0.313151346,97,47,50,1,-1.256536731,-1.28755061,-1.170500555,0.044564177,0.142251401,0.142251401,-1.170500555,-1.28755061,1,0,1
5082,22,43,16,50,44,1,3392.99,60,2237.885,LESS,872,1208,2080,5,2,-6,-0.562445076,6,-0.523822722,0.790118632,0.260008692,94,50,44,0,-1.316371814,-1.170500555,-1.404600665,1.47061783,0.909146395,0.909146395,-1.404600665,-1.170500555,1,1,1
5083,22,44,7,57,50,1,2362.167,50,2778.997,LESS,610,830,1440,3,2,-7,-0.656185922,7,-0.349215148,0.235649417,-0.302259547,107,57,50,0,-1.057086457,-0.897383758,-1.170500555,0.044564177,0.63688828,0.63688828,-1.170500555,-0.897383758,1,0,1
5084,22,45,18,42,50,0,7480.396,30,2342.487,LESS,-938,3220,2282,4,1,8,0.749926769,8,-0.174607574,-0.873289014,2.489507428,92,42,50,1,-1.356261869,-1.482634036,-1.170500555,0.757591003,-0.971720731,0.971720731,-1.170500555,-1.482634036,0,1,0
5085,22,46,51,108,110,0,4304.928,30,959.45,LESS,994,1424,2418,4,1,2,0.187481692,2,-1.222253018,-0.873289014,0.757430436,218,108,110,1,1.156811594,1.092467184,1.170500555,0.757591003,1.035923074,1.035923074,1.170500555,1.092467184,0,1,1
5086,22,47,31,78,80,0,1333.413,70,1066.696,LESS,-452,842,390,2,1,2,0.187481692,2,-1.222253018,1.344587848,-0.863399238,158,78,80,1,-0.039890055,-0.07803337,0,-0.66846265,-0.466692321,0.466692321,0,-0.07803337,1,0,0
5087,22,48,58,110,92,1,1699.346,50,1136.87,LESS,374,540,914,3,2,-18,-1.687335229,18,1.571468165,0.235649417,-0.663799013,202,110,92,0,0.837691154,1.170500555,0.468200222,0.044564177,0.391648147,0.391648147,0.468200222,1.170500555,1,0,1
5088,22,49,12,50,48,0,1330.119,40,1302.753,LESS,-460,856,396,2,1,-2,-0.187481692,2,-1.222253018,-0.318819799,-0.865195969,98,50,48,0,-1.236591704,-1.170500555,-1.248533925,-0.66846265,-0.475005545,0.475005545,-1.248533925,-1.170500555,1,0,0
5089,22,50,54,110,101,1,1991.938,40,1605.699,LESS,416,644,1060,3,2,-9,-0.843667615,9,0,-0.318819799,-0.50420305,211,110,101,0,1.017196402,1.170500555,0.819350388,0.044564177,0.435292577,0.435292577,0.819350388,1.170500555,0,0,1
5090,22,51,14,46,50,0,2734.698,30,1120.65,LESS,-94,1226,1132,4,1,4,0.374963384,4,-0.87303787,-0.873289014,-0.099060405,96,46,50,1,-1.276481759,-1.326567295,-1.170500555,0.757591003,-0.094675508,0.094675508,-1.170500555,-1.326567295,0,1,1
5091,22,52,22,80,83,0,5612.598,60,1140.702,LESS,66,2426,2492,5,1,3,0.281222538,3,-1.047645444,0.790118632,1.470706438,163,80,83,1,0.059835082,0,0.117050055,1.47061783,0.07158899,0.07158899,0.117050055,0,1,1,1
5092,22,53,6,50,56,1,3874.569,60,1039.634,LESS,950,1240,2190,5,2,6,0.562445076,6,-0.523822722,0.790118632,0.522688683,106,50,56,1,-1.077031484,-1.170500555,-0.936400444,1.47061783,0.990200337,0.990200337,-0.936400444,-1.170500555,1,1,1
5093,22,54,13,50,47,1,5428.564,30,908.975,LESS,2224,1300,3524,5,2,-3,-0.281222538,3,-1.047645444,-0.873289014,1.370324051,97,50,47,0,-1.256536731,-1.170500555,-1.28755061,1.47061783,2.314081397,2.314081397,-1.28755061,-1.170500555,0,1,1
5094,22,55,46,110,124,0,2538.829,30,1212.215,LESS,-512,1476,964,4,1,14,1.312371845,14,0.87303787,-0.873289014,-0.205898259,234,110,124,1,1.475932034,1.170500555,1.716734147,0.757591003,-0.529041507,0.529041507,1.716734147,1.170500555,0,1,0
5095,22,56,27,91,80,0,3955.248,30,3813.931,LESS,-222,1946,1724,2,1,-11,-1.031149307,11,0.349215148,-0.873289014,0.566695501,171,91,80,0,0.219395302,0.429183537,0,-0.66846265,-0.227687106,0.227687106,0,0.429183537,0,0,0
5096,22,57,40,64,80,0,2049.666,50,1751.772,LESS,-554,1322,768,2,1,16,1.499853537,16,1.222253018,0.235649417,-0.472714986,144,64,80,1,-0.31912044,-0.624266962,0,-0.66846265,-0.572685938,0.572685938,0,-0.624266962,1,0,0
5097,22,58,22,83,80,1,5041.603,50,1275.494,LESS,1830,1426,3256,5,2,-3,-0.281222538,3,-1.047645444,0.235649417,1.159253984,163,83,80,0,0.059835082,0.117050055,0,1.47061783,1.904655073,1.904655073,0,0.117050055,1,1,1
5098,22,59,54,101,110,1,7011.989,50,1332.408,LESS,2504,1904,4408,7,2,9,0.843667615,9,0,0.235649417,2.234012179,211,101,110,1,1.017196402,0.819350388,1.170500555,2.896671483,2.605044268,2.605044268,1.170500555,0.819350388,1,1,1
5099,22,60,6,56,50,0,3595.792,40,1299.503,LESS,370,1538,1908,4,1,-6,-0.562445076,6,-0.523822722,-0.318819799,0.370628191,106,56,50,0,-1.077031484,-0.936400444,-1.170500555,0.757591003,0.387491534,0.387491534,-1.170500555,-0.936400444,0,1,1
5100,22,61,18,50,42,0,3932.313,50,1661.373,LESS,832,1222,2054,4,1,-8,-0.749926769,8,-0.174607574,0.235649417,0.554185475,92,50,42,0,-1.356261869,-1.170500555,-1.482634036,0.757591003,0.86758027,0.86758027,-1.482634036,-1.170500555,1,1,1
5101,22,62,43,110,117,0,2984.226,30,911.907,LESS,220,1292,1512,4,1,7,0.656185922,7,-0.349215148,-0.873289014,0.037046055,227,110,117,1,1.336316841,1.170500555,1.443617351,0.757591003,0.231618568,0.231618568,1.443617351,1.170500555,0,1,1
5102,22,63,32,77,80,0,8796.809,40,1426.425,LESS,-1236,4620,3384,8,1,3,0.281222538,3,-1.047645444,-0.318819799,3.207552349,157,77,80,1,-0.059835082,-0.117050055,0,3.609698309,-1.281388357,1.281388357,0,-0.117050055,1,1,0
5103,22,64,27,80,91,0,3577.746,20,3608.196,LESS,-584,1870,1286,4,1,11,1.031149307,11,0.349215148,-1.42775823,0.360784898,171,80,91,1,0.219395302,0,0.429183537,0.757591003,-0.603860531,0.603860531,0.429183537,0,0,1,0
5104,22,65,16,44,50,0,3110.577,40,1635.379,LESS,-1456,2422,966,4,1,6,0.562445076,6,-0.523822722,-0.318819799,0.105964923,94,44,50,1,-1.316371814,-1.404600665,-1.170500555,0.757591003,-1.510002041,1.510002041,-1.170500555,-1.404600665,0,1,0
5105,22,66,7,50,57,0,3619.106,30,1334.321,LESS,-184,1386,1202,4,1,7,0.656185922,7,-0.349215148,-0.873289014,0.383344944,107,50,57,1,-1.057086457,-1.170500555,-0.897383758,0.757591003,-0.188199288,0.188199288,-0.897383758,-1.170500555,0,1,1
5106,22,67,14,50,46,0,3170.632,40,1404.34,LESS,-42,1368,1326,3,1,-4,-0.374963384,4,-0.87303787,-0.318819799,0.138722263,96,50,46,0,-1.276481759,-1.170500555,-1.326567295,0.044564177,-0.040639546,0.040639546,-1.326567295,-1.170500555,1,0,1
5107,22,68,51,110,108,0,8489.945,40,1693.886,LESS,-12,3814,3802,7,1,-2,-0.187481692,2,-1.222253018,-0.318819799,3.040171644,218,110,108,0,1.156811594,1.170500555,1.092467184,2.896671483,-0.009464953,0.009464953,1.092467184,1.170500555,1,1,1
5108,22,69,50,133,110,0,5555.579,20,957.078,LESS,-130,2906,2776,4,1,-23,-2.15603946,23,2.444506035,-1.42775823,1.439605102,243,133,110,0,1.655437281,2.067884313,1.170500555,0.757591003,-0.13208502,0.13208502,1.170500555,2.067884313,0,1,1
5109,22,70,49,131,110,1,4811.767,50,1741.288,LESS,2940,836,3776,3,1,-21,-1.968557767,21,2.095290887,0.235649417,1.033888637,241,131,110,0,1.615547226,1.989850943,1.170500555,0.044564177,3.058115023,3.058115023,1.170500555,1.989850943,1,1,1
5110,22,71,47,126,110,1,5486.553,30,1343.002,LESS,2540,1242,3782,5,2,-16,-1.499853537,16,1.222253018,-0.873289014,1.401954479,236,126,110,0,1.515822089,1.794767517,1.170500555,1.47061783,2.642453779,2.642453779,1.170500555,1.794767517,0,1,1
5111,22,72,50,110,133,0,3947.918,20,1303.102,LESS,638,1650,2288,4,1,23,2.15603946,23,2.444506035,-1.42775823,0.562697311,243,110,133,1,1.655437281,1.170500555,2.067884313,0.757591003,0.665984567,0.665984567,2.067884313,1.170500555,0,1,1
5112,22,73,47,110,126,0,3060.958,70,428.675,LESS,-420,1720,1300,4,1,16,1.499853537,16,1.222253018,1.344587848,0.078899959,236,110,126,1,1.515822089,1.170500555,1.794767517,0.757591003,-0.433439421,0.433439421,1.794767517,1.170500555,1,1,0
5113,22,74,12,48,50,0,3290.588,40,1715.911,LESS,236,1472,1708,4,1,2,0.187481692,2,-1.222253018,-0.318819799,0.204152942,98,48,50,1,-1.236591704,-1.248533925,-1.170500555,0.757591003,0.248245018,0.248245018,-1.170500555,-1.248533925,1,1,1
5114,22,75,32,80,77,0,4984.029,20,1103.285,LESS,944,2112,3056,4,1,-3,-0.281222538,3,-1.047645444,-1.42775823,1.12784992,157,80,77,0,-0.059835082,0,-0.117050055,0.757591003,0.983965419,0.983965419,-0.117050055,0,0,1,1
5115,22,76,43,117,110,0,2396.927,30,1533.746,LESS,-692,1496,804,4,1,-7,-0.656185922,7,-0.349215148,-0.873289014,-0.283299508,227,117,110,0,1.336316841,1.443617351,1.170500555,0.757591003,-0.716089067,0.716089067,1.170500555,1.443617351,0,1,0
5116,22,77,40,80,64,0,3058.846,30,2212.065,LESS,-1078,2022,944,4,1,-16,-1.499853537,16,1.222253018,-0.873289014,0.077747957,144,80,64,0,-0.31912044,0,-0.624266962,0.757591003,-1.117202166,1.117202166,-0.624266962,0,0,1,0
5117,22,78,31,80,78,1,1775.493,20,1708.242,LESS,516,676,1192,2,1,-2,-0.187481692,2,-1.222253018,-1.42775823,-0.622264201,158,80,78,0,-0.039890055,0,-0.07803337,-0.66846265,0.539207888,0.539207888,-0.07803337,0,0,0,1
5118,22,79,46,124,110,1,1901.146,10,1293.437,LESS,-878,1628,750,2,1,-14,-1.312371845,14,0.87303787,-1.982227445,-0.553726061,234,124,110,0,1.475932034,1.716734147,1.170500555,-0.66846265,-0.909371545,0.909371545,1.170500555,1.716734147,0,0,0
5119,22,80,58,92,110,0,4069.328,20,1564.868,LESS,-1070,3396,2326,4,1,18,1.687335229,18,1.571468165,-1.42775823,0.628921082,202,92,110,1,0.837691154,0.468200222,1.170500555,0.757591003,-1.108888941,1.108888941,1.170500555,0.468200222,0,1,0
5120,22,81,48,128,110,1,2832.425,20,1239.022,MORE,-1436,2356,920,3,1,-18,-1.687335229,18,1.571468165,-1.42775823,-0.045754659,238,128,110,1,1.555712144,1.872800887,1.170500555,0.044564177,-1.489218979,1.489218979,1.170500555,1.872800887,0,1,0
5121,22,82,8,50,58,1,1245.847,80,1671.621,MORE,550,370,920,1,2,8,0.749926769,8,-0.174607574,1.899057063,-0.911162609,108,50,58,0,-1.037141429,-1.170500555,-0.858367073,-1.381489476,0.574539094,0.574539094,-0.858367073,-1.170500555,1,0,1
5122,22,83,4,54,50,1,5351.723,10,1092.806,MORE,1186,2024,3210,5,1,-4,-0.374963384,4,-0.87303787,-1.982227445,1.328410693,104,54,50,1,-1.116921539,-1.014433814,-1.170500555,1.47061783,1.235440471,1.235440471,-1.170500555,-1.014433814,0,1,1
5123,22,84,37,80,69,0,2878.054,10,2027.686,MORE,-974,2036,1062,4,1,-11,-1.031149307,11,0.349215148,-1.982227445,-0.020866063,149,80,69,1,-0.219395302,0,-0.429183537,0.757591003,-1.009130243,1.009130243,-0.429183537,0,0,1,0
5124,22,85,52,105,110,0,5010.351,10,828.151,MORE,-1446,3212,1766,4,1,5,0.46870423,5,-0.698430296,-1.982227445,1.142207403,215,105,110,0,1.096976512,0.975417129,1.170500555,0.757591003,-1.49961051,1.49961051,1.170500555,0.975417129,0,1,0
5125,22,86,5,55,50,0,1722.535,20,1205.217,MORE,-878,1284,406,2,1,-5,-0.46870423,5,-0.698430296,-1.42775823,-0.651150441,105,55,50,1,-1.096976512,-0.975417129,-1.170500555,-0.66846265,-0.909371545,0.909371545,-1.170500555,-0.975417129,0,0,0
5126,22,87,30,96,80,0,3481.955,50,3012.848,MORE,-1650,2756,1106,2,2,-16,-1.499853537,16,1.222253018,0.235649417,0.308535155,176,96,80,1,0.31912044,0.624266962,0,-0.66846265,-1.711597744,1.711597744,0,0.624266962,1,0,0
5127,22,88,33,80,75,0,3005.074,50,1203.574,MORE,1030,1136,2166,1,1,-5,-0.46870423,5,-0.698430296,0.235649417,0.048417715,155,80,75,1,-0.099725137,0,-0.195083426,-1.381489476,1.073332586,1.073332586,-0.195083426,0,1,0,1
5128,22,89,48,110,128,1,2443.694,60,1315.171,MORE,26,1146,1172,3,2,18,1.687335229,18,1.571468165,0.790118632,-0.257790183,238,110,128,0,1.555712144,1.170500555,1.872800887,0.044564177,0.030022865,0.030022865,1.872800887,1.170500555,1,1,0
5129,22,90,9,59,50,1,1336.958,50,1300.486,MORE,756,290,1046,1,2,-9,-0.843667615,9,0,0.235649417,-0.861465598,109,59,50,1,-1.017196402,-0.819350388,-1.170500555,-1.381489476,0.788604634,0.788604634,-1.170500555,-0.819350388,1,0,1
5130,22,91,44,110,119,1,1867.874,70,1688.123,MORE,90,864,954,1,2,9,0.843667615,9,0,1.344587848,-0.571874461,229,110,119,0,1.376206896,1.170500555,1.521650721,-1.381489476,0.096528664,0.096528664,1.521650721,1.170500555,1,0,0
5131,22,92,2,52,50,0,2857.047,50,1399.059,MORE,-346,1490,1144,3,1,-2,-0.187481692,2,-1.222253018,0.235649417,-0.03232445,102,52,50,1,-1.156811594,-1.092467184,-1.170500555,0.044564177,-0.356542091,0.356542091,-1.170500555,-1.092467184,1,1,0
5132,22,93,8,58,50,1,1027.907,70,1590.191,MORE,328,320,648,1,2,-8,-0.749926769,8,-0.174607574,1.344587848,-1.030039215,108,58,50,1,-1.037141429,-0.858367073,-1.170500555,-1.381489476,0.343847104,0.343847104,-1.170500555,-0.858367073,1,0,1
5133,22,94,44,119,110,0,2047.906,50,1366.377,MORE,-358,1118,760,2,1,-9,-0.843667615,9,0,0.235649417,-0.473674988,229,119,110,1,1.376206896,1.521650721,1.170500555,-0.66846265,-0.369011928,0.369011928,1.170500555,1.521650721,0,0,0
5134,22,95,34,74,80,1,2419.123,40,1667.669,MORE,1360,800,2160,1,1,6,0.562445076,6,-0.523822722,-0.318819799,-0.271192574,154,74,80,0,-0.119670165,-0.234100111,0,-1.381489476,1.416253112,1.416253112,0,-0.234100111,0,0,1
5135,22,96,24,86,80,1,1235.95,70,1497.228,MORE,740,338,1078,1,2,-6,-0.562445076,6,-0.523822722,1.344587848,-0.916560983,166,86,80,1,0.119670165,0.234100111,0,-1.381489476,0.771978185,0.771978185,0,0.234100111,1,0,1
5136,22,97,39,66,80,1,1568.838,40,2995.934,MORE,106,914,1020,3,1,14,1.312371845,14,0.87303787,-0.318819799,-0.73498534,146,66,80,0,-0.279230385,-0.546233592,0,0.044564177,0.113155114,0.113155114,0,-0.546233592,0,1,0
5137,22,98,9,50,59,1,3832.769,40,1208.216,MORE,34,1694,1728,5,2,9,0.843667615,9,0,-0.318819799,0.499888637,109,50,59,0,-1.017196402,-1.170500555,-0.819350388,1.47061783,0.03833609,0.03833609,-0.819350388,-1.170500555,0,1,0
5138,22,99,57,94,110,1,4459.989,40,1516.186,MORE,842,1764,2606,3,1,16,1.499853537,16,1.222253018,-0.318819799,0.842009336,204,94,110,0,0.877581209,0.546233592,1.170500555,0.044564177,0.877971802,0.877971802,1.170500555,0.546233592,0,1,1
5139,22,100,60,110,87,0,1727.036,40,1651.41,MORE,-998,1416,418,2,1,-23,-2.15603946,23,2.444506035,-0.318819799,-0.648695345,197,110,87,1,0.737966017,1.170500555,0.273116796,-0.66846265,-1.034069918,1.034069918,0.273116796,1.170500555,0,0,0
5140,22,101,33,75,80,1,1045.908,70,1606.779,MORE,518,260,778,1,2,5,0.46870423,5,-0.698430296,1.344587848,-1.020220468,155,75,80,0,-0.099725137,-0.195083426,0,-1.381489476,0.541286194,0.541286194,0,-0.195083426,1,0,1
5141,22,102,15,50,45,0,2923.584,40,1640.848,MORE,-424,1652,1228,4,1,-5,-0.46870423,5,-0.698430296,-0.318819799,0.003968533,95,50,45,1,-1.296426786,-1.170500555,-1.36558398,0.757591003,-0.437596034,0.437596034,-1.36558398,-1.170500555,0,1,0
5142,22,103,59,89,110,0,1735.928,30,1124.592,MORE,-692,1154,462,2,1,21,1.968557767,21,2.095290887,-0.873289014,-0.643845154,199,89,110,0,0.777856072,0.351150166,1.170500555,-0.66846265,-0.716089067,0.716089067,1.170500555,0.351150166,0,0,0
5143,22,104,29,80,94,1,1715.623,30,1625.097,MORE,308,602,910,3,2,14,1.312371845,14,0.87303787,-0.873289014,-0.654920631,174,80,94,0,0.279230385,0,0.546233592,0.044564177,0.323064042,0.323064042,0.546233592,0,0,1,0
5144,22,105,55,110,98,0,1720.248,70,2429.166,MORE,-1208,1692,484,2,1,-12,-1.124890153,12,0.523822722,1.344587848,-0.652397898,208,110,98,1,0.957361319,1.170500555,0.702300333,-0.66846265,-1.25229207,1.25229207,0.702300333,1.170500555,1,0,0
5145,22,106,29,94,80,0,3814.193,30,1365.626,MORE,-1458,2940,1482,4,1,-14,-1.312371845,14,0.87303787,-0.873289014,0.489756253,174,94,80,1,0.279230385,0.546233592,0,0.757591003,-1.512080347,1.512080347,0,0.546233592,0,1,0
5146,22,107,57,110,94,0,3350.17,40,1587.068,MORE,-1330,2182,852,4,1,-16,-1.499853537,16,1.222253018,-0.318819799,0.236652281,204,110,94,1,0.877581209,1.170500555,0.546233592,0.757591003,-1.37906875,1.37906875,0.546233592,1.170500555,0,1,0
5147,22,108,39,80,66,1,1875.777,50,1659.753,MORE,312,814,1126,3,2,-14,-1.312371845,14,0.87303787,0.235649417,-0.567563725,146,80,66,1,-0.279230385,0,-0.546233592,0.044564177,0.327220654,0.327220654,-0.546233592,0,0,1,0
5148,22,109,4,50,54,1,1258.058,50,1660.313,MORE,698,150,848,1,2,4,0.374963384,4,-0.87303787,0.235649417,-0.90450205,104,50,54,0,-1.116921539,-1.170500555,-1.014433814,-1.381489476,0.728333754,0.728333754,-1.014433814,-1.170500555,0,0,1
5149,22,110,55,98,110,1,3335.248,30,1242.509,MORE,440,1318,1758,5,2,12,1.124890153,12,0.523822722,-0.873289014,0.228512992,208,98,110,0,0.957361319,0.702300333,1.170500555,1.47061783,0.460232252,0.460232252,1.170500555,0.702300333,0,1,1
5150,22,111,2,50,52,0,4384.725,30,1001.032,MORE,350,1890,2240,2,1,2,0.187481692,2,-1.222253018,-0.873289014,0.800956161,102,50,52,0,-1.156811594,-1.170500555,-1.092467184,-0.66846265,0.366708472,0.366708472,-1.092467184,-1.170500555,0,0,1
5151,22,112,59,110,89,0,1283.15,70,2335.275,MORE,-838,1132,294,2,1,-21,-1.968557767,21,2.095290887,1.344587848,-0.890815476,199,110,89,1,0.777856072,1.170500555,0.351150166,-0.66846265,-0.86780542,0.86780542,0.351150166,1.170500555,1,0,0
5152,22,113,60,87,110,1,1904.111,50,3840.452,MORE,-546,1580,1034,3,1,23,2.15603946,23,2.444506035,0.235649417,-0.552108784,197,87,110,0,0.737966017,0.273116796,1.170500555,0.044564177,-0.564372713,0.564372713,1.170500555,0.273116796,0,1,0
5153,22,114,52,110,105,0,1966.821,50,1953.075,MORE,-938,1404,466,2,1,-5,-0.46870423,5,-0.698430296,0.235649417,-0.51790326,215,110,105,1,1.096976512,1.170500555,0.975417129,-0.66846265,-0.971720731,0.971720731,0.975417129,1.170500555,0,0,0
5154,22,115,30,80,96,0,14660.622,30,2065.717,MORE,-268,6470,6202,9,1,16,1.499853537,16,1.222253018,-0.873289014,6.406002336,176,80,96,0,0.31912044,0,0.624266962,4.322725136,-0.275488149,0.275488149,0.624266962,0,0,1,0
5155,22,116,24,80,86,1,2734.725,60,1092.646,MORE,1102,622,1724,3,2,6,0.562445076,6,-0.523822722,0.790118632,-0.099045677,166,80,86,0,0.119670165,0,0.234100111,0.044564177,1.14815161,1.14815161,0.234100111,0,1,1,1
5156,22,117,5,50,55,1,2675.513,50,2173.566,MORE,-206,1874,1668,3,1,5,0.46870423,5,-0.698430296,0.235649417,-0.131343198,105,50,55,0,-1.096976512,-1.170500555,-0.975417129,0.044564177,-0.211060656,0.211060656,-0.975417129,-1.170500555,0,1,0
5157,22,118,34,80,74,0,3280.808,50,2032.612,MORE,-884,2100,1216,4,1,-6,-0.562445076,6,-0.523822722,0.235649417,0.198818386,154,80,74,1,-0.119670165,0,-0.234100111,0.757591003,-0.915606463,0.915606463,-0.234100111,0,0,1,0
5158,22,119,15,45,50,1,1183.132,70,2395.928,MORE,102,670,772,1,1,5,0.46870423,5,-0.698430296,1.344587848,-0.94537086,95,45,50,0,-1.296426786,-1.36558398,-1.170500555,-1.381489476,0.108998501,0.108998501,-1.170500555,-1.36558398,1,0,0
5159,22,120,37,69,80,1,1136.765,50,1284.732,MORE,540,280,820,1,1,11,1.031149307,11,0.349215148,0.235649417,-0.970662003,149,69,80,0,-0.219395302,-0.429183537,0,-1.381489476,0.564147563,0.564147563,0,-0.429183537,0,0,1
5160,22,121,48,128,110,1,2543.718,20,1782.556,LESS,668,998,1666,3,1,-18,-1.687335229,18,1.571468165,-1.42775823,-0.203231526,238,128,110,0,1.555712144,1.872800887,1.170500555,0.044564177,0.697159161,0.697159161,1.170500555,1.872800887,0,1,1
5161,22,122,8,50,58,0,1651.329,70,2023.345,LESS,-192,1160,968,2,2,8,0.749926769,8,-0.174607574,1.344587848,-0.689990157,108,50,58,1,-1.037141429,-1.170500555,-0.858367073,-0.66846265,-0.196512512,0.196512512,-0.858367073,-1.170500555,1,0,0
5162,22,123,4,54,50,0,2720.714,50,1929.426,LESS,-178,1476,1298,4,1,-4,-0.374963384,4,-0.87303787,0.235649417,-0.106688057,104,54,50,0,-1.116921539,-1.014433814,-1.170500555,0.757591003,-0.181964369,0.181964369,-1.170500555,-1.014433814,1,1,1
5163,22,124,37,80,69,1,2237.718,60,1733.234,LESS,402,896,1298,3,2,-11,-1.031149307,11,0.349215148,0.790118632,-0.370140958,149,80,69,0,-0.219395302,0,-0.429183537,0.044564177,0.420744434,0.420744434,-0.429183537,0,1,1,1
5164,22,125,52,105,110,0,5937.872,40,1898.045,LESS,1132,2242,3374,6,1,5,0.46870423,5,-0.698430296,-0.318819799,1.648128982,215,105,110,1,1.096976512,0.975417129,1.170500555,2.183644656,1.179326203,1.179326203,1.170500555,0.975417129,1,1,1
5165,22,126,5,55,50,1,2074.664,50,1605.879,LESS,432,738,1170,3,1,-5,-0.46870423,5,-0.698430296,0.235649417,-0.459079685,105,55,50,0,-1.096976512,-0.975417129,-1.170500555,0.044564177,0.451919027,0.451919027,-1.170500555,-0.975417129,1,1,1
5166,22,127,30,96,80,1,1913.437,60,1779.002,LESS,76,898,974,3,2,-16,-1.499853537,16,1.222253018,0.790118632,-0.547021865,176,96,80,0,0.31912044,0.624266962,0,0.044564177,0.081980521,0.081980521,0,0.624266962,1,1,1
5167,22,128,33,80,75,1,6025.029,40,1888.792,LESS,926,2016,2942,5,2,-5,-0.46870423,5,-0.698430296,-0.318819799,1.695669261,155,80,75,0,-0.099725137,0,-0.195083426,1.47061783,0.965260663,0.965260663,-0.195083426,0,1,1,1
5168,22,129,48,110,128,0,5861.154,20,1269.105,LESS,854,2522,3376,4,1,18,1.687335229,18,1.571468165,-1.42775823,1.606282715,238,110,128,1,1.555712144,1.170500555,1.872800887,0.757591003,0.890441639,0.890441639,1.872800887,1.170500555,0,1,1
5169,22,130,9,59,50,1,3053.924,70,2595.329,LESS,1360,702,2062,3,2,-9,-0.843667615,9,0,1.344587848,0.075063224,109,59,50,0,-1.017196402,-0.819350388,-1.170500555,0.044564177,1.416253112,1.416253112,-1.170500555,-0.819350388,1,1,1
5170,22,131,44,110,119,0,5750.981,20,2394.139,LESS,-2630,4382,1752,3,1,9,0.843667615,9,0,-1.42775823,1.546188229,229,110,119,1,1.376206896,1.170500555,1.521650721,0.044564177,-2.72996779,2.72996779,1.521650721,1.170500555,0,1,0
5171,22,132,2,52,50,0,2896.543,70,2157.066,LESS,-818,1788,970,4,1,-2,-0.187481692,2,-1.222253018,1.344587848,-0.010781133,102,52,50,0,-1.156811594,-1.092467184,-1.170500555,0.757591003,-0.847022358,0.847022358,-1.170500555,-1.092467184,1,1,0
5172,22,133,8,58,50,0,5574.571,30,2290.914,LESS,-102,2066,1964,4,1,-8,-0.749926769,8,-0.174607574,-0.873289014,1.449964396,108,58,50,0,-1.037141429,-0.858367073,-1.170500555,0.757591003,-0.102988733,0.102988733,-1.170500555,-0.858367073,0,1,1
5173,22,134,44,119,110,1,5610.303,40,2272.058,LESS,594,1492,2086,3,1,-9,-0.843667615,9,0,-0.318819799,1.469454617,229,119,110,0,1.376206896,1.521650721,1.170500555,0.044564177,0.620261831,0.620261831,1.170500555,1.521650721,1,0,1
5174,22,135,34,74,80,1,5096.788,60,3407.934,LESS,762,1660,2422,4,1,6,0.562445076,6,-0.523822722,0.790118632,1.189354954,154,74,80,1,-0.119670165,-0.234100111,0,0.757591003,0.794839553,0.794839553,0,-0.234100111,1,1,1
5175,22,136,24,86,80,1,7124.988,50,2078.341,LESS,1376,2570,3946,5,1,-6,-0.562445076,6,-0.523822722,0.235649417,2.295648123,166,86,80,0,0.119670165,0.234100111,0,1.47061783,1.432879561,1.432879561,0,0.234100111,1,1,1
5176,22,137,39,66,80,0,1886.034,30,2146.221,LESS,-1214,1694,480,2,1,14,1.312371845,14,0.87303787,-0.873289014,-0.561968986,146,66,80,1,-0.279230385,-0.546233592,0,-0.66846265,-1.258526989,1.258526989,0,-0.546233592,0,0,0
5177,22,138,9,50,59,0,2175.385,20,2647.732,LESS,-408,1298,890,4,1,9,0.843667615,9,0,-1.42775823,-0.404140846,109,50,59,1,-1.017196402,-1.170500555,-0.819350388,0.757591003,-0.420969584,0.420969584,-0.819350388,-1.170500555,0,1,0
5178,22,139,57,94,110,0,2161.453,20,1334.886,LESS,-488,1162,674,2,1,16,1.499853537,16,1.222253018,-1.42775823,-0.411740134,204,94,110,1,0.877581209,0.546233592,1.170500555,-0.66846265,-0.504101832,0.504101832,1.170500555,0.546233592,0,0,0
5179,22,140,60,110,87,1,1779.399,30,2113.876,LESS,90,802,892,3,2,-23,-2.15603946,23,2.444506035,-0.873289014,-0.620133651,197,110,87,0,0.737966017,1.170500555,0.273116796,0.044564177,0.096528664,0.096528664,0.273116796,1.170500555,0,1,1
5180,22,141,33,75,80,1,2200.476,20,1024.559,LESS,-526,1506,980,5,1,5,0.46870423,5,-0.698430296,-1.42775823,-0.390454818,155,75,80,1,-0.099725137,-0.195083426,0,1.47061783,-0.543589651,0.543589651,0,-0.195083426,0,1,0
5181,22,142,15,50,45,0,5176.143,30,1362.235,LESS,1860,1664,3524,2,1,-5,-0.46870423,5,-0.698430296,-0.873289014,1.232639588,95,50,45,0,-1.296426786,-1.170500555,-1.36558398,-0.66846265,1.935829666,1.935829666,-1.36558398,-1.170500555,0,0,1
5182,22,143,59,89,110,1,6800.015,50,2607.674,LESS,-118,3292,3174,5,2,21,1.968557767,21,2.095290887,0.235649417,2.118389761,199,89,110,1,0.777856072,0.351150166,1.170500555,1.47061783,-0.119615182,0.119615182,1.170500555,0.351150166,1,1,1
5183,22,144,29,80,94,0,3217.962,40,1642.808,LESS,-696,1966,1270,4,1,14,1.312371845,14,0.87303787,-0.318819799,0.164538679,174,80,94,1,0.279230385,0,0.546233592,0.757591003,-0.720245679,0.720245679,0.546233592,0,0,1,0
5184,22,145,55,110,98,1,2795.17,50,1789.543,LESS,764,880,1644,3,2,-12,-1.124890153,12,0.523822722,0.235649417,-0.06607561,208,110,98,0,0.957361319,1.170500555,0.702300333,0.044564177,0.796917859,0.796917859,0.702300333,1.170500555,1,0,1
5185,22,146,29,94,80,1,2123.109,40,3455.913,LESS,128,780,908,1,1,-14,-1.312371845,14,0.87303787,-0.318819799,-0.432655086,174,94,80,0,0.279230385,0.546233592,0,-1.381489476,0.136016482,0.136016482,0,0.546233592,0,0,1
5186,22,147,57,110,94,1,5400.809,10,1154.65,LESS,782,1978,2760,3,1,-16,-1.499853537,16,1.222253018,-1.982227445,1.355184929,204,110,94,0,0.877581209,1.170500555,0.546233592,0.044564177,0.815622615,0.815622615,0.546233592,1.170500555,0,0,1
5187,22,148,39,80,66,1,3092.476,50,1855.762,LESS,916,992,1908,3,2,-14,-1.312371845,14,0.87303787,0.235649417,0.09609163,146,80,66,0,-0.279230385,0,-0.546233592,0.044564177,0.954869132,0.954869132,-0.546233592,0,1,0,1
5188,22,149,4,50,54,0,4144.597,50,1876.772,LESS,22,1828,1850,3,1,4,0.374963384,4,-0.87303787,0.235649417,0.669976984,104,50,54,1,-1.116921539,-1.170500555,-1.014433814,0.044564177,0.025866253,0.025866253,-1.014433814,-1.170500555,1,0,1
5189,22,150,55,98,110,0,3872.583,20,1604.536,LESS,-1380,2636,1256,4,1,12,1.124890153,12,0.523822722,-1.42775823,0.521605409,208,98,110,1,0.957361319,0.702300333,1.170500555,0.757591003,-1.431026405,1.431026405,1.170500555,0.702300333,0,1,0
5190,22,151,2,50,52,1,2245.704,10,1382.155,LESS,-470,1792,1322,3,1,2,0.187481692,2,-1.222253018,-1.982227445,-0.365784949,102,50,52,1,-1.156811594,-1.170500555,-1.092467184,0.044564177,-0.485397076,0.485397076,-1.092467184,-1.170500555,0,0,0
5191,22,152,59,110,89,1,1405.35,40,922.496,LESS,-1016,1426,410,2,1,-21,-1.968557767,21,2.095290887,-0.318819799,-0.824160795,199,110,89,0,0.777856072,1.170500555,0.351150166,-0.66846265,-1.052774674,1.052774674,0.351150166,1.170500555,0,0,0
5192,22,153,60,87,110,0,3152.69,30,795.087,LESS,-100,1628,1528,2,1,23,2.15603946,23,2.444506035,-0.873289014,0.128935697,197,87,110,1,0.737966017,0.273116796,1.170500555,-0.66846265,-0.100910426,0.100910426,1.170500555,0.273116796,0,0,1
5193,22,154,52,110,105,1,2129.347,20,1450.458,LESS,-542,1594,1052,3,1,-5,-0.46870423,5,-0.698430296,-1.42775823,-0.429252534,215,110,105,0,1.096976512,1.170500555,0.975417129,0.044564177,-0.5602161,0.5602161,0.975417129,1.170500555,0,0,0
5194,22,155,30,80,96,0,1228.199,30,863.88,LESS,-1492,1838,346,2,1,16,1.499853537,16,1.222253018,-0.873289014,-0.92078881,176,80,96,1,0.31912044,0,0.624266962,-0.66846265,-1.547411553,1.547411553,0.624266962,0,0,0,0
5195,22,156,24,80,86,0,1741.894,20,1068.261,LESS,-1524,1980,456,2,1,6,0.562445076,6,-0.523822722,-1.42775823,-0.640590965,166,80,86,1,0.119670165,0,0.234100111,-0.66846265,-1.580664453,1.580664453,0.234100111,0,0,0,0
5196,22,157,5,50,55,0,1512.257,50,1675.755,LESS,-1628,1986,358,2,1,5,0.46870423,5,-0.698430296,0.235649417,-0.765847766,105,50,55,1,-1.096976512,-1.170500555,-0.975417129,-0.66846265,-1.688736376,1.688736376,-0.975417129,-1.170500555,1,0,0
5197,22,158,34,80,74,0,6271.58,60,2225.315,LESS,-1648,2886,1238,3,1,-6,-0.562445076,6,-0.523822722,0.790118632,1.830151899,154,80,74,0,-0.119670165,0,-0.234100111,0.044564177,-1.709519438,1.709519438,-0.234100111,0,1,0,0
5198,22,159,15,45,50,0,1090.217,30,1535.397,LESS,-818,1128,310,2,1,5,0.46870423,5,-0.698430296,-0.873289014,-0.996051873,95,45,50,1,-1.296426786,-1.36558398,-1.170500555,-0.66846265,-0.847022358,0.847022358,-1.170500555,-1.36558398,0,0,0
5199,22,160,37,69,80,0,1642.316,60,1549.764,LESS,-1706,2100,394,2,1,11,1.031149307,11,0.349215148,0.790118632,-0.694906349,149,69,80,1,-0.219395302,-0.429183537,0,-0.66846265,-1.769790318,1.769790318,0,-0.429183537,1,0,0
5200,22,161,3,50,53,1,2690.545,70,3126.722,MORE,-470,1340,870,3,2,3,0.281222538,3,-1.047645444,1.344587848,-0.123143908,103,50,53,0,-1.136866566,-1.170500555,-1.053450499,0.044564177,-0.485397076,0.485397076,-1.053450499,-1.170500555,1,1,0
5201,22,162,20,50,40,0,2904.159,40,2092.56,MORE,-2148,3116,968,4,1,-10,-0.937408461,10,0.174607574,-0.318819799,-0.006626943,90,50,40,1,-1.396151924,-1.170500555,-1.560667406,0.757591003,-2.229095992,2.229095992,-1.560667406,-1.170500555,0,1,0
5202,22,163,25,80,88,1,2020.204,70,1595.111,MORE,490,658,1148,3,2,8,0.749926769,8,-0.174607574,1.344587848,-0.488785201,168,80,88,0,0.15956022,0,0.312133481,0.044564177,0.512189907,0.512189907,0.312133481,0,1,1,1
5203,22,164,42,115,110,1,5823.042,60,1278.928,MORE,2164,1552,3716,4,2,-5,-0.46870423,5,-0.698430296,0.790118632,1.585494309,225,115,110,1,1.296426786,1.36558398,1.170500555,0.757591003,2.251732211,2.251732211,1.170500555,1.36558398,1,1,1
5204,22,165,53,103,110,1,2364.803,50,1973.025,MORE,794,690,1484,3,1,7,0.656185922,7,-0.349215148,0.235649417,-0.300821726,213,103,110,0,1.057086457,0.897383758,1.170500555,0.044564177,0.828092452,0.828092452,1.170500555,0.897383758,0,1,1
5205,22,166,26,90,80,1,2087.627,50,1439.051,MORE,512,684,1196,3,2,-10,-0.937408461,10,0.174607574,0.235649417,-0.452008944,170,90,80,1,0.199450275,0.390166852,0,0.044564177,0.535051276,0.535051276,0,0.390166852,0,1,1
5206,22,167,35,80,72,1,1253.863,40,1370.354,MORE,-58,1002,944,1,1,-8,-0.749926769,8,-0.174607574,-0.318819799,-0.906790236,152,80,72,1,-0.15956022,0,-0.312133481,-1.381489476,-0.057265996,0.057265996,-0.312133481,0,0,0,0
5207,22,168,28,93,80,1,2354.439,50,1387.876,MORE,1198,584,1782,3,2,-13,-1.218630999,13,0.698430296,0.235649417,-0.306474828,173,93,80,1,0.259285357,0.507216907,0,0.044564177,1.247910308,1.247910308,0,0.507216907,0,1,1
5208,22,169,26,80,90,0,1642.407,30,1217.763,MORE,-2004,2314,310,2,1,10,0.937408461,10,0.174607574,-0.873289014,-0.694856712,170,80,90,0,0.199450275,0,0.390166852,-0.66846265,-2.079457945,2.079457945,0.390166852,0,0,0,0
5209,22,170,25,88,80,1,3602.054,50,1246.128,MORE,1834,576,2410,1,2,-8,-0.749926769,8,-0.174607574,0.235649417,0.374043834,168,88,80,1,0.15956022,0.312133481,0,-1.381489476,1.908811685,1.908811685,0,0.312133481,0,0,1
5210,22,171,36,80,70,1,1140.405,40,1440.161,MORE,-50,792,742,1,1,-10,-0.937408461,10,0.174607574,-0.318819799,-0.968676544,150,80,70,1,-0.199450275,0,-0.390166852,-1.381489476,-0.048952771,0.048952771,-0.390166852,0,0,0,0
5211,22,172,28,80,93,1,1132.559,60,1348.845,MORE,218,384,602,1,2,13,1.218630999,13,0.698430296,0.790118632,-0.97295619,173,80,93,0,0.259285357,0,0.507216907,-1.381489476,0.229540262,0.229540262,0.507216907,0,1,0,0
5212,22,173,21,82,80,1,1035.352,70,1115.771,MORE,400,256,656,1,2,-2,-0.187481692,2,-1.222253018,1.344587848,-1.025978298,162,82,80,1,0.039890055,0.07803337,0,-1.381489476,0.418666128,0.418666128,0,0.07803337,1,0,1
5213,22,174,19,50,41,1,3856.735,70,2095.156,MORE,490,560,1050,1,1,-9,-0.843667615,9,0,1.344587848,0.512961027,91,50,41,1,-1.376206896,-1.170500555,-1.521650721,-1.381489476,0.512189907,0.512189907,-1.521650721,-1.170500555,1,0,1
5214,22,175,56,96,110,1,1972.125,60,1511.794,MORE,320,706,1026,3,2,14,1.312371845,14,0.87303787,0.790118632,-0.515010163,206,96,110,0,0.917471264,0.624266962,1.170500555,0.044564177,0.335533879,0.335533879,1.170500555,0.624266962,1,0,1
5215,22,176,23,80,85,1,1743.218,50,1460.87,MORE,54,1018,1072,3,1,5,0.46870423,5,-0.698430296,0.235649417,-0.639868782,165,80,85,0,0.099725137,0,0.195083426,0.044564177,0.059119152,0.059119152,0.195083426,0,0,1,0
5216,22,177,10,60,50,1,1954.868,80,2611.889,MORE,968,510,1478,3,2,-10,-0.937408461,10,0.174607574,1.899057063,-0.524423092,110,60,50,1,-0.997251374,-0.780333703,-1.170500555,0.044564177,1.008905093,1.008905093,-1.170500555,-0.780333703,1,1,1
5217,22,178,19,41,50,1,2041.706,70,1149.175,MORE,586,510,1096,3,2,9,0.843667615,9,0,1.344587848,-0.477056813,91,41,50,0,-1.376206896,-1.521650721,-1.170500555,0.044564177,0.611948606,0.611948606,-1.170500555,-1.521650721,1,1,1
5218,22,179,56,110,96,1,1993.617,30,1851.122,MORE,-684,1692,1008,3,1,-14,-1.312371845,14,0.87303787,-0.873289014,-0.50328723,206,110,96,1,0.917471264,1.170500555,0.624266962,0.044564177,-0.707775842,0.707775842,0.624266962,1.170500555,0,1,0
5219,22,180,35,72,80,1,3404.234,30,1449.38,MORE,778,1138,1916,5,2,8,0.749926769,8,-0.174607574,-0.873289014,0.266141796,152,72,80,0,-0.15956022,-0.312133481,0,1.47061783,0.811466003,0.811466003,0,-0.312133481,0,1,1
5220,22,181,11,49,50,1,2069.967,70,1621.963,MORE,492,752,1244,3,2,1,0.093740846,1,-1.396860592,1.344587848,-0.461641691,99,49,50,0,-1.216646676,-1.20951724,-1.170500555,0.044564177,0.514268214,0.514268214,-1.170500555,-1.20951724,1,1,1
5221,22,182,17,43,50,0,2524.046,30,1120.892,MORE,-540,1430,890,4,1,7,0.656185922,7,-0.349215148,-0.873289014,-0.21396173,93,43,50,0,-1.336316841,-1.443617351,-1.170500555,0.757591003,-0.558137794,0.558137794,-1.170500555,-1.443617351,0,1,0
5222,22,183,1,51,50,1,1021.653,40,1826.017,MORE,268,328,596,1,2,-1,-0.093740846,1,-1.396860592,-0.318819799,-1.033450495,101,51,50,1,-1.176756621,-1.131483869,-1.170500555,-1.381489476,0.281497917,0.281497917,-1.170500555,-1.131483869,0,0,0
5223,22,184,41,112,110,1,3057.357,50,1916.877,MORE,308,426,734,1,2,-2,-0.187481692,2,-1.222253018,0.235649417,0.076935773,222,112,110,1,1.236591704,1.248533925,1.170500555,-1.381489476,0.323064042,0.323064042,1.170500555,1.248533925,0,0,0
5224,22,185,20,40,50,1,1207.583,40,1852.776,MORE,290,656,946,1,1,10,0.937408461,10,0.174607574,-0.318819799,-0.932033924,90,40,50,0,-1.396151924,-1.560667406,-1.170500555,-1.381489476,0.304359286,0.304359286,-1.170500555,-1.560667406,0,0,0
5225,22,186,1,50,51,1,1852.45,50,1421.374,MORE,502,464,966,3,2,1,0.093740846,1,-1.396860592,0.235649417,-0.580287569,101,50,51,0,-1.176756621,-1.170500555,-1.131483869,0.044564177,0.524659745,0.524659745,-1.131483869,-1.170500555,0,1,1
5226,22,187,23,85,80,1,1991.661,40,1932.067,MORE,1626,202,1828,1,2,-5,-0.46870423,5,-0.698430296,-0.318819799,-0.504354141,165,85,80,1,0.099725137,0.195083426,0,-1.381489476,1.692667838,1.692667838,0,0.195083426,0,0,1
5227,22,188,11,50,49,1,1258.405,70,1453.917,MORE,530,320,850,1,2,-1,-0.093740846,1,-1.396860592,1.344587848,-0.904312777,99,50,49,1,-1.216646676,-1.170500555,-1.20951724,-1.381489476,0.553756032,0.553756032,-1.20951724,-1.170500555,1,0,1
5228,22,189,17,50,43,1,1145.536,40,1755.18,MORE,114,846,960,1,1,-7,-0.656185922,7,-0.349215148,-0.318819799,-0.965877811,93,50,43,1,-1.336316841,-1.170500555,-1.443617351,-1.381489476,0.121468339,0.121468339,-1.443617351,-1.170500555,0,0,0
5229,22,190,21,80,82,1,2516.649,60,1831.02,MORE,1436,224,1660,1,2,2,0.187481692,2,-1.222253018,0.790118632,-0.217996466,162,80,82,0,0.039890055,0,0.07803337,-1.381489476,1.495228748,1.495228748,0.07803337,0,1,0,1
5230,22,191,10,50,60,1,1842.058,50,1568.408,MORE,758,184,942,1,2,10,0.937408461,10,0.174607574,0.235649417,-0.585955945,110,50,60,0,-0.997251374,-1.170500555,-0.780333703,-1.381489476,0.79068294,0.79068294,-0.780333703,-1.170500555,0,0,1
5231,22,192,3,53,50,1,1980.187,50,1891.487,MORE,900,314,1214,1,1,-3,-0.281222538,3,-1.047645444,0.235649417,-0.5106127,103,53,50,1,-1.136866566,-1.053450499,-1.170500555,-1.381489476,0.938242682,0.938242682,-1.170500555,-1.053450499,0,0,1
5232,22,193,45,122,110,1,1017.719,70,1685.641,MORE,592,310,902,1,2,-12,-1.124890153,12,0.523822722,1.344587848,-1.035596317,232,122,110,1,1.436041979,1.638700776,1.170500555,-1.381489476,0.618183525,0.618183525,1.170500555,1.638700776,1,0,1
5233,22,194,38,67,80,1,2228.271,30,1860.599,MORE,1754,184,1938,2,1,13,1.218630999,13,0.698430296,-0.873289014,-0.375293878,147,67,80,0,-0.259285357,-0.507216907,0,-0.66846265,1.825679436,1.825679436,0,-0.507216907,0,0,1
5234,22,195,38,80,67,1,1967.784,10,1305.949,MORE,-418,1542,1124,3,2,-13,-1.218630999,13,0.698430296,-1.982227445,-0.517377986,147,80,67,1,-0.259285357,0,-0.507216907,0.044564177,-0.431361115,0.431361115,-0.507216907,0,0,1,0
5235,22,196,36,70,80,1,2396.256,70,1227.849,MORE,-140,1094,954,3,2,10,0.937408461,10,0.174607574,1.344587848,-0.283665509,150,70,80,0,-0.199450275,-0.390166852,0,0.044564177,-0.142476551,0.142476551,0,-0.390166852,1,1,0
5236,22,197,45,110,122,1,1232.64,60,860.843,MORE,834,292,1126,1,2,12,1.124890153,12,0.523822722,0.790118632,-0.918366442,232,110,122,0,1.436041979,1.170500555,1.638700776,-1.381489476,0.869658577,0.869658577,1.638700776,1.170500555,1,0,1
5237,22,198,42,110,115,1,1559.972,40,2250.683,MORE,868,256,1124,1,2,5,0.46870423,5,-0.698430296,-0.318819799,-0.73982135,225,110,115,0,1.296426786,1.170500555,1.36558398,-1.381489476,0.904989782,0.904989782,1.36558398,1.170500555,0,0,1
5238,22,199,41,110,112,0,1769.561,70,1130.837,MORE,-1008,1506,498,2,1,2,0.187481692,2,-1.222253018,1.344587848,-0.625499843,222,110,112,0,1.236591704,1.170500555,1.248533925,-0.66846265,-1.044461449,1.044461449,1.248533925,1.170500555,1,0,0
5239,22,200,53,110,103,1,2482.277,50,1829.457,MORE,1014,678,1692,2,1,-7,-0.656185922,7,-0.349215148,0.235649417,-0.236744868,213,110,103,1,1.057086457,1.170500555,0.897383758,-0.66846265,1.056706136,1.056706136,0.897383758,1.170500555,0,0,1
5240,22,201,3,50,53,0,2969.908,50,2035.508,LESS,-920,1758,838,3,1,3,0.281222538,3,-1.047645444,0.235649417,0.029236221,103,50,53,1,-1.136866566,-1.170500555,-1.053450499,0.044564177,-0.953015975,0.953015975,-1.053450499,-1.170500555,1,0,0
5241,22,202,20,50,40,1,1796.985,50,3143.692,LESS,636,602,1238,3,1,-10,-0.937408461,10,0.174607574,0.235649417,-0.610541267,90,50,40,0,-1.396151924,-1.170500555,-1.560667406,0.044564177,0.663906261,0.663906261,-1.560667406,-1.170500555,1,0,1
5242,22,203,25,80,88,1,1501.604,50,1745.422,LESS,380,550,930,3,2,8,0.749926769,8,-0.174607574,0.235649417,-0.771658506,168,80,88,1,0.15956022,0,0.312133481,0.044564177,0.397883066,0.397883066,0.312133481,0,1,0,1
5243,22,204,42,115,110,0,2535.906,40,1686.461,LESS,-414,1430,1016,4,1,-5,-0.46870423,5,-0.698430296,-0.318819799,-0.207492626,225,115,110,0,1.296426786,1.36558398,1.170500555,0.757591003,-0.427204502,0.427204502,1.170500555,1.36558398,1,1,0
5244,22,205,53,103,110,0,1280.104,50,2053.474,LESS,-682,1032,350,2,1,7,0.656185922,7,-0.349215148,0.235649417,-0.892476934,213,103,110,1,1.057086457,0.897383758,1.170500555,-0.66846265,-0.705697535,0.705697535,1.170500555,0.897383758,1,0,0
5245,22,206,26,90,80,0,4045.242,40,1488.552,LESS,-330,2206,1876,4,1,-10,-0.937408461,10,0.174607574,-0.318819799,0.615783237,170,90,80,0,0.199450275,0.390166852,0,0.757591003,-0.339915641,0.339915641,0,0.390166852,1,1,0
5246,22,207,35,80,72,1,1617.313,50,1487.633,LESS,284,682,966,3,2,-8,-0.749926769,8,-0.174607574,0.235649417,-0.708544377,152,80,72,0,-0.15956022,0,-0.312133481,0.044564177,0.298124367,0.298124367,-0.312133481,0,1,0,1
5247,22,208,28,93,80,1,2319.141,50,1687.325,LESS,-358,1522,1164,3,1,-13,-1.218630999,13,0.698430296,0.235649417,-0.325728322,173,93,80,0,0.259285357,0.507216907,0,0.044564177,-0.369011928,0.369011928,0,0.507216907,1,0,0
5248,22,209,26,80,90,0,1172.646,20,1130.655,LESS,-1198,1550,352,2,1,10,0.937408461,10,0.174607574,-1.42775823,-0.951090508,170,80,90,1,0.199450275,0,0.390166852,-0.66846265,-1.241900539,1.241900539,0.390166852,0,0,0,0
5249,22,210,25,88,80,1,2566.249,30,1661.907,LESS,750,764,1514,3,1,-8,-0.749926769,8,-0.174607574,-0.873289014,-0.190941865,168,88,80,0,0.15956022,0.312133481,0,0.044564177,0.782369716,0.782369716,0,0.312133481,0,0,1
5250,22,211,36,80,70,1,2048.014,20,2427.385,LESS,-908,2158,1250,3,1,-10,-0.937408461,10,0.174607574,-1.42775823,-0.473616079,150,80,70,0,-0.199450275,0,-0.390166852,0.044564177,-0.940546138,0.940546138,-0.390166852,0,0,0,0
5251,22,212,28,80,93,0,1116.105,30,2185.729,LESS,-868,1170,302,2,1,13,1.218630999,13,0.698430296,-0.873289014,-0.981931117,173,80,93,1,0.259285357,0,0.507216907,-0.66846265,-0.898980014,0.898980014,0.507216907,0,0,0,0
5252,22,213,21,82,80,1,8926.948,40,883.028,LESS,1552,3034,4586,6,2,-2,-0.187481692,2,-1.222253018,-0.318819799,3.278537403,162,82,80,0,0.039890055,0.07803337,0,2.183644656,1.615770508,1.615770508,0,0.07803337,1,1,1
5253,22,214,19,50,41,0,2706.309,20,1883.235,LESS,-982,2352,1370,2,1,-9,-0.843667615,9,0,-1.42775823,-0.114545345,91,50,41,0,-1.376206896,-1.170500555,-1.521650721,-0.66846265,-1.017443468,1.017443468,-1.521650721,-1.170500555,0,0,0
5254,22,215,56,96,110,1,2411.239,50,1415.043,LESS,754,602,1356,3,2,14,1.312371845,14,0.87303787,0.235649417,-0.275492947,206,96,110,1,0.917471264,0.624266962,1.170500555,0.044564177,0.786526328,0.786526328,1.170500555,0.624266962,1,0,1
5255,22,216,23,80,85,1,2289.552,40,2001.112,LESS,466,794,1260,3,2,5,0.46870423,5,-0.698430296,-0.318819799,-0.34186781,165,80,85,1,0.099725137,0,0.195083426,0.044564177,0.487250233,0.487250233,0.195083426,0,0,0,1
5256,22,217,10,60,50,0,1407.212,30,1074.968,LESS,-778,1168,390,2,1,-10,-0.937408461,10,0.174607574,-0.873289014,-0.823145156,110,60,50,0,-0.997251374,-0.780333703,-1.170500555,-0.66846265,-0.805456234,0.805456234,-1.170500555,-0.780333703,0,0,0
5257,22,218,19,41,50,0,1720.936,50,1761.559,LESS,-534,1164,630,2,1,9,0.843667615,9,0,0.235649417,-0.652022625,91,41,50,1,-1.376206896,-1.521650721,-1.170500555,-0.66846265,-0.551902875,0.551902875,-1.170500555,-1.521650721,1,0,0
5258,22,219,56,110,96,1,1866.761,50,1394.746,LESS,92,1028,1120,4,1,-14,-1.312371845,14,0.87303787,0.235649417,-0.572481553,206,110,96,0,0.917471264,1.170500555,0.624266962,0.757591003,0.09860697,0.09860697,0.624266962,1.170500555,1,1,1
5259,22,220,35,72,80,1,2287.665,30,1786.224,LESS,-792,2188,1396,3,1,8,0.749926769,8,-0.174607574,-0.873289014,-0.342897084,152,72,80,1,-0.15956022,-0.312133481,0,0.044564177,-0.820004377,0.820004377,0,-0.312133481,0,0,0
5260,22,221,11,49,50,0,1332.571,50,1530.112,LESS,-516,894,378,2,1,1,0.093740846,1,-1.396860592,0.235649417,-0.863858512,99,49,50,1,-1.216646676,-1.20951724,-1.170500555,-0.66846265,-0.533198119,0.533198119,-1.170500555,-1.20951724,1,0,0
5261,22,222,17,43,50,0,2202.458,70,2034.436,LESS,-942,1520,578,2,1,7,0.656185922,7,-0.349215148,1.344587848,-0.389373725,93,43,50,1,-1.336316841,-1.443617351,-1.170500555,-0.66846265,-0.975877344,0.975877344,-1.170500555,-1.443617351,1,0,0
5262,22,223,1,51,50,0,2878.683,40,1894.339,LESS,-646,1644,998,4,1,-1,-0.093740846,1,-1.396860592,-0.318819799,-0.020522971,101,51,50,0,-1.176756621,-1.131483869,-1.170500555,0.757591003,-0.668288024,0.668288024,-1.170500555,-1.131483869,1,1,0
5263,22,224,41,112,110,1,4337.983,30,1905.419,LESS,354,1796,2150,5,1,-2,-0.187481692,2,-1.222253018,-0.873289014,0.775460472,222,112,110,0,1.236591704,1.248533925,1.170500555,1.47061783,0.370865085,0.370865085,1.170500555,1.248533925,0,1,1
5264,22,225,20,40,50,0,2690.521,70,1956.539,LESS,-526,1658,1132,4,1,10,0.937408461,10,0.174607574,1.344587848,-0.123156999,90,40,50,1,-1.396151924,-1.560667406,-1.170500555,0.757591003,-0.543589651,0.543589651,-1.170500555,-1.560667406,1,1,0
5265,22,226,1,50,51,0,1693.509,50,1699.156,LESS,-762,1292,530,2,1,1,0.093740846,1,-1.396860592,0.235649417,-0.666982837,101,50,51,1,-1.176756621,-1.170500555,-1.131483869,-0.66846265,-0.788829784,0.788829784,-1.131483869,-1.170500555,1,0,0
5266,22,227,23,85,80,0,2313.065,70,2033.677,LESS,-1102,1918,816,4,1,-5,-0.46870423,5,-0.698430296,1.344587848,-0.329042511,165,85,80,0,0.099725137,0.195083426,0,0.757591003,-1.142141841,1.142141841,0,0.195083426,1,1,0
5267,22,228,11,50,49,1,1600.281,30,1347.694,LESS,-730,1360,630,2,1,-1,-0.093740846,1,-1.396860592,-0.873289014,-0.717834578,99,50,49,0,-1.216646676,-1.170500555,-1.20951724,-0.66846265,-0.755576885,0.755576885,-1.20951724,-1.170500555,0,0,0
5268,22,229,17,50,43,1,1107.641,70,2526.882,LESS,274,574,848,1,1,-7,-0.656185922,7,-0.349215148,1.344587848,-0.986547854,93,50,43,0,-1.336316841,-1.170500555,-1.443617351,-1.381489476,0.287732836,0.287732836,-1.443617351,-1.170500555,1,0,1
5269,22,230,21,80,82,0,1590.669,20,1165.001,LESS,-1412,1900,488,2,1,2,0.187481692,2,-1.222253018,-1.42775823,-0.723077497,162,80,82,1,0.039890055,0,0.07803337,-0.66846265,-1.464279304,1.464279304,0.07803337,0,0,0,0
5270,22,231,10,50,60,0,2748.301,10,1382.212,LESS,-1940,2814,874,4,1,10,0.937408461,10,0.174607574,-1.982227445,-0.091640571,110,50,60,1,-0.997251374,-1.170500555,-0.780333703,0.757591003,-2.012952146,2.012952146,-0.780333703,-1.170500555,0,1,0
5271,22,232,3,53,50,0,3963.145,30,1685.287,LESS,-1786,2994,1208,4,1,-3,-0.281222538,3,-1.047645444,-0.873289014,0.571002964,103,53,50,0,-1.136866566,-1.053450499,-1.170500555,0.757591003,-1.852922567,1.852922567,-1.170500555,-1.053450499,0,1,0
5272,22,233,45,122,110,0,1594.602,10,1201.329,LESS,-1622,1926,304,2,1,-12,-1.124890153,12,0.523822722,-1.982227445,-0.72093222,232,122,110,0,1.436041979,1.638700776,1.170500555,-0.66846265,-1.682501457,1.682501457,1.170500555,1.638700776,0,0,0
5273,22,234,38,67,80,0,5893.362,30,1371.985,LESS,96,2518,2614,5,1,13,1.218630999,13,0.698430296,-0.873289014,1.623850751,147,67,80,1,-0.259285357,-0.507216907,0,1.47061783,0.102763583,0.102763583,0,-0.507216907,0,1,1
5274,22,235,38,80,67,0,1303.528,80,524.396,LESS,-732,1082,350,2,1,-13,-1.218630999,13,0.698430296,1.899057063,-0.879700181,147,80,67,0,-0.259285357,0,-0.507216907,-0.66846265,-0.757655191,0.757655191,-0.507216907,0,1,0,0
5275,22,236,36,70,80,0,1108.254,20,1342.738,LESS,-1730,2042,312,2,1,10,0.937408461,10,0.174607574,-1.42775823,-0.986213489,150,70,80,1,-0.199450275,-0.390166852,0,-0.66846265,-1.794729993,1.794729993,0,-0.390166852,0,0,0
5276,22,237,45,110,122,0,1507.767,50,477.631,LESS,-958,1398,440,2,1,12,1.124890153,12,0.523822722,0.235649417,-0.768296862,232,110,122,1,1.436041979,1.170500555,1.638700776,-0.66846265,-0.992503793,0.992503793,1.638700776,1.170500555,1,0,0
5277,22,238,42,110,115,1,4422.591,40,1741.613,LESS,-16,1594,1578,4,1,5,0.46870423,5,-0.698430296,-0.318819799,0.821610385,225,110,115,1,1.296426786,1.170500555,1.36558398,0.757591003,-0.013621565,0.013621565,1.36558398,1.170500555,1,1,1
5278,22,239,41,110,112,0,5432.37,20,800.453,LESS,544,2326,2870,3,1,2,0.187481692,2,-1.222253018,-1.42775823,1.372400055,222,110,112,1,1.236591704,1.170500555,1.248533925,0.044564177,0.568304175,0.568304175,1.248533925,1.170500555,0,0,1
5279,22,240,53,110,103,1,2910.324,30,1438.447,LESS,-1130,2044,914,2,1,-7,-0.656185922,7,-0.349215148,-0.873289014,-0.003264209,213,110,103,0,1.057086457,1.170500555,0.897383758,-0.66846265,-1.171238128,1.171238128,0.897383758,1.170500555,0,0,0
5280,23,1,49,110,131,0,5204.121,44,2460.754,LESS,380,2294,2674,9,2,21,1.968557767,21,2.095290887,-0.367387781,0.379682386,241,110,131,1,1.615547226,1.170500555,1.989850943,2.065984676,0.604029047,0.604029047,1.989850943,1.170500555,0,1,1
5281,23,2,13,47,50,0,3055.181,64,1867.059,LESS,-410,1436,1026,4,1,3,0.281222538,3,-1.047645444,0.27480499,-0.590833202,97,47,50,1,-1.256536731,-1.28755061,-1.170500555,-0.295140668,-0.126688548,0.126688548,-1.170500555,-1.28755061,1,0,0
5282,23,3,16,50,44,0,1742.212,100,1002.93,LESS,64,1094,1158,2,2,-6,-0.562445076,6,-0.523822722,1.430751976,-1.183803169,94,50,44,0,-1.316371814,-1.170500555,-1.404600665,-1.239590806,0.311742009,0.311742009,-1.404600665,-1.170500555,1,0,1
5283,23,4,7,57,50,0,5583.058,4,1579.435,LESS,-1900,4222,2322,6,1,-7,-0.656185922,7,-0.349215148,-1.651773322,0.550819907,107,57,50,0,-1.057086457,-0.897383758,-1.170500555,0.64930947,-1.50487743,1.50487743,-1.170500555,-0.897383758,0,1,0
5284,23,5,18,42,50,0,1630.824,84,1537.558,LESS,-222,1216,994,2,2,8,0.749926769,8,-0.174607574,0.91699776,-1.234108803,92,42,50,1,-1.356261869,-1.482634036,-1.170500555,-1.239590806,0.04720374,0.04720374,-1.170500555,-1.482634036,1,0,0
5285,23,6,51,108,110,0,5647.961,44,3040.811,LESS,-106,3036,2930,6,2,2,0.187481692,2,-1.222253018,-0.367387781,0.580131742,218,108,110,1,1.156811594,1.092467184,1.170500555,0.64930947,0.154498982,0.154498982,1.170500555,1.092467184,0,1,1
5286,23,7,31,78,80,0,10036.347,0,1136.501,LESS,-1742,5658,3916,10,1,2,0.187481692,2,-1.222253018,-1.780211876,2.562037713,158,78,80,1,-0.039890055,-0.07803337,0,2.538209745,-1.358733911,1.358733911,0,-0.07803337,0,1,0
5287,23,8,58,110,92,1,2986.934,4,1576.624,LESS,-1102,2614,1512,4,1,-18,-1.687335229,18,1.571468165,-1.651773322,-0.621655271,202,110,92,0,0.837691154,1.170500555,0.468200222,-0.295140668,-0.766760163,0.766760163,0.468200222,1.170500555,0,0,0
5288,23,9,12,50,48,0,3674.966,54,2249.546,LESS,-1274,2784,1510,2,1,-2,-0.187481692,2,-1.222253018,-0.046291396,-0.310922639,98,50,48,0,-1.236591704,-1.170500555,-1.248533925,-1.239590806,-0.925853108,0.925853108,-1.248533925,-1.170500555,0,0,0
5289,23,10,54,110,101,1,9208.107,54,1568.031,LESS,856,3866,4722,8,1,-9,-0.843667615,9,0,-0.046291396,2.187983607,211,110,101,0,1.017196402,1.170500555,0.819350388,1.593759607,1.044309522,1.044309522,0.819350388,1.170500555,0,1,1
5290,23,11,14,46,50,0,1972.588,100,1501.914,LESS,618,1142,1760,2,2,4,0.374963384,4,-0.87303787,1.430751976,-1.079759547,96,46,50,1,-1.276481759,-1.326567295,-1.170500555,-1.239590806,0.824169284,0.824169284,-1.170500555,-1.326567295,1,0,1
5291,23,12,22,80,83,0,4958.179,84,2703.412,LESS,376,2246,2622,4,2,3,0.281222538,3,-1.047645444,0.91699776,0.268608766,163,80,83,1,0.059835082,0,0.117050055,-0.295140668,0.600329211,0.600329211,0.117050055,0,1,0,1
5292,23,13,6,50,56,1,7160.836,74,1713.808,LESS,1174,2524,3698,4,2,6,0.562445076,6,-0.523822722,0.595901375,1.263384308,106,50,56,1,-1.077031484,-1.170500555,-0.936400444,-0.295140668,1.338446478,1.338446478,-0.936400444,-1.170500555,1,0,1
5293,23,14,13,50,47,1,5275.58,34,1963.309,LESS,-1352,3744,2392,6,1,-3,-0.281222538,3,-1.047645444,-0.688484166,0.411955075,97,50,47,0,-1.256536731,-1.170500555,-1.28755061,0.64930947,-0.997999909,0.997999909,-1.28755061,-1.170500555,0,1,0
5294,23,15,46,110,124,0,3053.825,94,956.388,LESS,410,1510,1920,4,2,14,1.312371845,14,0.87303787,1.238094145,-0.591445606,234,110,124,1,1.475932034,1.170500555,1.716734147,-0.295140668,0.631777816,0.631777816,1.716734147,1.170500555,1,0,1
5295,23,16,27,91,80,0,11543.974,24,1632.406,LESS,-2158,5922,3764,11,1,-11,-1.031149307,11,0.349215148,-1.009580551,3.24292015,171,91,80,0,0.219395302,0.429183537,0,3.010434814,-1.743516847,1.743516847,0,0.429183537,0,1,0
5296,23,17,40,64,80,0,1875.935,54,1616.567,LESS,-990,1414,424,2,1,16,1.499853537,16,1.222253018,-0.046291396,-1.123410484,144,64,80,1,-0.31912044,-0.624266962,0,-1.239590806,-0.663164757,0.663164757,0,-0.624266962,0,0,0
5297,23,18,22,83,80,0,6832.351,24,1256.958,LESS,-1652,4420,2768,6,1,-3,-0.281222538,3,-1.047645444,-1.009580551,1.115032184,163,83,80,0,0.059835082,0.117050055,0,0.64930947,-1.275487603,1.275487603,0,0.117050055,0,1,0
5298,23,19,54,101,110,0,3361.985,84,1005.123,LESS,138,1644,1782,4,1,9,0.843667615,9,0,0.91699776,-0.452272765,211,101,110,1,1.017196402,0.819350388,1.170500555,-0.295140668,0.380188973,0.380188973,1.170500555,0.819350388,1,0,1
5299,23,20,6,56,50,1,3958.387,84,1238.472,LESS,1426,1462,2888,3,2,-6,-0.562445076,6,-0.523822722,0.91699776,-0.182922556,106,56,50,0,-1.077031484,-0.936400444,-1.170500555,-0.767365737,1.571536141,1.571536141,-1.170500555,-0.936400444,1,0,1
5300,23,21,18,50,42,0,7594.009,4,1917.825,LESS,-1864,5060,3196,8,1,-8,-0.749926769,8,-0.174607574,-1.651773322,1.459016177,92,50,42,0,-1.356261869,-1.170500555,-1.482634036,1.593759607,-1.471578907,1.471578907,-1.482634036,-1.170500555,0,1,0
5301,23,22,43,110,117,0,9315.865,44,2380.53,LESS,-1016,4566,3550,10,2,7,0.656185922,7,-0.349215148,-0.367387781,2.236649842,227,110,117,1,1.336316841,1.170500555,1.443617351,2.538209745,-0.687213691,0.687213691,1.443617351,1.170500555,0,1,0
5302,23,23,32,77,80,0,1826.872,74,1083.862,LESS,-582,1104,522,2,1,3,0.281222538,3,-1.047645444,0.595901375,-1.145568574,157,77,80,1,-0.059835082,-0.117050055,0,-1.239590806,-0.285781493,0.285781493,0,-0.117050055,1,0,0
5303,23,24,27,80,91,1,2063.828,84,1314.671,LESS,578,738,1316,3,2,11,1.031149307,11,0.349215148,0.91699776,-1.038553259,171,80,91,1,0.219395302,0,0.429183537,-0.767365737,0.787170925,0.787170925,0.429183537,0,1,0,1
5304,23,25,16,44,50,0,4442.518,44,2414.767,LESS,-1186,2468,1282,3,1,6,0.562445076,6,-0.523822722,-0.367387781,0.035723233,94,44,50,1,-1.316371814,-1.404600665,-1.170500555,-0.767365737,-0.844456718,0.844456718,-1.170500555,-1.404600665,0,0,0
5305,23,26,7,50,57,1,6184.954,14,3886.192,LESS,-518,3986,3468,6,1,7,0.656185922,7,-0.349215148,-1.330676936,0.822651345,107,50,57,1,-1.057086457,-1.170500555,-0.897383758,0.64930947,-0.226584118,0.226584118,-0.897383758,-1.170500555,0,1,0
5306,23,27,14,50,46,1,5219.459,44,1070.852,LESS,1184,1818,3002,6,1,-4,-0.374963384,4,-0.87303787,-0.367387781,0.386609414,96,50,46,0,-1.276481759,-1.170500555,-1.326567295,0.64930947,1.347696067,1.347696067,-1.326567295,-1.170500555,0,1,1
5307,23,28,51,110,108,0,4985.086,4,1869.697,LESS,-2068,3618,1550,4,1,-2,-0.187481692,2,-1.222253018,-1.651773322,0.280760647,218,110,108,0,1.156811594,1.170500555,1.092467184,-0.295140668,-1.660270539,1.660270539,1.092467184,1.170500555,0,0,0
5308,23,29,50,133,110,1,6102.594,74,1410.134,LESS,-194,2666,2472,5,2,-23,-2.15603946,23,2.444506035,0.595901375,0.785455489,243,133,110,0,1.655437281,2.067884313,1.170500555,0.177084401,0.073102591,0.073102591,1.170500555,2.067884313,1,1,1
5309,23,30,49,131,110,1,5591.604,44,1697.158,LESS,-966,3178,2212,5,1,-21,-1.968557767,21,2.095290887,-0.367387781,0.554679497,241,131,110,0,1.615547226,1.989850943,1.170500555,0.177084401,-0.640965742,0.640965742,1.170500555,1.989850943,0,1,0
5310,23,31,47,126,110,0,10455.844,34,2534.346,LESS,-52,4798,4746,7,2,-16,-1.499853537,16,1.222253018,-0.688484166,2.751493155,236,126,110,0,1.515822089,1.794767517,1.170500555,1.121534539,0.204446767,0.204446767,1.170500555,1.794767517,0,1,1
5311,23,32,50,110,133,0,2717.282,100,2017.276,LESS,1230,1344,2574,4,2,23,2.15603946,23,2.444506035,1.430751976,-0.743436926,243,110,133,1,1.655437281,1.170500555,2.067884313,-0.295140668,1.39024418,1.39024418,2.067884313,1.170500555,1,0,1
5312,23,33,47,110,126,0,4991.945,44,1481.045,LESS,-1592,3178,1586,6,1,16,1.499853537,16,1.222253018,-0.367387781,0.283858345,236,110,126,1,1.515822089,1.170500555,1.794767517,0.64930947,-1.219990064,1.219990064,1.794767517,1.170500555,0,1,0
5313,23,34,12,48,50,0,4295.051,100,3343.382,LESS,206,2532,2738,4,2,2,0.187481692,2,-1.222253018,1.430751976,-0.03087659,98,48,50,1,-1.236591704,-1.248533925,-1.170500555,-0.295140668,0.443086184,0.443086184,-1.170500555,-1.248533925,1,1,1
5314,23,35,32,80,77,0,7051.383,64,2853.183,LESS,-934,3638,2704,8,1,-3,-0.281222538,3,-1.047645444,0.27480499,1.213952568,157,80,77,0,-0.059835082,0,-0.117050055,1.593759607,-0.611367055,0.611367055,-0.117050055,0,1,1,0
5315,23,36,43,117,110,1,7789.693,34,1738.657,LESS,-844,4054,3210,7,1,-7,-0.656185922,7,-0.349215148,-0.688484166,1.547392014,227,117,110,0,1.336316841,1.443617351,1.170500555,1.121534539,-0.528120746,0.528120746,1.170500555,1.443617351,0,1,0
5316,23,37,40,80,64,1,3845.165,64,1973.745,LESS,854,1574,2428,3,2,-16,-1.499853537,16,1.222253018,0.27480499,-0.234056472,144,80,64,0,-0.31912044,0,-0.624266962,-0.767365737,1.042459604,1.042459604,-0.624266962,0,1,0,1
5317,23,38,31,80,78,1,3622.884,74,1005.094,LESS,368,1528,1896,5,2,-2,-0.187481692,2,-1.222253018,0.595901375,-0.334444186,158,80,78,0,-0.039890055,0,-0.07803337,0.177084401,0.592929539,0.592929539,-0.07803337,0,1,1,1
5318,23,39,46,124,110,1,8778.517,14,3181.56,LESS,74,4538,4612,9,1,-14,-1.312371845,14,0.87303787,-1.330676936,1.993969911,234,124,110,0,1.475932034,1.716734147,1.170500555,2.065984676,0.320991598,0.320991598,1.170500555,1.716734147,0,1,1
5319,23,40,58,92,110,0,3919.144,64,1488.529,LESS,-1258,2452,1194,4,1,18,1.687335229,18,1.571468165,0.27480499,-0.200645687,202,92,110,1,0.837691154,0.468200222,1.170500555,-0.295140668,-0.911053764,0.911053764,1.170500555,0.468200222,1,0,0
5320,23,41,49,110,131,1,2344.062,94,2837.186,MORE,776,988,1764,3,2,21,1.968557767,21,2.095290887,1.238094145,-0.911992505,241,110,131,0,1.615547226,1.170500555,1.989850943,-0.767365737,0.970312803,0.970312803,1.989850943,1.170500555,1,0,1
5321,23,42,13,47,50,1,4627.984,34,1585.523,MORE,-252,2368,2116,6,1,3,0.281222538,3,-1.047645444,-0.688484166,0.119484363,97,47,50,0,-1.256536731,-1.28755061,-1.170500555,0.64930947,0.019454971,0.019454971,-1.170500555,-1.28755061,0,1,0
5322,23,43,16,50,44,0,2976.171,64,1280.146,MORE,-828,1780,952,4,1,-6,-0.562445076,6,-0.523822722,0.27480499,-0.626516114,94,50,44,1,-1.316371814,-1.170500555,-1.404600665,-0.295140668,-0.513321403,0.513321403,-1.404600665,-1.170500555,0,1,0
5323,23,44,7,57,50,0,5534.289,84,2653.92,MORE,274,2686,2960,4,2,-7,-0.656185922,7,-0.349215148,0.91699776,0.528794595,107,57,50,1,-1.057086457,-0.897383758,-1.170500555,-0.295140668,0.505983395,0.505983395,-1.170500555,-0.897383758,1,1,1
5324,23,45,18,42,50,1,6015.648,14,1258.189,MORE,-540,3366,2826,7,1,8,0.749926769,8,-0.174607574,-1.330676936,0.746188479,92,42,50,0,-1.356261869,-1.482634036,-1.170500555,1.121534539,-0.246933216,0.246933216,-1.170500555,-1.482634036,0,1,0
5325,23,46,51,108,110,0,5201.659,24,1793.692,MORE,-258,2632,2374,4,1,2,0.187481692,2,-1.222253018,-1.009580551,0.378570485,218,108,110,0,1.156811594,1.092467184,1.170500555,-0.295140668,0.013905217,0.013905217,1.170500555,1.092467184,0,1,0
5326,23,47,31,78,80,1,9036.964,0,3120.823,MORE,-1792,5542,3750,10,1,2,0.187481692,2,-1.222253018,-1.780211876,2.110691105,158,78,80,0,-0.039890055,-0.07803337,0,2.538209745,-1.40498186,1.40498186,0,-0.07803337,0,1,0
5327,23,48,58,110,92,0,2203.778,100,2373.574,MORE,176,1568,1744,2,2,-18,-1.687335229,18,1.571468165,1.430751976,-0.975348303,202,110,92,1,0.837691154,1.170500555,0.468200222,-1.239590806,0.415337414,0.415337414,0.468200222,1.170500555,1,0,1
5328,23,49,12,50,48,0,3222.26,84,2349.886,MORE,-640,1954,1314,4,2,-2,-0.187481692,2,-1.222253018,0.91699776,-0.515376105,98,50,48,1,-1.236591704,-1.170500555,-1.248533925,-0.295140668,-0.339429114,0.339429114,-1.248533925,-1.170500555,1,1,0
5329,23,50,54,110,101,0,3193.828,94,2247.574,MORE,1172,1634,2806,4,2,-9,-0.843667615,9,0,1.238094145,-0.528216714,211,110,101,1,1.017196402,1.170500555,0.819350388,-0.295140668,1.33659656,1.33659656,0.819350388,1.170500555,1,1,1
5330,23,51,14,46,50,1,7236.065,14,2255.755,MORE,-114,3378,3264,7,1,4,0.374963384,4,-0.87303787,-1.330676936,1.297359625,96,46,50,0,-1.276481759,-1.326567295,-1.170500555,1.121534539,0.14709931,0.14709931,-1.170500555,-1.326567295,0,1,1
5331,23,52,22,80,83,1,4608.862,24,1382.517,MORE,-1126,3208,2082,6,1,3,0.281222538,3,-1.047645444,-1.009580551,0.110848385,163,80,83,0,0.059835082,0,0.117050055,0.64930947,-0.788959179,0.788959179,0.117050055,0,0,1,0
5332,23,53,6,50,56,1,5553.779,24,1498.048,MORE,380,2400,2780,7,1,6,0.562445076,6,-0.523822722,-1.009580551,0.537596771,106,50,56,0,-1.077031484,-1.170500555,-0.936400444,1.121534539,0.604029047,0.604029047,-0.936400444,-1.170500555,0,1,1
5333,23,54,13,50,47,0,1702.086,94,1640.75,MORE,-42,1176,1134,2,2,-3,-0.281222538,3,-1.047645444,1.238094145,-1.201925084,97,50,47,1,-1.256536731,-1.170500555,-1.28755061,-1.239590806,0.213696357,0.213696357,-1.28755061,-1.170500555,1,0,1
5334,23,55,46,110,124,0,6570.668,54,1796.595,MORE,-584,2864,2280,5,2,14,1.312371845,14,0.87303787,-0.046291396,0.996849531,234,110,124,0,1.475932034,1.170500555,1.716734147,0.177084401,-0.287631411,0.287631411,1.716734147,1.170500555,0,1,0
5335,23,56,27,91,80,0,6377.001,54,1820.078,MORE,-2158,3898,1740,6,1,-11,-1.031149307,11,0.349215148,-0.046291396,0.909384622,171,91,80,1,0.219395302,0.429183537,0,0.64930947,-1.743516847,1.743516847,0,0.429183537,0,1,0
5336,23,57,40,64,80,1,2698.174,74,3944.531,MORE,-384,2162,1778,3,2,16,1.499853537,16,1.222253018,0.595901375,-0.752066581,144,64,80,0,-0.31912044,-0.624266962,0,-0.767365737,-0.102639615,0.102639615,0,-0.624266962,1,0,0
5337,23,58,22,83,80,1,5340.369,14,1704.193,MORE,-700,3394,2694,6,1,-3,-0.281222538,3,-1.047645444,-1.330676936,0.441215424,163,83,80,1,0.059835082,0.117050055,0,0.64930947,-0.394926653,0.394926653,0,0.117050055,0,1,0
5338,23,59,54,101,110,1,2953.779,100,1243.722,MORE,528,1376,1904,4,2,9,0.843667615,9,0,1.430751976,-0.636628906,211,101,110,0,1.017196402,0.819350388,1.170500555,-0.295140668,0.740922976,0.740922976,1.170500555,0.819350388,1,1,1
5339,23,60,6,56,50,0,3482.959,84,2918.841,MORE,208,1642,1850,2,1,-6,-0.562445076,6,-0.523822722,0.91699776,-0.397637851,106,56,50,1,-1.077031484,-0.936400444,-1.170500555,-1.239590806,0.444936102,0.444936102,-1.170500555,-0.936400444,1,0,1
5340,23,61,18,50,42,0,1713.165,90,3440.048,MORE,1732,1028,2760,2,2,-8,-0.749926769,8,-0.174607574,1.109655591,-1.196921527,92,50,42,1,-1.356261869,-1.170500555,-1.482634036,-1.239590806,1.854573589,1.854573589,-1.482634036,-1.170500555,1,0,1
5341,23,62,43,110,117,1,4477.442,64,1650.425,MORE,184,1932,2116,5,2,7,0.656185922,7,-0.349215148,0.27480499,0.051495793,227,110,117,0,1.336316841,1.170500555,1.443617351,0.177084401,0.422737086,0.422737086,1.443617351,1.170500555,0,1,1
5342,23,63,32,77,80,1,4010.07,54,1683.397,MORE,478,1604,2082,3,2,3,0.281222538,3,-1.047645444,-0.046291396,-0.159581208,157,77,80,0,-0.059835082,-0.117050055,0,-0.767365737,0.694675027,0.694675027,0,-0.117050055,0,0,1
5343,23,64,27,80,91,1,4995.276,34,2038.354,MORE,-1040,3420,2380,4,1,11,1.031149307,11,0.349215148,-0.688484166,0.285362708,171,80,91,0,0.219395302,0,0.429183537,-0.295140668,-0.709412706,0.709412706,0.429183537,0,0,1,0
5344,23,65,16,44,50,1,6005.393,0,3479.209,MORE,-572,3548,2976,5,1,6,0.562445076,6,-0.523822722,-1.780211876,0.741557062,94,44,50,0,-1.316371814,-1.404600665,-1.170500555,0.177084401,-0.276531903,0.276531903,-1.170500555,-1.404600665,0,1,0
5345,23,66,7,50,57,1,7086.972,24,1044.502,MORE,-1846,4358,2512,5,1,7,0.656185922,7,-0.349215148,-1.009580551,1.23002546,107,50,57,0,-1.057086457,-1.170500555,-0.897383758,0.177084401,-1.454929645,1.454929645,-0.897383758,-1.170500555,0,1,0
5346,23,67,14,50,46,0,10712.993,24,2302.844,MORE,-4184,7054,2870,8,1,-4,-0.374963384,4,-0.87303787,-1.009580551,2.867628139,96,50,46,1,-1.276481759,-1.170500555,-1.326567295,1.593759607,-3.617483743,3.617483743,-1.326567295,-1.170500555,0,1,0
5347,23,68,51,110,108,0,3501.092,34,1679.448,MORE,-892,2354,1462,5,1,-2,-0.187481692,2,-1.222253018,-0.688484166,-0.38944853,218,110,108,1,1.156811594,1.170500555,1.092467184,0.177084401,-0.572518777,0.572518777,1.092467184,1.170500555,0,1,0
5348,23,69,50,133,110,0,3416.171,64,1781.517,MORE,-1076,2108,1032,4,1,-23,-2.15603946,23,2.444506035,0.27480499,-0.427800999,243,133,110,1,1.655437281,2.067884313,1.170500555,-0.295140668,-0.74271123,0.74271123,1.170500555,2.067884313,0,1,0
5349,23,70,49,131,110,1,6492.763,14,1041.995,MORE,-382,3384,3002,7,1,-21,-1.968557767,21,2.095290887,-1.330676936,0.961665665,241,131,110,1,1.615547226,1.989850943,1.170500555,1.121534539,-0.100789697,0.100789697,1.170500555,1.989850943,0,1,0
5350,23,71,47,126,110,0,2468.641,74,1482.792,MORE,-830,1626,796,2,1,-16,-1.499853537,16,1.222253018,0.595901375,-0.855729482,236,126,110,1,1.515822089,1.794767517,1.170500555,-1.239590806,-0.51517132,0.51517132,1.170500555,1.794767517,1,0,0
5351,23,72,50,110,133,1,3639.825,90,2019.218,MORE,1888,1430,3318,5,2,23,2.15603946,23,2.444506035,1.109655591,-0.326793203,243,110,133,0,1.655437281,1.170500555,2.067884313,0.177084401,1.99886719,1.99886719,2.067884313,1.170500555,1,1,1
5352,23,73,47,110,126,1,2461.623,84,1385.921,MORE,326,1070,1396,3,2,16,1.499853537,16,1.222253018,0.91699776,-0.858898988,236,110,126,0,1.515822089,1.170500555,1.794767517,-0.767365737,0.554081262,0.554081262,1.794767517,1.170500555,1,0,1
5353,23,74,12,48,50,1,5899.174,54,1685.006,MORE,-14,2780,2766,7,2,2,0.187481692,2,-1.222253018,-0.046291396,0.693585878,98,48,50,0,-1.236591704,-1.248533925,-1.170500555,1.121534539,0.239595208,0.239595208,-1.170500555,-1.248533925,0,1,1
5354,23,75,32,80,77,1,8113.496,14,1411.33,MORE,-898,4318,3420,10,1,-3,-0.281222538,3,-1.047645444,-1.330676936,1.693629629,157,80,77,1,-0.059835082,0,-0.117050055,2.538209745,-0.578068531,0.578068531,-0.117050055,0,0,1,0
5355,23,76,43,117,110,0,6384.662,64,1735.472,MORE,-1640,3910,2270,6,2,-7,-0.656185922,7,-0.349215148,0.27480499,0.912844523,227,117,110,1,1.336316841,1.443617351,1.170500555,0.64930947,-1.264388095,1.264388095,1.170500555,1.443617351,1,1,0
5356,23,77,40,80,64,0,1466.661,100,775.637,MORE,-166,1136,970,2,2,-16,-1.499853537,16,1.222253018,1.430751976,-1.308248961,144,80,64,1,-0.31912044,0,-0.624266962,-1.239590806,0.099001443,0.099001443,-0.624266962,0,1,0,1
5357,23,78,31,80,78,1,3374.687,44,1703.678,MORE,60,1498,1558,5,2,-2,-0.187481692,2,-1.222253018,-0.367387781,-0.446536221,158,80,78,1,-0.039890055,0,-0.07803337,0.177084401,0.308042173,0.308042173,-0.07803337,0,0,1,1
5358,23,79,46,124,110,0,4830.295,4,2108.004,MORE,-2586,4034,1448,4,1,-14,-1.312371845,14,0.87303787,-1.651773322,0.210853121,234,124,110,1,1.475932034,1.716734147,1.170500555,-0.295140668,-2.139399291,2.139399291,1.170500555,1.716734147,0,1,0
5359,23,80,58,92,110,1,2760.83,64,1437.516,MORE,174,1280,1454,4,1,18,1.687335229,18,1.571468165,0.27480499,-0.723769549,202,92,110,0,0.837691154,0.468200222,1.170500555,-0.295140668,0.413487496,0.413487496,1.170500555,0.468200222,1,1,1
5360,23,81,48,128,110,0,5203.747,0,2345.062,LESS,-2680,4244,1564,7,1,-18,-1.687335229,18,1.571468165,-1.780211876,0.379513478,238,128,110,0,1.555712144,1.872800887,1.170500555,1.121534539,-2.226345435,2.226345435,1.170500555,1.872800887,0,1,0
5361,23,82,8,50,58,0,12041.247,34,1498.965,LESS,-1786,6564,4778,11,1,8,0.749926769,8,-0.174607574,-0.688484166,3.467501198,108,50,58,1,-1.037141429,-1.170500555,-0.858367073,3.010434814,-1.399432106,1.399432106,-0.858367073,-1.170500555,0,1,0
5362,23,83,4,54,50,0,4817.539,34,1787.103,LESS,-1302,3110,1808,6,1,-4,-0.374963384,4,-0.87303787,-0.688484166,0.205092189,104,54,50,0,-1.116921539,-1.014433814,-1.170500555,0.64930947,-0.95175196,0.95175196,-1.170500555,-1.014433814,0,1,0
5363,23,84,37,80,69,1,3252.75,84,2711.459,LESS,214,1334,1548,3,2,-11,-1.031149307,11,0.349215148,0.91699776,-0.501606051,149,80,69,0,-0.219395302,0,-0.429183537,-0.767365737,0.450485856,0.450485856,-0.429183537,0,1,0,1
5364,23,85,52,105,110,1,5834.547,74,4098.108,LESS,474,2316,2790,5,1,5,0.46870423,5,-0.698430296,0.595901375,0.664398693,215,105,110,1,1.096976512,0.975417129,1.170500555,0.177084401,0.690975191,0.690975191,1.170500555,0.975417129,1,1,1
5365,23,86,5,55,50,0,3037.466,94,891.166,LESS,28,1694,1722,4,2,-5,-0.46870423,5,-0.698430296,1.238094145,-0.598833743,105,55,50,0,-1.096976512,-0.975417129,-1.170500555,-0.295140668,0.278443485,0.278443485,-1.170500555,-0.975417129,1,0,1
5366,23,87,30,96,80,1,2475.963,80,1747.367,LESS,978,1148,2126,3,2,-16,-1.499853537,16,1.222253018,0.788559206,-0.852422682,176,96,80,0,0.31912044,0.624266962,0,-0.767365737,1.157154517,1.157154517,0,0.624266962,1,0,1
5367,23,88,33,80,75,1,6641.422,24,1136.116,LESS,-854,3846,2992,8,1,-5,-0.46870423,5,-0.698430296,-1.009580551,1.028803825,155,80,75,0,-0.099725137,0,-0.195083426,1.593759607,-0.537370336,0.537370336,-0.195083426,0,0,1,0
5368,23,89,48,110,128,0,3295.507,100,1477.966,LESS,110,1950,2060,4,2,18,1.687335229,18,1.571468165,1.430751976,-0.482295909,238,110,128,1,1.555712144,1.170500555,1.872800887,-0.295140668,0.354290122,0.354290122,1.872800887,1.170500555,1,0,1
5369,23,90,9,59,50,1,2693.041,14,1110.917,LESS,-1038,2028,990,4,1,-9,-0.843667615,9,0,-1.330676936,-0.754384774,109,59,50,0,-1.017196402,-0.819350388,-1.170500555,-0.295140668,-0.707562789,0.707562789,-1.170500555,-0.819350388,0,0,0
5370,23,91,44,110,119,0,4536.877,64,1568.325,LESS,-152,2040,1888,6,1,9,0.843667615,9,0,0.27480499,0.078338141,229,110,119,1,1.376206896,1.170500555,1.521650721,0.64930947,0.111950869,0.111950869,1.521650721,1.170500555,1,1,1
5371,23,92,2,52,50,0,4190.215,84,1587.014,LESS,-280,2356,2076,6,2,-2,-0.187481692,2,-1.222253018,0.91699776,-0.078223176,102,52,50,0,-1.156811594,-1.092467184,-1.170500555,0.64930947,-0.006443881,0.006443881,-1.170500555,-1.092467184,1,1,0
5372,23,93,8,58,50,1,2792.557,34,1133.102,LESS,-278,1120,842,3,2,-8,-0.749926769,8,-0.174607574,-0.688484166,-0.709440834,108,58,50,0,-1.037141429,-0.858367073,-1.170500555,-0.767365737,-0.004593963,0.004593963,-1.170500555,-0.858367073,0,0,0
5373,23,94,44,119,110,0,1678.978,74,3620.428,LESS,274,1402,1676,2,1,-9,-0.843667615,9,0,0.595901375,-1.21236124,229,119,110,0,1.376206896,1.521650721,1.170500555,-1.239590806,0.505983395,0.505983395,1.170500555,1.521650721,1,0,1
5374,23,95,34,74,80,1,4975.688,14,2444.874,LESS,-2810,4824,2014,4,1,6,0.562445076,6,-0.523822722,-1.330676936,0.276516273,154,74,80,1,-0.119670165,-0.234100111,0,-0.295140668,-2.346590103,2.346590103,0,-0.234100111,0,0,0
5375,23,96,24,86,80,1,4649.152,24,1708.039,LESS,-454,2842,2388,6,1,-6,-0.562445076,6,-0.523822722,-1.009580551,0.129044367,166,86,80,0,0.119670165,0.234100111,0,0.64930947,-0.167386744,0.167386744,0,0.234100111,0,1,0
5376,23,97,39,66,80,0,3011.419,100,1878.114,LESS,-530,1996,1466,2,2,14,1.312371845,14,0.87303787,1.430751976,-0.610597226,146,66,80,1,-0.279230385,-0.546233592,0,-1.239590806,-0.237683626,0.237683626,0,-0.546233592,1,0,0
5377,23,98,9,50,59,0,2162.661,100,1188.24,LESS,-280,1592,1312,3,2,9,0.843667615,9,0,1.430751976,-0.993917779,109,50,59,1,-1.017196402,-1.170500555,-0.819350388,-0.767365737,-0.006443881,0.006443881,-0.819350388,-1.170500555,1,0,0
5378,23,99,57,94,110,0,1892.987,84,3278.922,LESS,-512,2078,1566,3,2,16,1.499853537,16,1.222253018,0.91699776,-1.11570937,204,94,110,1,0.877581209,0.546233592,1.170500555,-0.767365737,-0.221034365,0.221034365,1.170500555,0.546233592,1,0,0
5379,23,100,60,110,87,1,3277.054,34,2852.404,LESS,-788,2454,1666,3,1,-23,-2.15603946,23,2.444506035,-0.688484166,-0.49062975,197,110,87,0,0.737966017,1.170500555,0.273116796,-0.767365737,-0.476323043,0.476323043,0.273116796,1.170500555,0,0,0
5380,23,101,33,75,80,0,1947.047,94,1586.229,LESS,204,1168,1372,2,2,5,0.46870423,5,-0.698430296,1.238094145,-1.091294508,155,75,80,1,-0.099725137,-0.195083426,0,-1.239590806,0.441236266,0.441236266,0,-0.195083426,1,0,1
5381,23,102,15,50,45,1,4248.472,4,3687.609,LESS,-1232,3170,1938,5,1,-5,-0.46870423,5,-0.698430296,-1.651773322,-0.051912843,95,50,45,0,-1.296426786,-1.170500555,-1.36558398,0.177084401,-0.887004831,0.887004831,-1.36558398,-1.170500555,0,1,0
5382,23,103,59,89,110,0,7842.359,14,1146.492,LESS,-1932,4780,2848,6,1,21,1.968557767,21,2.095290887,-1.330676936,1.57117731,199,89,110,1,0.777856072,0.351150166,1.170500555,0.64930947,-1.534476118,1.534476118,1.170500555,0.351150166,0,1,0
5383,23,104,29,80,94,0,5183.759,34,2171.436,LESS,-232,2424,2192,6,1,14,1.312371845,14,0.87303787,-0.688484166,0.370486392,174,80,94,1,0.279230385,0,0.546233592,0.64930947,0.03795415,0.03795415,0.546233592,0,0,1,0
5384,23,105,55,110,98,1,5946.455,64,2050.379,LESS,376,2622,2998,7,2,-12,-1.124890153,12,0.523822722,0.27480499,0.714939172,208,110,98,0,0.957361319,1.170500555,0.702300333,1.121534539,0.600329211,0.600329211,0.702300333,1.170500555,1,1,1
5385,23,106,29,94,80,1,5577.324,34,1835.877,LESS,944,1942,2886,4,2,-14,-1.312371845,14,0.87303787,-0.688484166,0.548230288,174,94,80,0,0.279230385,0.546233592,0,-0.295140668,1.125705912,1.125705912,0,0.546233592,0,0,1
5386,23,107,57,110,94,1,4187.894,64,2177.114,LESS,-144,2120,1976,3,1,-16,-1.499853537,16,1.222253018,0.27480499,-0.079271398,204,110,94,0,0.877581209,1.170500555,0.546233592,-0.767365737,0.119350541,0.119350541,0.546233592,1.170500555,1,0,1
5387,23,108,39,80,66,1,2364.475,84,1270.431,LESS,552,1090,1642,3,2,-14,-1.312371845,14,0.87303787,0.91699776,-0.902773479,146,80,66,0,-0.279230385,0,-0.546233592,-0.767365737,0.763121991,0.763121991,-0.546233592,0,1,0,1
5388,23,109,4,50,54,0,2721.997,90,2367.886,LESS,470,1654,2124,4,2,4,0.374963384,4,-0.87303787,1.109655591,-0.741307513,104,50,54,1,-1.116921539,-1.170500555,-1.014433814,-0.295140668,0.687275355,0.687275355,-1.014433814,-1.170500555,1,0,1
5389,23,110,55,98,110,0,3528.017,44,1649.774,LESS,-464,1698,1234,4,1,12,1.124890153,12,0.523822722,-0.367387781,-0.37728852,208,98,110,1,0.957361319,0.702300333,1.170500555,-0.295140668,-0.176636333,0.176636333,1.170500555,0.702300333,0,0,0
5390,23,111,2,50,52,1,3819.64,34,1767.517,LESS,558,1450,2008,5,2,2,0.187481692,2,-1.222253018,-0.688484166,-0.245584207,102,50,52,1,-1.156811594,-1.170500555,-1.092467184,0.177084401,0.768671745,0.768671745,-1.092467184,-1.170500555,0,1,1
5391,23,112,59,110,89,1,6035.808,4,2361.035,LESS,280,3020,3300,5,1,-21,-1.968557767,21,2.095290887,-1.651773322,0.755293244,199,110,89,0,0.777856072,1.170500555,0.351150166,0.177084401,0.511533148,0.511533148,0.351150166,1.170500555,0,1,1
5392,23,113,60,87,110,0,1583.491,100,1744.302,LESS,-36,1168,1132,2,2,23,2.15603946,23,2.444506035,1.430751976,-1.255485582,197,87,110,1,0.737966017,0.273116796,1.170500555,-1.239590806,0.21924611,0.21924611,1.170500555,0.273116796,1,0,1
5393,23,114,52,110,105,1,4636.445,14,1146.941,LESS,316,2162,2478,4,1,-5,-0.46870423,5,-0.698430296,-1.330676936,0.123305564,215,110,105,0,1.096976512,1.170500555,0.975417129,-0.295140668,0.544831672,0.544831672,0.975417129,1.170500555,0,0,1
5394,23,115,30,80,96,0,4978.054,84,2553.233,LESS,-2552,4124,1572,5,2,16,1.499853537,16,1.222253018,0.91699776,0.277584818,176,80,96,1,0.31912044,0,0.624266962,0.177084401,-2.107950686,2.107950686,0.624266962,0,1,1,0
5395,23,116,24,80,86,1,5937.286,34,1922.396,LESS,414,2664,3078,5,1,6,0.562445076,6,-0.523822722,-0.688484166,0.71079822,166,80,86,1,0.119670165,0,0.234100111,0.177084401,0.635477652,0.635477652,0.234100111,0,0,1,1
5396,23,117,5,50,55,1,4285.335,64,2392.672,LESS,-58,2018,1960,4,1,5,0.46870423,5,-0.698430296,0.27480499,-0.035264581,105,50,55,1,-1.096976512,-1.170500555,-0.975417129,-0.295140668,0.198897013,0.198897013,-0.975417129,-1.170500555,0,0,1
5397,23,118,34,80,74,0,2874.753,84,2644.987,LESS,24,1718,1742,4,2,-6,-0.562445076,6,-0.523822722,0.91699776,-0.672319044,154,80,74,0,-0.119670165,0,-0.234100111,-0.295140668,0.274743649,0.274743649,-0.234100111,0,1,0,1
5398,23,119,15,45,50,0,2423.803,84,922.284,LESS,-876,1802,926,2,2,5,0.46870423,5,-0.698430296,0.91699776,-0.875979456,95,45,50,1,-1.296426786,-1.36558398,-1.170500555,-1.239590806,-0.557719434,0.557719434,-1.170500555,-1.36558398,1,0,0
5399,23,120,37,69,80,0,2091.791,74,3516.867,LESS,-156,1940,1784,2,2,11,1.031149307,11,0.349215148,0.595901375,-1.025924462,149,69,80,1,-0.219395302,-0.429183537,0,-1.239590806,0.108251033,0.108251033,0,-0.429183537,1,0,1
5400,23,121,48,128,110,0,2978.324,74,2082.087,MORE,-212,1384,1172,4,1,-18,-1.687335229,18,1.571468165,0.595901375,-0.625543764,238,128,110,1,1.555712144,1.872800887,1.170500555,-0.295140668,0.05645333,0.05645333,1.170500555,1.872800887,1,1,1
5401,23,122,8,50,58,1,2394.95,84,1446.452,MORE,620,886,1506,2,2,8,0.749926769,8,-0.174607574,0.91699776,-0.889010199,108,50,58,0,-1.037141429,-1.170500555,-0.858367073,-1.239590806,0.826019202,0.826019202,-0.858367073,-1.170500555,1,0,1
5402,23,123,4,54,50,0,4043.489,14,1503.629,MORE,-2086,3408,1322,4,1,-4,-0.374963384,4,-0.87303787,-1.330676936,-0.144488344,104,54,50,1,-1.116921539,-1.014433814,-1.170500555,-0.295140668,-1.676919801,1.676919801,-1.170500555,-1.014433814,0,1,0
5403,23,124,37,80,69,0,3110.236,64,1932.583,MORE,-688,1766,1078,4,1,-11,-1.031149307,11,0.349215148,0.27480499,-0.565968973,149,80,69,1,-0.219395302,0,-0.429183537,-0.295140668,-0.383827145,0.383827145,-0.429183537,0,1,1,0
5404,23,125,52,105,110,1,2338.162,84,1673.042,MORE,788,934,1722,3,2,5,0.46870423,5,-0.698430296,0.91699776,-0.914657094,215,105,110,0,1.096976512,0.975417129,1.170500555,-0.767365737,0.981412311,0.981412311,1.170500555,0.975417129,1,0,1
5405,23,126,5,55,50,0,1902.047,84,2726.256,MORE,258,976,1234,4,2,-5,-0.46870423,5,-0.698430296,0.91699776,-1.111617645,105,55,50,1,-1.096976512,-0.975417129,-1.170500555,-0.295140668,0.491184051,0.491184051,-1.170500555,-0.975417129,1,1,1
5406,23,127,30,96,80,0,3217.385,34,2582.066,MORE,-338,1826,1488,4,2,-16,-1.499853537,16,1.222253018,-0.688484166,-0.517577778,176,96,80,1,0.31912044,0.624266962,0,-0.295140668,-0.060091502,0.060091502,0,0.624266962,0,1,0
5407,23,128,33,80,75,0,4795.25,4,1482.148,MORE,-2118,3668,1550,4,1,-5,-0.46870423,5,-0.698430296,-1.651773322,0.195025914,155,80,75,1,-0.099725137,0,-0.195083426,-0.295140668,-1.706518488,1.706518488,-0.195083426,0,0,1,0
5408,23,129,48,110,128,1,2186.1,100,2156.826,MORE,914,844,1758,3,2,18,1.687335229,18,1.571468165,1.430751976,-0.983332135,238,110,128,0,1.555712144,1.170500555,1.872800887,-0.767365737,1.097957142,1.097957142,1.872800887,1.170500555,1,0,1
5409,23,130,9,59,50,0,1925.543,94,1016.491,MORE,-240,1276,1036,2,2,-9,-0.843667615,9,0,1.238094145,-1.101006258,109,59,50,1,-1.017196402,-0.819350388,-1.170500555,-1.239590806,0.030554478,0.030554478,-1.170500555,-0.819350388,1,0,0
5410,23,131,44,110,119,0,4451.032,4,2495.323,MORE,-2910,4370,1460,6,1,9,0.843667615,9,0,-1.651773322,0.03956837,229,110,119,0,1.376206896,1.170500555,1.521650721,0.64930947,-2.439086001,2.439086001,1.521650721,1.170500555,0,1,0
5411,23,132,2,52,50,0,3095.197,94,2429.521,MORE,86,2076,2162,4,2,-2,-0.187481692,2,-1.222253018,1.238094145,-0.572760965,102,52,50,1,-1.156811594,-1.092467184,-1.170500555,-0.295140668,0.332091106,0.332091106,-1.170500555,-1.092467184,1,1,1
5412,23,133,8,58,50,1,7624.386,74,1234.876,MORE,-304,3680,3376,9,2,-8,-0.749926769,8,-0.174607574,0.595901375,1.472735197,108,58,50,1,-1.037141429,-0.858367073,-1.170500555,2.065984676,-0.028642896,0.028642896,-1.170500555,-0.858367073,1,1,0
5413,23,134,44,119,110,0,2704.182,84,2003.679,MORE,-506,1772,1266,2,2,-9,-0.843667615,9,0,0.91699776,-0.749353217,229,119,110,1,1.376206896,1.521650721,1.170500555,-1.239590806,-0.215484611,0.215484611,1.170500555,1.521650721,1,0,0
5414,23,135,34,74,80,1,4213.814,0,2806.567,MORE,-1592,3530,1938,4,1,6,0.562445076,6,-0.523822722,-1.780211876,-0.067565271,154,74,80,0,-0.119670165,-0.234100111,0,-0.295140668,-1.219990064,1.219990064,0,-0.234100111,0,1,0
5415,23,136,24,86,80,0,3277.911,74,1290.465,MORE,-1358,2182,824,3,1,-6,-0.562445076,6,-0.523822722,0.595901375,-0.490242707,166,86,80,1,0.119670165,0.234100111,0,-0.767365737,-1.003549662,1.003549662,0,0.234100111,1,0,0
5416,23,137,39,66,80,1,1742.037,74,890.34,MORE,826,662,1488,3,2,14,1.312371845,14,0.87303787,0.595901375,-1.183882203,146,66,80,0,-0.279230385,-0.546233592,0,-0.767365737,1.016560752,1.016560752,0,-0.546233592,1,0,1
5417,23,138,9,50,59,1,1585.672,100,2209.435,MORE,2584,404,2988,3,2,9,0.843667615,9,0,1.430751976,-1.254500587,109,50,59,0,-1.017196402,-1.170500555,-0.819350388,-0.767365737,2.642638641,2.642638641,-0.819350388,-1.170500555,1,0,1
5418,23,139,57,94,110,1,2365.385,64,1118.202,MORE,116,962,1078,2,2,16,1.499853537,16,1.222253018,0.27480499,-0.9023625,204,94,110,0,0.877581209,0.546233592,1.170500555,-1.239590806,0.359839876,0.359839876,1.170500555,0.546233592,1,0,1
5419,23,140,60,110,87,0,2278.348,84,1441.474,MORE,-362,1524,1162,4,2,-23,-2.15603946,23,2.444506035,0.91699776,-0.941670608,197,110,87,1,0.737966017,1.170500555,0.273116796,-0.295140668,-0.082290517,0.082290517,0.273116796,1.170500555,1,1,0
5420,23,141,33,75,80,1,3189.707,64,1218.352,MORE,382,1398,1780,5,2,5,0.46870423,5,-0.698430296,0.27480499,-0.530077862,155,75,80,0,-0.099725137,-0.195083426,0,0.177084401,0.605878965,0.605878965,0,-0.195083426,1,1,1
5421,23,142,15,50,45,0,5392.648,0,1537.301,MORE,-1974,4088,2114,4,1,-5,-0.46870423,5,-0.698430296,-1.780211876,0.464825941,95,50,45,1,-1.296426786,-1.170500555,-1.36558398,-0.295140668,-1.573324395,1.573324395,-1.36558398,-1.170500555,0,0,0
5422,23,143,59,89,110,1,2210.893,90,2447.405,MORE,2264,1044,3308,3,2,21,1.968557767,21,2.095290887,1.109655591,-0.97213499,199,89,110,0,0.777856072,0.351150166,1.170500555,-0.767365737,2.346651767,2.346651767,1.170500555,0.351150166,1,0,1
5423,23,144,29,80,94,1,3352.195,74,1767.38,MORE,1834,1170,3004,3,2,14,1.312371845,14,0.87303787,0.595901375,-0.456694177,174,80,94,0,0.279230385,0,0.546233592,-0.767365737,1.948919405,1.948919405,0.546233592,0,1,0,1
5424,23,145,55,110,98,1,4265.469,34,1116.766,MORE,-224,2084,1860,5,2,-12,-1.124890153,12,0.523822722,-0.688484166,-0.044236568,208,110,98,1,0.957361319,1.170500555,0.702300333,0.177084401,0.045353822,0.045353822,0.702300333,1.170500555,0,1,0
5425,23,146,29,94,80,0,8368.841,4,1937.292,MORE,-2100,5444,3344,8,1,-14,-1.312371845,14,0.87303787,-1.651773322,1.808949881,174,94,80,1,0.279230385,0.546233592,0,1.593759607,-1.689869226,1.689869226,0,0.546233592,0,1,0
5426,23,147,57,110,94,0,3526.597,74,1939.834,MORE,-470,2172,1702,4,2,-16,-1.499853537,16,1.222253018,0.595901375,-0.377929828,204,110,94,1,0.877581209,1.170500555,0.546233592,-0.295140668,-0.182186087,0.182186087,0.546233592,1.170500555,1,0,0
5427,23,148,39,80,66,0,3109.193,94,1897.679,MORE,298,1708,2006,4,2,-14,-1.312371845,14,0.87303787,1.238094145,-0.566440018,146,80,66,1,-0.279230385,0,-0.546233592,-0.295140668,0.52818241,0.52818241,-0.546233592,0,1,0,1
5428,23,149,4,50,54,0,4880.341,64,1328.254,MORE,-394,2468,2074,6,1,4,0.374963384,4,-0.87303787,0.27480499,0.233455159,104,50,54,0,-1.116921539,-1.170500555,-1.014433814,0.64930947,-0.111889205,0.111889205,-1.014433814,-1.170500555,1,1,0
5429,23,150,55,98,110,1,1698.801,100,918.233,MORE,174,910,1084,2,2,12,1.124890153,12,0.523822722,1.430751976,-1.203408673,208,98,110,0,0.957361319,0.702300333,1.170500555,-1.239590806,0.413487496,0.413487496,1.170500555,0.702300333,1,0,1
5430,23,151,2,50,52,1,3014.328,74,1306.425,MORE,1548,910,2458,3,2,2,0.187481692,2,-1.222253018,0.595901375,-0.609283448,102,50,52,0,-1.156811594,-1.170500555,-1.092467184,-0.767365737,1.684381136,1.684381136,-1.092467184,-1.170500555,1,0,1
5431,23,152,59,110,89,0,5611.193,4,1197.995,MORE,-1506,3574,2068,6,1,-21,-1.968557767,21,2.095290887,-1.651773322,0.563526384,199,110,89,1,0.777856072,1.170500555,0.351150166,0.64930947,-1.140443592,1.140443592,0.351150166,1.170500555,0,1,0
5432,23,153,60,87,110,1,2165.3,84,1133.948,MORE,670,830,1500,3,2,23,2.15603946,23,2.444506035,0.91699776,-0.99272594,197,87,110,0,0.737966017,0.273116796,1.170500555,-0.767365737,0.872267151,0.872267151,1.170500555,0.273116796,1,0,1
5433,23,154,52,110,105,0,4414.14,34,1870.029,MORE,-808,2484,1676,3,1,-5,-0.46870423,5,-0.698430296,-0.688484166,0.022907011,215,110,105,1,1.096976512,1.170500555,0.975417129,-0.767365737,-0.494822223,0.494822223,0.975417129,1.170500555,0,0,0
5434,23,155,30,80,96,1,4289.097,74,1652.391,MORE,770,1736,2506,4,2,16,1.499853537,16,1.222253018,0.595901375,-0.033565567,176,80,96,0,0.31912044,0,0.624266962,-0.295140668,0.964763049,0.964763049,0.624266962,0,1,0,1
5435,23,156,24,80,86,1,1643.303,84,2356.227,MORE,1390,766,2156,3,2,6,0.562445076,6,-0.523822722,0.91699776,-1.228472971,166,80,86,0,0.119670165,0,0.234100111,-0.767365737,1.538237617,1.538237617,0.234100111,0,1,0,1
5436,23,157,5,50,55,1,2858.929,84,1238.658,MORE,1244,986,2230,3,2,5,0.46870423,5,-0.698430296,0.91699776,-0.679465562,105,50,55,0,-1.096976512,-1.170500555,-0.975417129,-0.767365737,1.403193606,1.403193606,-0.975417129,-1.170500555,1,0,1
5437,23,158,34,80,74,0,3979.11,34,1179.837,MORE,-322,1570,1248,4,1,-6,-0.562445076,6,-0.523822722,-0.688484166,-0.173563526,154,80,74,1,-0.119670165,0,-0.234100111,-0.295140668,-0.045292158,0.045292158,-0.234100111,0,0,0,0
5438,23,159,15,45,50,1,4881.373,54,1615.873,MORE,940,1740,2680,4,2,5,0.46870423,5,-0.698430296,-0.046291396,0.233921236,95,45,50,0,-1.296426786,-1.36558398,-1.170500555,-0.295140668,1.122006076,1.122006076,-1.170500555,-1.36558398,0,0,1
5439,23,160,37,69,80,1,2245.528,74,1575.451,MORE,1894,846,2740,3,2,11,1.031149307,11,0.349215148,0.595901375,-0.956492949,149,69,80,0,-0.219395302,-0.429183537,0,-0.767365737,2.004416944,2.004416944,0,-0.429183537,1,0,1
5440,23,161,3,50,53,1,4417.729,10,1716.549,LESS,-642,3004,2362,7,1,3,0.281222538,3,-1.047645444,-1.45911549,0.024527894,103,50,53,1,-1.136866566,-1.170500555,-1.053450499,1.121534539,-0.341279032,0.341279032,-1.053450499,-1.170500555,0,1,0
5441,23,162,20,50,40,1,1847.285,94,1852.431,LESS,1642,682,2324,3,2,-10,-0.937408461,10,0.174607574,1.238094145,-1.136349548,90,50,40,0,-1.396151924,-1.170500555,-1.560667406,-0.767365737,1.771327281,1.771327281,-1.560667406,-1.170500555,1,0,1
5442,23,163,25,80,88,0,4153.333,24,1514.672,LESS,-784,2474,1690,5,1,8,0.749926769,8,-0.174607574,-1.009580551,-0.094880018,168,80,88,1,0.15956022,0,0.312133481,0.177084401,-0.472623207,0.472623207,0.312133481,0,0,1,0
5443,23,164,42,115,110,1,5662.976,14,1506.829,LESS,-662,3466,2804,7,1,-5,-0.46870423,5,-0.698430296,-1.330676936,0.586912895,225,115,110,0,1.296426786,1.36558398,1.170500555,1.121534539,-0.359778212,0.359778212,1.170500555,1.36558398,0,1,0
5444,23,165,53,103,110,0,3128.357,84,2355.868,LESS,354,2340,2694,5,2,7,0.656185922,7,-0.349215148,0.91699776,-0.557785072,213,103,110,1,1.057086457,0.897383758,1.170500555,0.177084401,0.579980113,0.579980113,1.170500555,0.897383758,1,1,1
5445,23,166,26,90,80,1,3775.908,44,2095.488,LESS,454,1534,1988,7,2,-10,-0.937408461,10,0.174607574,-0.367387781,-0.265334682,170,90,80,0,0.199450275,0.390166852,0,1.121534539,0.672476011,0.672476011,0,0.390166852,0,1,1
5446,23,167,35,80,72,1,7483.732,54,1942.949,LESS,122,3404,3526,7,2,-8,-0.749926769,8,-0.174607574,-0.046291396,1.409212298,152,80,72,0,-0.15956022,0,-0.312133481,1.121534539,0.365389629,0.365389629,-0.312133481,0,0,1,1
5447,23,168,28,93,80,0,3086.677,84,1290.466,LESS,-506,1978,1472,4,2,-13,-1.218630999,13,0.698430296,0.91699776,-0.576608812,173,93,80,0,0.259285357,0.507216907,0,-0.295140668,-0.215484611,0.215484611,0,0.507216907,1,0,0
5448,23,169,26,80,90,0,2724.531,84,1914.787,LESS,-62,1696,1634,4,2,10,0.937408461,10,0.174607574,0.91699776,-0.740163094,170,80,90,1,0.199450275,0,0.390166852,-0.295140668,0.195197177,0.195197177,0.390166852,0,1,0,1
5449,23,170,25,88,80,1,14799.597,14,3035.993,LESS,-3410,9134,5724,14,1,-8,-0.749926769,8,-0.174607574,-1.330676936,4.713241736,168,88,80,0,0.15956022,0.312133481,0,4.427110021,-2.901565492,2.901565492,0,0.312133481,0,1,0
5450,23,171,36,80,70,0,4785.198,74,2423.931,LESS,-130,2812,2682,5,2,-10,-0.937408461,10,0.174607574,0.595901375,0.190486177,150,80,70,0,-0.199450275,0,-0.390166852,0.177084401,0.132299966,0.132299966,-0.390166852,0,1,1,1
5451,23,172,28,80,93,0,4683.189,64,2543.158,LESS,-716,2444,1728,3,1,13,1.218630999,13,0.698430296,0.27480499,0.144416336,173,80,93,1,0.259285357,0,0.507216907,-0.767365737,-0.409725997,0.409725997,0.507216907,0,1,0,0
5452,23,173,21,82,80,0,1716.5,90,1106.101,LESS,402,914,1316,2,2,-2,-0.187481692,2,-1.222253018,1.109655591,-1.195415357,162,82,80,0,0.039890055,0.07803337,0,-1.239590806,0.624378144,0.624378144,0,0.07803337,1,0,1
5453,23,174,19,50,41,1,3201.775,84,1452.371,LESS,778,1326,2104,5,2,-9,-0.843667615,9,0,0.91699776,-0.524627648,91,50,41,0,-1.376206896,-1.170500555,-1.521650721,0.177084401,0.972162721,0.972162721,-1.521650721,-1.170500555,1,1,1
5454,23,175,56,96,110,0,6216.332,64,967.565,LESS,-200,2666,2466,10,1,14,1.312371845,14,0.87303787,0.27480499,0.836822443,206,96,110,1,0.917471264,0.624266962,1.170500555,2.538209745,0.067552838,0.067552838,1.170500555,0.624266962,1,1,1
5455,23,176,23,80,85,1,10104.012,24,1377.493,LESS,-918,5530,4612,10,1,5,0.46870423,5,-0.698430296,-1.009580551,2.592596936,165,80,85,1,0.099725137,0,0.195083426,2.538209745,-0.596567711,0.596567711,0.195083426,0,0,1,0
5456,23,177,10,60,50,1,2600.535,74,2461.754,LESS,-18,1528,1510,2,2,-10,-0.937408461,10,0.174607574,0.595901375,-0.79616282,110,60,50,0,-0.997251374,-0.780333703,-1.170500555,-1.239590806,0.235895372,0.235895372,-1.170500555,-0.780333703,1,0,1
5457,23,178,19,41,50,0,1775.276,100,2627.207,LESS,184,1198,1382,2,2,9,0.843667615,9,0,1.430751976,-1.168870631,91,41,50,1,-1.376206896,-1.521650721,-1.170500555,-1.239590806,0.422737086,0.422737086,-1.170500555,-1.521650721,1,0,1
5458,23,179,56,110,96,1,2897.693,74,1464.661,LESS,912,1088,2000,5,2,-14,-1.312371845,14,0.87303787,0.595901375,-0.661958761,206,110,96,0,0.917471264,1.170500555,0.624266962,0.177084401,1.096107225,1.096107225,0.624266962,1.170500555,1,1,1
5459,23,180,35,72,80,0,3046.368,64,957.15,LESS,-960,1922,962,4,1,8,0.749926769,8,-0.174607574,0.27480499,-0.594813375,152,72,80,1,-0.15956022,-0.312133481,0,-0.295140668,-0.635415988,0.635415988,0,-0.312133481,1,0,0
5460,23,181,11,49,50,1,3664.812,74,1199.51,LESS,1390,1230,2620,3,2,1,0.093740846,1,-1.396860592,0.595901375,-0.315508442,99,49,50,1,-1.216646676,-1.20951724,-1.170500555,-0.767365737,1.538237617,1.538237617,-1.170500555,-1.20951724,1,0,1
5461,23,182,17,43,50,0,6023.569,34,2214.322,LESS,-62,2808,2746,6,1,7,0.656185922,7,-0.349215148,-0.688484166,0.749765803,93,43,50,1,-1.336316841,-1.443617351,-1.170500555,0.64930947,0.195197177,0.195197177,-1.170500555,-1.443617351,0,1,1
5462,23,183,1,51,50,1,2116.203,14,2137.096,LESS,152,1292,1444,3,1,-1,-0.093740846,1,-1.396860592,-1.330676936,-1.014899386,101,51,50,0,-1.176756621,-1.131483869,-1.170500555,-0.767365737,0.393138399,0.393138399,-1.170500555,-1.131483869,0,0,1
5463,23,184,41,112,110,1,6664.439,24,1835.94,LESS,894,2614,3508,7,2,-2,-0.187481692,2,-1.222253018,-1.009580551,1.039198883,222,112,110,0,1.236591704,1.248533925,1.170500555,1.121534539,1.079457963,1.079457963,1.170500555,1.248533925,0,1,1
5464,23,185,20,40,50,0,1934.764,100,2573.952,LESS,-158,1418,1260,2,2,10,0.937408461,10,0.174607574,1.430751976,-1.096841821,90,40,50,1,-1.396151924,-1.560667406,-1.170500555,-1.239590806,0.106401115,0.106401115,-1.170500555,-1.560667406,1,0,1
5465,23,186,1,50,51,1,2015.064,84,849.696,LESS,756,866,1622,3,2,1,0.093740846,1,-1.396860592,0.91699776,-1.060576313,101,50,51,1,-1.176756621,-1.170500555,-1.131483869,-0.767365737,0.951813623,0.951813623,-1.131483869,-1.170500555,1,0,1
5466,23,187,23,85,80,0,1914.668,34,1526.342,LESS,-864,1388,524,2,1,-5,-0.46870423,5,-0.698430296,-0.688484166,-1.105917683,165,85,80,0,0.099725137,0.195083426,0,-1.239590806,-0.546619926,0.546619926,0,0.195083426,0,0,0
5467,23,188,11,50,49,0,3160.426,10,1479.312,LESS,-2030,2964,934,4,1,-1,-0.093740846,1,-1.396860592,-1.45911549,-0.543301901,99,50,49,0,-1.216646676,-1.170500555,-1.20951724,-0.295140668,-1.625122098,1.625122098,-1.20951724,-1.170500555,0,0,0
5468,23,189,17,50,43,1,6760.503,64,2761.834,LESS,662,2780,3442,7,2,-7,-0.656185922,7,-0.349215148,0.27480499,1.082583812,93,50,43,0,-1.336316841,-1.170500555,-1.443617351,1.121534539,0.864867479,0.864867479,-1.443617351,-1.170500555,0,1,1
5469,23,190,21,80,82,0,3184.714,44,1373.217,LESS,-1026,2186,1160,4,1,2,0.187481692,2,-1.222253018,-0.367387781,-0.532332827,162,80,82,1,0.039890055,0,0.07803337,-0.295140668,-0.696463281,0.696463281,0.07803337,0,0,0,0
5470,23,191,10,50,60,0,3722.876,84,1325.628,LESS,-366,1940,1574,6,2,10,0.937408461,10,0.174607574,0.91699776,-0.289285273,110,50,60,1,-0.997251374,-1.170500555,-0.780333703,0.64930947,-0.085990353,0.085990353,-0.780333703,-1.170500555,1,1,0
5471,23,192,3,53,50,0,8232.712,44,2920.807,LESS,-1992,4952,2960,6,2,-3,-0.281222538,3,-1.047645444,-0.367387781,1.747470586,103,53,50,0,-1.136866566,-1.053450499,-1.170500555,0.64930947,-1.589973656,1.589973656,-1.170500555,-1.053450499,0,1,0
5472,23,193,45,122,110,1,4782.786,24,1541.691,LESS,-698,2650,1952,4,1,-12,-1.124890153,12,0.523822722,-1.009580551,0.189396857,232,122,110,0,1.436041979,1.638700776,1.170500555,-0.295140668,-0.393076735,0.393076735,1.170500555,1.638700776,0,0,0
5473,23,194,38,67,80,0,8870.76,64,1565.793,LESS,-378,4112,3734,9,2,13,1.218630999,13,0.698430296,0.27480499,2.03562918,147,67,80,1,-0.259285357,-0.507216907,0,2.065984676,-0.097089861,0.097089861,0,-0.507216907,1,1,0
5474,23,195,38,80,67,1,4927.35,24,3192.235,LESS,-372,2854,2482,5,1,-13,-1.218630999,13,0.698430296,-1.009580551,0.254685611,147,80,67,0,-0.259285357,0,-0.507216907,0.177084401,-0.091540107,0.091540107,-0.507216907,0,0,1,0
5475,23,196,36,70,80,0,4936.844,0,2053.175,LESS,-3160,4838,1678,6,1,10,0.937408461,10,0.174607574,-1.780211876,0.258973341,150,70,80,1,-0.199450275,-0.390166852,0,0.64930947,-2.670325746,2.670325746,0,-0.390166852,0,1,0
5476,23,197,45,110,122,1,4823.197,0,1931.83,LESS,-418,3098,2680,6,1,12,1.124890153,12,0.523822722,-1.780211876,0.207647485,232,110,122,1,1.436041979,1.170500555,1.638700776,0.64930947,-0.13408822,0.13408822,1.638700776,1.170500555,0,1,0
5477,23,198,42,110,115,0,2973.842,64,1547.369,LESS,-768,1662,894,4,1,5,0.46870423,5,-0.698430296,0.27480499,-0.627567949,225,110,115,1,1.296426786,1.170500555,1.36558398,-0.295140668,-0.457823864,0.457823864,1.36558398,1.170500555,1,0,0
5478,23,199,41,110,112,0,5737.8,74,1401.492,LESS,-478,2890,2412,5,2,2,0.187481692,2,-1.222253018,0.595901375,0.620705303,222,110,112,1,1.236591704,1.170500555,1.248533925,0.177084401,-0.189585759,0.189585759,1.248533925,1.170500555,1,1,0
5479,23,200,53,110,103,1,4140.13,74,1235.791,LESS,948,1464,2412,5,2,-7,-0.656185922,7,-0.349215148,0.595901375,-0.100842827,213,110,103,0,1.057086457,1.170500555,0.897383758,0.177084401,1.129405748,1.129405748,0.897383758,1.170500555,1,1,1
5480,23,201,3,50,53,1,1875.905,94,810.544,MORE,870,752,1622,2,2,3,0.281222538,3,-1.047645444,1.238094145,-1.123424033,103,50,53,0,-1.136866566,-1.170500555,-1.053450499,-1.239590806,1.057258947,1.057258947,-1.053450499,-1.170500555,1,0,1
5481,23,202,20,50,40,0,2376.242,74,1841.993,MORE,-298,1320,1022,4,1,-10,-0.937408461,10,0.174607574,0.595901375,-0.897459205,90,50,40,1,-1.396151924,-1.170500555,-1.560667406,-0.295140668,-0.023093143,0.023093143,-1.560667406,-1.170500555,1,0,0
5482,23,203,25,80,88,1,1984.592,74,1314.505,MORE,730,934,1664,3,2,8,0.749926769,8,-0.174607574,0.595901375,-1.074338238,168,80,88,0,0.15956022,0,0.312133481,-0.767365737,0.92776469,0.92776469,0.312133481,0,1,0,1
5483,23,204,42,115,110,0,4864.56,34,1483.735,MORE,-844,2696,1852,6,1,-5,-0.46870423,5,-0.698430296,-0.688484166,0.226328061,225,115,110,1,1.296426786,1.36558398,1.170500555,0.64930947,-0.528120746,0.528120746,1.170500555,1.36558398,0,1,0
5484,23,205,53,103,110,1,3147.067,54,1221.415,MORE,490,1160,1650,3,2,7,0.656185922,7,-0.349215148,-0.046291396,-0.549335163,213,103,110,0,1.057086457,0.897383758,1.170500555,-0.767365737,0.705774535,0.705774535,1.170500555,0.897383758,0,0,1
5485,23,206,26,90,80,1,6297.699,34,1383.166,MORE,330,2466,2796,5,1,-10,-0.937408461,10,0.174607574,-0.688484166,0.873569835,170,90,80,1,0.199450275,0.390166852,0,0.177084401,0.557781098,0.557781098,0,0.390166852,0,1,1
5486,23,207,35,80,72,0,2783.599,54,1298.55,MORE,-842,1790,948,4,1,-8,-0.749926769,8,-0.174607574,-0.046291396,-0.713486493,152,80,72,1,-0.15956022,0,-0.312133481,-0.295140668,-0.526270828,0.526270828,-0.312133481,0,0,0,0
5487,23,208,28,93,80,0,3529.033,84,2175.138,MORE,944,1106,2050,4,2,-13,-1.218630999,13,0.698430296,0.91699776,-0.376829669,173,93,80,1,0.259285357,0.507216907,0,-0.295140668,1.125705912,1.125705912,0,0.507216907,1,0,1
5488,23,209,26,80,90,1,5074.029,0,716.545,MORE,364,2340,2704,8,1,10,0.937408461,10,0.174607574,-1.780211876,0.320929553,170,80,90,0,0.199450275,0,0.390166852,1.593759607,0.589229703,0.589229703,0.390166852,0,0,1,1
5489,23,210,25,88,80,0,3747.942,34,953.268,MORE,-1100,2442,1342,4,1,-8,-0.749926769,8,-0.174607574,-0.688484166,-0.277964834,168,88,80,1,0.15956022,0.312133481,0,-0.295140668,-0.764910245,0.764910245,0,0.312133481,0,0,0
5490,23,211,36,80,70,1,3567.828,54,1701.015,MORE,556,1608,2164,5,2,-10,-0.937408461,10,0.174607574,-0.046291396,-0.359308867,150,80,70,1,-0.199450275,0,-0.390166852,0.177084401,0.766821827,0.766821827,-0.390166852,0,0,1,1
5491,23,212,28,80,93,1,2085.536,74,1113.597,MORE,584,724,1308,3,2,13,1.218630999,13,0.698430296,0.595901375,-1.028749378,173,80,93,0,0.259285357,0,0.507216907,-0.767365737,0.792720679,0.792720679,0.507216907,0,1,0,1
5492,23,213,21,82,80,0,3857.72,54,2477.073,MORE,-1120,2352,1232,4,1,-2,-0.187481692,2,-1.222253018,-0.046291396,-0.228386317,162,82,80,1,0.039890055,0.07803337,0,-0.295140668,-0.783409425,0.783409425,0,0.07803337,0,0,0
5493,23,214,19,50,41,0,3532.94,34,1605.817,MORE,-1326,2450,1124,4,1,-9,-0.843667615,9,0,-0.688484166,-0.375065169,91,50,41,1,-1.376206896,-1.170500555,-1.521650721,-0.295140668,-0.973950975,0.973950975,-1.521650721,-1.170500555,0,0,0
5494,23,215,56,96,110,1,2868.798,84,2041.168,MORE,706,1294,2000,3,2,14,1.312371845,14,0.87303787,0.91699776,-0.675008473,206,96,110,0,0.917471264,0.624266962,1.170500555,-0.767365737,0.905565674,0.905565674,1.170500555,0.624266962,1,0,1
5495,23,216,23,80,85,1,2428.069,74,1202.25,MORE,770,890,1660,3,2,5,0.46870423,5,-0.698430296,0.595901375,-0.874052822,165,80,85,0,0.099725137,0,0.195083426,-0.767365737,0.964763049,0.964763049,0.195083426,0,1,0,1
5496,23,217,10,60,50,0,4224.684,84,1264.325,MORE,-462,2504,2042,4,2,-10,-0.937408461,10,0.174607574,0.91699776,-0.062656104,110,60,50,1,-0.997251374,-0.780333703,-1.170500555,-0.295140668,-0.174786415,0.174786415,-1.170500555,-0.780333703,1,0,0
5497,23,218,19,41,50,1,2737.177,100,1926.243,MORE,1426,1150,2576,3,2,9,0.843667615,9,0,1.430751976,-0.734451841,91,41,50,0,-1.376206896,-1.521650721,-1.170500555,-0.767365737,1.571536141,1.571536141,-1.170500555,-1.521650721,1,0,1
5498,23,219,56,110,96,0,3647.591,14,1005.919,MORE,-954,2174,1220,4,1,-14,-1.312371845,14,0.87303787,-1.330676936,-0.323285881,206,110,96,1,0.917471264,1.170500555,0.624266962,-0.295140668,-0.629866234,0.629866234,0.624266962,1.170500555,0,0,0
5499,23,220,35,72,80,1,1696.722,94,2185.935,MORE,2104,516,2620,0,2,8,0.749926769,8,-0.174607574,1.238094145,-1.204347602,152,72,80,0,-0.15956022,-0.312133481,0,-2.184040944,2.19865833,2.19865833,0,-0.312133481,1,0,1
5500,23,221,11,49,50,1,8186.463,0,670.469,MORE,-1008,4076,3068,6,1,1,0.093740846,1,-1.396860592,-1.780211876,1.726583369,99,49,50,0,-1.216646676,-1.20951724,-1.170500555,0.64930947,-0.679814019,0.679814019,-1.170500555,-1.20951724,0,1,0
5501,23,222,17,43,50,1,8628.347,4,1915.327,MORE,-2316,5162,2846,4,1,7,0.656185922,7,-0.349215148,-1.651773322,1.926149346,93,43,50,0,-1.336316841,-1.443617351,-1.170500555,-0.295140668,-1.889660366,1.889660366,-1.170500555,-1.443617351,0,0,0
5502,23,223,1,51,50,0,4808.653,64,1870.239,MORE,-922,2752,1830,4,1,-1,-0.093740846,1,-1.396860592,0.27480499,0.201079047,101,51,50,1,-1.176756621,-1.131483869,-1.170500555,-0.295140668,-0.600267547,0.600267547,-1.170500555,-1.131483869,0,0,0
5503,23,224,41,112,110,0,7458.338,54,2029.325,MORE,-944,3926,2982,11,1,-2,-0.187481692,2,-1.222253018,-0.046291396,1.397743726,222,112,110,1,1.236591704,1.248533925,1.170500555,3.010434814,-0.620616644,0.620616644,1.170500555,1.248533925,0,1,0
5504,23,225,20,40,50,1,2172.229,100,1205.599,MORE,1106,934,2040,3,2,10,0.937408461,10,0.174607574,1.430751976,-0.989596629,90,40,50,0,-1.396151924,-1.560667406,-1.170500555,-0.767365737,1.275549267,1.275549267,-1.170500555,-1.560667406,1,0,1
5505,23,226,1,50,51,0,4388.031,84,1184.39,MORE,638,2196,2834,4,2,1,0.093740846,1,-1.396860592,0.91699776,0.011115527,101,50,51,0,-1.176756621,-1.170500555,-1.131483869,-0.295140668,0.842668464,0.842668464,-1.131483869,-1.170500555,1,0,1
5506,23,227,23,85,80,1,5195.435,34,1021.572,MORE,-4,2538,2534,6,1,-5,-0.46870423,5,-0.698430296,-0.688484166,0.375759569,165,85,80,1,0.099725137,0.195083426,0,0.64930947,0.248844798,0.248844798,0,0.195083426,0,1,1
5507,23,228,11,50,49,0,5465.185,14,1711.945,MORE,-2076,4008,1932,7,1,-1,-0.093740846,1,-1.396860592,-1.330676936,0.497585483,99,50,49,1,-1.216646676,-1.170500555,-1.20951724,1.121534539,-1.667670211,1.667670211,-1.20951724,-1.170500555,0,1,0
5508,23,229,17,50,43,1,7167.638,34,2724.199,MORE,-60,3328,3268,4,1,-7,-0.656185922,7,-0.349215148,-0.688484166,1.266456263,93,50,43,1,-1.336316841,-1.170500555,-1.443617351,-0.295140668,0.197047095,0.197047095,-1.443617351,-1.170500555,0,0,1
5509,23,230,21,80,82,1,7094.661,84,1376.832,MORE,1358,2656,4014,6,2,2,0.187481692,2,-1.222253018,0.91699776,1.233498006,162,80,82,0,0.039890055,0,0.07803337,0.64930947,1.50863893,1.50863893,0.07803337,0,1,1,1
5510,23,231,10,50,60,1,2298.996,54,1193.958,MORE,430,818,1248,3,2,10,0.937408461,10,0.174607574,-0.046291396,-0.932345449,110,50,60,0,-0.997251374,-1.170500555,-0.780333703,-0.767365737,0.650276996,0.650276996,-0.780333703,-1.170500555,0,0,1
5511,23,232,3,53,50,1,5971.541,14,2285.889,MORE,-1590,3742,2152,6,1,-3,-0.281222538,3,-1.047645444,-1.330676936,0.726268644,103,53,50,1,-1.136866566,-1.053450499,-1.170500555,0.64930947,-1.218140146,1.218140146,-1.170500555,-1.053450499,0,1,0
5512,23,233,45,122,110,0,6903.541,14,2822.262,MORE,-1274,4052,2778,4,1,-12,-1.124890153,12,0.523822722,-1.330676936,1.147183386,232,122,110,1,1.436041979,1.638700776,1.170500555,-0.295140668,-0.925853108,0.925853108,1.170500555,1.638700776,0,0,0
5513,23,234,38,67,80,1,1808.105,84,1166.251,MORE,332,766,1098,1,2,13,1.218630999,13,0.698430296,0.91699776,-1.154044225,147,67,80,0,-0.259285357,-0.507216907,0,-1.711815875,0.559631015,0.559631015,0,-0.507216907,1,0,1
5514,23,235,38,80,67,0,6005.364,44,1522.207,MORE,-728,2626,1898,7,1,-13,-1.218630999,13,0.698430296,-0.367387781,0.741543965,147,80,67,1,-0.259285357,0,-0.507216907,1.121534539,-0.420825504,0.420825504,-0.507216907,0,0,1,0
5515,23,236,36,70,80,1,2137.484,94,1058.398,MORE,674,870,1544,3,2,10,0.937408461,10,0.174607574,1.238094145,-1.005288349,150,70,80,0,-0.199450275,-0.390166852,0,-0.767365737,0.875966987,0.875966987,0,-0.390166852,1,0,1
5516,23,237,45,110,122,1,2025.05,84,1402.028,MORE,1754,708,2462,3,2,12,1.124890153,12,0.523822722,0.91699776,-1.056066383,232,110,122,0,1.436041979,1.170500555,1.638700776,-0.767365737,1.874922687,1.874922687,1.638700776,1.170500555,1,0,1
5517,23,238,42,110,115,1,4421.108,44,1740.081,MORE,-220,2170,1950,5,1,5,0.46870423,5,-0.698430296,-0.367387781,0.026053936,225,110,115,0,1.296426786,1.170500555,1.36558398,0.177084401,0.049053658,0.049053658,1.36558398,1.170500555,0,1,0
5518,23,239,41,110,112,0,6405.426,54,2183.892,MORE,-698,3324,2626,6,2,2,0.187481692,2,-1.222253018,-0.046291396,0.92222207,222,110,112,0,1.236591704,1.170500555,1.248533925,0.64930947,-0.393076735,0.393076735,1.248533925,1.170500555,0,1,0
5519,23,240,53,110,103,0,3406.581,4,777.712,MORE,-1424,2348,924,4,1,-7,-0.656185922,7,-0.349215148,-1.651773322,-0.432132085,213,110,103,1,1.057086457,1.170500555,0.897383758,-0.295140668,-1.064596955,1.064596955,0.897383758,1.170500555,0,1,0
5520,24,1,49,110,131,1,13446.647,20,5350.595,MORE,-1058,6652,5594,9,2,21,1.968557767,21,2.095290887,-0.199859349,2.96083848,241,110,131,0,1.615547226,1.170500555,1.989850943,2.044963498,-0.340194406,0.340194406,1.989850943,1.170500555,0,1,0
5521,24,2,13,47,50,1,14524.851,30,3427.743,MORE,232,4474,4706,7,2,3,0.281222538,3,-1.047645444,0.183870601,3.327205873,97,47,50,0,-1.256536731,-1.28755061,-1.170500555,0.99401866,0.806253708,0.806253708,-1.170500555,-1.28755061,1,1,1
5522,24,3,16,50,44,0,8482.831,20,3732.861,MORE,-3544,5476,1932,6,1,-6,-0.562445076,6,-0.523822722,-0.199859349,1.274162928,94,50,44,1,-1.316371814,-1.170500555,-1.404600665,0.46854624,-2.549551004,2.549551004,-1.404600665,-1.170500555,1,1,0
5523,24,4,7,57,50,0,7790.284,10,3185.738,MORE,-682,3494,2812,8,1,-7,-0.656185922,7,-0.349215148,-0.583589298,1.038839521,107,57,50,1,-1.057086457,-0.897383758,-1.170500555,1.519491079,-0.006035886,0.006035886,-1.170500555,-0.897383758,0,1,0
5524,24,5,18,42,50,1,8137.083,10,1793.22,MORE,-768,3498,2730,5,1,8,0.749926769,8,-0.174607574,-0.583589298,1.156679786,92,42,50,0,-1.356261869,-1.482634036,-1.170500555,-0.056926179,-0.082465761,0.082465761,-1.170500555,-1.482634036,0,0,0
5525,24,6,51,108,110,1,15677.821,30,2110.474,MORE,2856,4416,7272,7,2,2,0.187481692,2,-1.222253018,0.183870601,3.718978314,218,108,110,0,1.156811594,1.092467184,1.170500555,0.99401866,3.138253592,3.138253592,1.170500555,1.092467184,1,1,1
5526,24,7,31,78,80,1,10911.269,0,1468.47,MORE,2760,3014,5774,7,2,2,0.187481692,2,-1.222253018,-0.967319247,2.099331911,158,78,80,0,-0.039890055,-0.07803337,0,0.99401866,3.052936523,3.052936523,0,-0.07803337,0,1,1
5527,24,8,58,110,92,0,6553.163,20,3809.209,MORE,-1134,3584,2450,5,1,-18,-1.687335229,18,1.571468165,-0.199859349,0.618473064,202,110,92,1,0.837691154,1.170500555,0.468200222,-0.056926179,-0.407737086,0.407737086,0.468200222,1.170500555,1,0,0
5528,24,9,12,50,48,1,2662.425,40,2407.283,MORE,400,1104,1504,3,2,-2,-0.187481692,2,-1.222253018,0.56760055,-0.70357688,98,50,48,1,-1.236591704,-1.170500555,-1.248533925,-1.107871017,0.955558578,0.955558578,-1.248533925,-1.170500555,1,0,1
5529,24,10,54,110,101,0,8306.192,0,5436.247,MORE,-1448,4716,3268,6,1,-9,-0.843667615,9,0,-0.967319247,1.214142032,211,110,101,1,1.017196402,1.170500555,0.819350388,0.46854624,-0.686794999,0.686794999,0.819350388,1.170500555,0,1,0
5530,24,11,14,46,50,1,5601.945,50,4734.375,MORE,-68,2110,2042,5,2,4,0.374963384,4,-0.87303787,0.951330499,0.295254769,96,46,50,0,-1.276481759,-1.326567295,-1.170500555,-0.056926179,0.539637867,0.539637867,-1.170500555,-1.326567295,1,0,1
5531,24,12,22,80,83,1,6247.112,40,1531.81,MORE,-70,2696,2626,7,2,3,0.281222538,3,-1.047645444,0.56760055,0.51447873,163,80,83,0,0.059835082,0,0.117050055,0.99401866,0.537860428,0.537860428,0.117050055,0,1,1,1
5532,24,13,6,50,56,1,2528.041,60,1798.202,MORE,564,980,1544,3,2,6,0.562445076,6,-0.523822722,1.335060448,-0.749239775,106,50,56,0,-1.077031484,-1.170500555,-0.936400444,-1.107871017,1.101308571,1.101308571,-0.936400444,-1.170500555,1,0,1
5533,24,14,13,50,47,1,14967.924,0,4516.612,MORE,-3240,7636,4396,7,1,-3,-0.281222538,3,-1.047645444,-0.967319247,3.477759478,97,50,47,1,-1.256536731,-1.170500555,-1.28755061,0.99401866,-2.279380286,2.279380286,-1.28755061,-1.170500555,0,1,0
5534,24,15,46,110,124,1,3203.733,60,2634.894,MORE,840,1024,1864,3,2,14,1.312371845,14,0.87303787,1.335060448,-0.519643598,234,110,124,0,1.475932034,1.170500555,1.716734147,-1.107871017,1.346595144,1.346595144,1.716734147,1.170500555,1,0,1
5535,24,16,27,91,80,0,8905.4,30,2569.943,MORE,-28,3288,3260,8,1,-11,-1.031149307,11,0.349215148,0.183870601,1.417749395,171,91,80,1,0.219395302,0.429183537,0,1.519491079,0.575186646,0.575186646,0,0.429183537,1,1,1
5536,24,17,40,64,80,1,15783.087,20,2967.525,MORE,140,5996,6136,8,1,16,1.499853537,16,1.222253018,-0.199859349,3.754747083,144,64,80,0,-0.31912044,-0.624266962,0,1.519491079,0.724491516,0.724491516,0,-0.624266962,1,1,1
5537,24,18,22,83,80,0,8126.123,0,5612.426,MORE,-1654,5058,3404,6,1,-3,-0.281222538,3,-1.047645444,-0.967319247,1.152955642,163,83,80,1,0.059835082,0.117050055,0,0.46854624,-0.869871209,0.869871209,0,0.117050055,0,1,0
5538,24,19,54,101,110,0,11386.066,10,4238.121,MORE,-2590,6396,3806,9,1,9,0.843667615,9,0,-0.583589298,2.260665146,211,101,110,0,1.017196402,0.819350388,1.170500555,2.044963498,-1.701712632,1.701712632,1.170500555,0.819350388,0,1,0
5539,24,20,6,56,50,0,4852.127,0,2873.128,MORE,-650,2488,1838,6,1,-6,-0.562445076,6,-0.523822722,-0.967319247,0.040471012,106,56,50,1,-1.077031484,-0.936400444,-1.170500555,0.46854624,0.022403137,0.022403137,-1.170500555,-0.936400444,0,1,0
5540,24,21,18,50,42,1,11320.057,10,2822.743,MORE,1624,4306,5930,5,1,-8,-0.749926769,8,-0.174607574,-0.583589298,2.238235675,92,50,42,1,-1.356261869,-1.170500555,-1.482634036,-0.056926179,2.043351207,2.043351207,-1.482634036,-1.170500555,0,0,1
5541,24,22,43,110,117,1,4958.222,0,2951.687,MORE,512,1620,2132,4,1,7,0.656185922,7,-0.349215148,-0.967319247,0.07652147,227,110,117,0,1.336316841,1.170500555,1.443617351,-0.582398598,1.055095159,1.055095159,1.443617351,1.170500555,0,0,1
5542,24,23,32,77,80,1,5720.845,10,1639.78,MORE,-1378,3252,1874,5,1,3,0.281222538,3,-1.047645444,-0.583589298,0.335656291,157,77,80,0,-0.059835082,-0.117050055,0,-0.056926179,-0.624584636,0.624584636,0,-0.117050055,0,1,0
5543,24,24,27,80,91,1,2867.319,40,1821.587,MORE,236,1202,1438,3,2,11,1.031149307,11,0.349215148,0.56760055,-0.633955101,171,80,91,0,0.219395302,0,0.429183537,-1.107871017,0.809808585,0.809808585,0.429183537,0,1,0,1
5544,24,25,16,44,50,1,12566.805,0,3020.11,MORE,-1448,5884,4436,9,1,6,0.562445076,6,-0.523822722,-0.967319247,2.66187333,94,44,50,0,-1.316371814,-1.404600665,-1.170500555,2.044963498,-0.686794999,0.686794999,-1.170500555,-1.404600665,0,1,0
5545,24,26,7,50,57,1,2622.717,40,3679.167,MORE,758,726,1484,3,2,7,0.656185922,7,-0.349215148,0.56760055,-0.717069425,107,50,57,0,-1.057086457,-1.170500555,-0.897383758,-1.107871017,1.273720148,1.273720148,-0.897383758,-1.170500555,1,0,1
5546,24,27,14,50,46,1,3022.98,20,4655.8,MORE,-24,1466,1442,3,1,-4,-0.374963384,4,-0.87303787,-0.199859349,-0.581062406,96,50,46,1,-1.276481759,-1.170500555,-1.326567295,-1.107871017,0.578741524,0.578741524,-1.326567295,-1.170500555,0,0,1
5547,24,28,51,110,108,0,5129.217,30,3493.351,MORE,-792,2300,1508,5,1,-2,-0.187481692,2,-1.222253018,0.183870601,0.134624568,218,110,108,1,1.156811594,1.170500555,1.092467184,-0.056926179,-0.103795028,0.103795028,1.092467184,1.170500555,1,1,0
5548,24,29,50,133,110,0,6388.74,30,2379.191,MORE,-1268,3396,2128,6,1,-23,-2.15603946,23,2.444506035,0.183870601,0.562603093,243,133,110,1,1.655437281,2.067884313,1.170500555,0.46854624,-0.526825495,0.526825495,1.170500555,2.067884313,1,1,0
5549,24,30,49,131,110,0,3102.868,0,1095.955,MORE,-1102,1954,852,4,1,-21,-1.968557767,21,2.095290887,-0.967319247,-0.553916933,241,131,110,1,1.615547226,1.989850943,1.170500555,-0.582398598,-0.379298063,0.379298063,1.170500555,1.989850943,0,0,0
5550,24,31,47,126,110,0,3448.079,40,949.159,MORE,-936,1894,958,3,1,-16,-1.499853537,16,1.222253018,0.56760055,-0.436616261,236,126,110,1,1.515822089,1.794767517,1.170500555,-1.107871017,-0.231770631,0.231770631,1.170500555,1.794767517,1,0,0
5551,24,32,50,110,133,1,2074.678,80,1518.074,MORE,886,826,1712,3,2,23,2.15603946,23,2.444506035,2.102520346,-0.903289862,243,110,133,0,1.655437281,1.170500555,2.067884313,-1.107871017,1.38747624,1.38747624,2.067884313,1.170500555,1,0,1
5552,24,33,47,110,126,1,2311.138,90,1805.526,MORE,770,930,1700,3,2,16,1.499853537,16,1.222253018,2.486250295,-0.822942141,236,110,126,0,1.515822089,1.170500555,1.794767517,-1.107871017,1.284384781,1.284384781,1.794767517,1.170500555,1,0,1
5553,24,34,12,48,50,0,20040.576,0,3427.42,MORE,-1306,9438,8132,15,1,2,0.187481692,2,-1.222253018,-0.967319247,5.201416864,98,48,50,0,-1.236591704,-1.248533925,-1.170500555,5.197798012,-0.560596835,0.560596835,-1.170500555,-1.248533925,0,1,0
5554,24,35,32,80,77,1,14313.706,0,2978.413,MORE,5534,2498,8032,7,1,-3,-0.281222538,3,-1.047645444,-0.967319247,3.25546004,157,80,77,1,-0.059835082,0,-0.117050055,0.99401866,5.518244328,5.518244328,-0.117050055,0,0,1,1
5555,24,36,43,117,110,1,2068.984,50,1508.422,MORE,358,642,1000,3,2,-7,-0.656185922,7,-0.349215148,0.951330499,-0.90522465,227,117,110,1,1.336316841,1.443617351,1.170500555,-1.107871017,0.918232361,0.918232361,1.170500555,1.443617351,1,0,1
5556,24,37,40,80,64,0,6688.034,20,3544.485,MORE,-888,3628,2740,5,1,-16,-1.499853537,16,1.222253018,-0.199859349,0.664301438,144,80,64,1,-0.31912044,0,-0.624266962,-0.056926179,-0.189112097,0.189112097,-0.624266962,0,1,1,0
5557,24,38,31,80,78,1,3621.703,40,1961.768,MORE,152,1588,1740,5,2,-2,-0.187481692,2,-1.222253018,0.56760055,-0.377619844,158,80,78,1,-0.039890055,0,-0.07803337,-0.056926179,0.73515615,0.73515615,-0.07803337,0,1,1,1
5558,24,39,46,124,110,0,4192.496,30,4244.525,MORE,-258,1780,1522,2,1,-14,-1.312371845,14,0.87303787,0.183870601,-0.183667732,234,124,110,1,1.475932034,1.716734147,1.170500555,-1.633343436,0.370781168,0.370781168,1.170500555,1.716734147,1,0,1
5559,24,40,58,92,110,1,1830.987,60,2064.407,MORE,316,804,1120,3,2,18,1.687335229,18,1.571468165,1.335060448,-0.986094634,202,92,110,0,0.837691154,0.468200222,1.170500555,-1.107871017,0.880906143,0.880906143,1.170500555,0.468200222,1,0,1
5560,24,41,49,110,131,0,3575.375,40,2381.365,LESS,-880,1716,836,4,1,21,1.968557767,21,2.095290887,0.56760055,-0.393361827,241,110,131,1,1.615547226,1.170500555,1.989850943,-0.582398598,-0.182002341,0.182002341,1.989850943,1.170500555,1,0,0
5561,24,42,13,47,50,0,5646.496,0,1345.055,LESS,-1358,3258,1900,6,1,3,0.281222538,3,-1.047645444,-0.967319247,0.310392937,97,47,50,1,-1.256536731,-1.28755061,-1.170500555,0.46854624,-0.606810247,0.606810247,-1.170500555,-1.28755061,0,1,0
5562,24,43,16,50,44,1,3149.933,50,1569.481,LESS,210,1212,1422,4,1,-6,-0.562445076,6,-0.523822722,0.951330499,-0.537924522,94,50,44,0,-1.316371814,-1.170500555,-1.404600665,-0.582398598,0.786701879,0.786701879,-1.404600665,-1.170500555,1,0,1
5563,24,44,7,57,50,1,5463.962,0,2125.042,LESS,-1000,3480,2480,7,1,-7,-0.656185922,7,-0.349215148,-0.967319247,0.248368955,107,57,50,0,-1.057086457,-0.897383758,-1.170500555,0.99401866,-0.288648677,0.288648677,-1.170500555,-0.897383758,0,1,0
5564,24,45,18,42,50,0,2460.966,80,1784.521,LESS,-448,1094,646,4,1,8,0.749926769,8,-0.174607574,2.102520346,-0.772031466,92,42,50,1,-1.356261869,-1.482634036,-1.170500555,-0.582398598,0.201924469,0.201924469,-1.170500555,-1.482634036,1,0,1
5565,24,46,51,108,110,0,5548.303,10,2214.411,LESS,-1310,3316,2006,6,1,2,0.187481692,2,-1.222253018,-0.583589298,0.277027532,218,108,110,1,1.156811594,1.092467184,1.170500555,0.46854624,-0.564151712,0.564151712,1.170500555,1.092467184,0,1,0
5566,24,47,31,78,80,0,4746.828,0,2865.589,LESS,-2778,4230,1452,6,1,2,0.187481692,2,-1.222253018,-0.967319247,0.004691029,158,78,80,1,-0.039890055,-0.07803337,0,0.46854624,-1.868791892,1.868791892,0,-0.07803337,0,1,0
5567,24,48,58,110,92,1,3859.959,0,863.548,LESS,80,1828,1908,5,1,-18,-1.687335229,18,1.571468165,-0.967319247,-0.296661853,202,110,92,0,0.837691154,1.170500555,0.468200222,-0.056926179,0.671168348,0.671168348,0.468200222,1.170500555,0,1,1
5568,24,49,12,50,48,1,2762.601,30,2774.944,LESS,802,762,1564,4,1,-2,-0.187481692,2,-1.222253018,0.183870601,-0.669537663,98,50,48,0,-1.236591704,-1.170500555,-1.248533925,-0.582398598,1.312823804,1.312823804,-1.248533925,-1.170500555,1,0,1
5569,24,50,54,110,101,1,7154.855,0,2744.584,LESS,-1994,4138,2144,7,1,-9,-0.843667615,9,0,-0.967319247,0.822924475,211,110,101,0,1.017196402,1.170500555,0.819350388,0.99401866,-1.172035829,1.172035829,0.819350388,1.170500555,0,1,0
5570,24,51,14,46,50,0,2105.441,80,2973.308,LESS,-62,1152,1090,2,2,4,0.374963384,4,-0.87303787,2.102520346,-0.892836775,96,46,50,1,-1.276481759,-1.326567295,-1.170500555,-1.633343436,0.544970184,0.544970184,-1.170500555,-1.326567295,1,0,1
5571,24,52,22,80,83,0,3839.659,30,1441.33,LESS,-596,1628,1032,6,1,3,0.281222538,3,-1.047645444,0.183870601,-0.303559674,163,80,83,1,0.059835082,0,0.117050055,0.46854624,0.070393988,0.070393988,0.117050055,0,1,1,1
5572,24,53,6,50,56,0,2483.443,100,1586.16,LESS,-112,1370,1258,5,1,6,0.562445076,6,-0.523822722,2.869980245,-0.764393913,106,50,56,1,-1.077031484,-1.170500555,-0.936400444,-0.056926179,0.50053421,0.50053421,-0.936400444,-1.170500555,1,1,1
5573,24,54,13,50,47,0,6981.949,0,2212.989,LESS,-1394,4382,2988,8,1,-3,-0.281222538,3,-1.047645444,-0.967319247,0.764172031,97,50,47,0,-1.256536731,-1.170500555,-1.28755061,1.519491079,-0.638804148,0.638804148,-1.28755061,-1.170500555,0,1,0
5574,24,55,46,110,124,0,7100.686,0,1974.016,LESS,-1142,3820,2678,6,1,14,1.312371845,14,0.87303787,-0.967319247,0.804518167,234,110,124,1,1.475932034,1.170500555,1.716734147,0.46854624,-0.414846842,0.414846842,1.716734147,1.170500555,0,1,0
5575,24,56,27,91,80,0,5496.885,0,1549.602,LESS,-1222,3326,2104,4,1,-11,-1.031149307,11,0.349215148,-0.967319247,0.259555997,171,91,80,0,0.219395302,0.429183537,0,-0.582398598,-0.485944399,0.485944399,0,0.429183537,0,0,0
5576,24,57,40,64,80,0,3532.508,40,2531.541,LESS,-388,1760,1372,4,1,16,1.499853537,16,1.222253018,0.56760055,-0.407927782,144,64,80,1,-0.31912044,-0.624266962,0,-0.582398598,0.255247637,0.255247637,0,-0.624266962,1,0,1
5577,24,58,22,83,80,0,2654.093,20,2880.366,LESS,-1130,2216,1086,4,1,-3,-0.281222538,3,-1.047645444,-0.199859349,-0.706408045,163,83,80,0,0.059835082,0.117050055,0,-0.582398598,-0.404182208,0.404182208,0,0.117050055,1,0,0
5578,24,59,54,101,110,0,4357.117,10,2864.721,LESS,-2310,3814,1504,6,1,9,0.843667615,9,0,-0.583589298,-0.127730482,211,101,110,1,1.017196402,0.819350388,1.170500555,0.46854624,-1.452871181,1.452871181,1.170500555,0.819350388,0,1,0
5579,24,60,6,56,50,0,3053.903,30,2492.92,LESS,-458,1644,1186,4,1,-6,-0.562445076,6,-0.523822722,0.183870601,-0.570554953,106,56,50,0,-1.077031484,-0.936400444,-1.170500555,-0.582398598,0.193037274,0.193037274,-1.170500555,-0.936400444,1,0,1
5580,24,61,18,50,42,1,4775.43,40,2163.816,LESS,728,1816,2544,5,2,-8,-0.749926769,8,-0.174607574,0.56760055,0.014409821,92,50,42,0,-1.356261869,-1.170500555,-1.482634036,-0.056926179,1.247058564,1.247058564,-1.482634036,-1.170500555,1,1,1
5581,24,62,43,110,117,0,7036.495,30,2335.836,LESS,-2458,4512,2054,6,1,7,0.656185922,7,-0.349215148,0.183870601,0.782706441,227,110,117,1,1.336316841,1.170500555,1.443617351,0.46854624,-1.584401662,1.584401662,1.443617351,1.170500555,1,1,0
5582,24,63,32,77,80,0,6367.577,10,1652.507,LESS,-488,3724,3236,6,1,3,0.281222538,3,-1.047645444,-0.583589298,0.55541203,157,77,80,1,-0.059835082,-0.117050055,0,0.46854624,0.16637569,0.16637569,0,-0.117050055,0,1,1
5583,24,64,27,80,91,0,4314.791,0,1326.301,LESS,-1054,2916,1862,4,1,11,1.031149307,11,0.349215148,-0.967319247,-0.142112608,171,80,91,1,0.219395302,0,0.429183537,-0.582398598,-0.336639529,0.336639529,0.429183537,0,0,0,0
5584,24,65,16,44,50,0,2763.048,70,1524.106,LESS,-144,1540,1396,4,2,6,0.562445076,6,-0.523822722,1.718790397,-0.669385775,94,44,50,1,-1.316371814,-1.404600665,-1.170500555,-0.582398598,0.472095187,0.472095187,-1.170500555,-1.404600665,1,0,1
5585,24,66,7,50,57,0,4439.563,20,2774.312,LESS,-1298,3102,1804,6,1,7,0.656185922,7,-0.349215148,-0.199859349,-0.099715815,107,50,57,1,-1.057086457,-1.170500555,-0.897383758,0.46854624,-0.553487079,0.553487079,-0.897383758,-1.170500555,1,1,0
5586,24,67,14,50,46,0,2591.437,0,1743.595,LESS,-1358,2034,676,4,1,-4,-0.374963384,4,-0.87303787,-0.967319247,-0.727698186,96,50,46,0,-1.276481759,-1.170500555,-1.326567295,-0.582398598,-0.606810247,0.606810247,-1.326567295,-1.170500555,0,0,0
5587,24,68,51,110,108,0,3184.332,0,2541.249,LESS,-978,1966,988,4,1,-2,-0.187481692,2,-1.222253018,-0.967319247,-0.526235944,218,110,108,0,1.156811594,1.170500555,1.092467184,-0.582398598,-0.269096849,0.269096849,1.092467184,1.170500555,0,0,0
5588,24,69,50,133,110,1,2982.399,0,3712.21,LESS,-274,1782,1508,5,1,-23,-2.15603946,23,2.444506035,-0.967319247,-0.594851592,243,133,110,0,1.655437281,2.067884313,1.170500555,-0.056926179,0.356561657,0.356561657,1.170500555,2.067884313,0,1,1
5589,24,70,49,131,110,0,4431.708,0,2967.913,LESS,-2144,3882,1738,6,1,-21,-1.968557767,21,2.095290887,-0.967319247,-0.102384898,241,131,110,0,1.615547226,1.989850943,1.170500555,0.46854624,-1.305343749,1.305343749,1.170500555,1.989850943,0,1,0
5590,24,71,47,126,110,1,2305.433,20,867.984,LESS,470,986,1456,3,2,-16,-1.499853537,16,1.222253018,-0.199859349,-0.824880667,236,126,110,0,1.515822089,1.794767517,1.170500555,-1.107871017,1.017768941,1.017768941,1.170500555,1.794767517,1,0,1
5591,24,72,50,110,133,0,5890.692,20,2719.748,LESS,-2440,4696,2256,8,1,23,2.15603946,23,2.444506035,-0.199859349,0.393369305,243,110,133,1,1.655437281,1.170500555,2.067884313,1.519491079,-1.568404711,1.568404711,2.067884313,1.170500555,1,1,0
5592,24,73,47,110,126,0,2753.98,20,1592.223,LESS,-546,1624,1078,4,1,16,1.499853537,16,1.222253018,-0.199859349,-0.672467028,236,110,126,1,1.515822089,1.170500555,1.794767517,-0.582398598,0.114829961,0.114829961,1.794767517,1.170500555,1,0,1
5593,24,74,12,48,50,0,1711.785,60,2207.891,LESS,-558,1118,560,2,1,2,0.187481692,2,-1.222253018,1.335060448,-1.026598774,98,48,50,1,-1.236591704,-1.248533925,-1.170500555,-1.633343436,0.104165328,0.104165328,-1.170500555,-1.248533925,1,0,1
5594,24,75,32,80,77,0,5420.205,0,2754.042,LESS,-898,3276,2378,6,1,-3,-0.281222538,3,-1.047645444,-0.967319247,0.233500583,157,80,77,0,-0.059835082,0,-0.117050055,0.46854624,-0.197999292,0.197999292,-0.117050055,0,0,1,0
5595,24,76,43,117,110,0,2595.165,0,2544.66,LESS,-870,1790,920,4,1,-7,-0.656185922,7,-0.349215148,-0.967319247,-0.726431433,227,117,110,0,1.336316841,1.443617351,1.170500555,-0.582398598,-0.173115146,0.173115146,1.170500555,1.443617351,0,0,0
5596,24,77,40,80,64,1,3789.701,0,2876.424,LESS,-774,2696,1922,5,1,-16,-1.499853537,16,1.222253018,-0.967319247,-0.320535109,144,80,64,0,-0.31912044,0,-0.624266962,-0.056926179,-0.087798077,0.087798077,-0.624266962,0,0,1,1
5597,24,78,31,80,78,0,5070.969,20,1852.177,LESS,-1286,2986,1700,6,1,-2,-0.187481692,2,-1.222253018,-0.199859349,0.114832239,158,80,78,0,-0.039890055,0,-0.07803337,0.46854624,-0.542822445,0.542822445,-0.07803337,0,1,1,0
5598,24,79,46,124,110,0,2740.984,30,1631.106,LESS,-742,1660,918,4,1,-14,-1.312371845,14,0.87303787,0.183870601,-0.676882993,234,124,110,0,1.475932034,1.716734147,1.170500555,-0.582398598,-0.059359054,0.059359054,1.170500555,1.716734147,1,0,1
5599,24,80,58,92,110,0,2481.574,40,2935.166,LESS,-688,1550,862,4,1,18,1.687335229,18,1.571468165,0.56760055,-0.765028989,202,92,110,1,0.837691154,0.468200222,1.170500555,-0.582398598,-0.011368203,0.011368203,1.170500555,0.468200222,1,0,1
5600,24,81,48,128,110,1,4405.112,10,1888.833,MORE,-1026,2684,1658,5,1,-18,-1.687335229,18,1.571468165,-0.583589298,-0.111422062,238,128,110,1,1.555712144,1.872800887,1.170500555,-0.056926179,-0.311755383,0.311755383,1.170500555,1.872800887,0,1,0
5601,24,82,8,50,58,1,5138.55,40,3215.59,MORE,-942,2602,1660,6,1,8,0.749926769,8,-0.174607574,0.56760055,0.137795866,108,50,58,0,-1.037141429,-1.170500555,-0.858367073,0.46854624,-0.237102948,0.237102948,-0.858367073,-1.170500555,1,1,0
5602,24,83,4,54,50,0,4855.218,20,2589.159,MORE,-2696,4312,1616,4,1,-4,-0.374963384,4,-0.87303787,-0.199859349,0.041521315,104,54,50,1,-1.116921539,-1.014433814,-1.170500555,-0.582398598,-1.795916895,1.795916895,-1.170500555,-1.014433814,1,0,0
5603,24,84,37,80,69,0,5766.952,30,2169.53,MORE,-508,2820,2312,6,1,-11,-1.031149307,11,0.349215148,0.183870601,0.351323179,149,80,69,1,-0.219395302,0,-0.429183537,0.46854624,0.148601301,0.148601301,-0.429183537,0,1,1,0
5604,24,85,52,105,110,1,2587.378,80,1096.075,MORE,1062,898,1960,3,2,5,0.46870423,5,-0.698430296,2.102520346,-0.72907741,215,105,110,0,1.096976512,0.975417129,1.170500555,-1.107871017,1.543890866,1.543890866,1.170500555,0.975417129,1,0,1
5605,24,86,5,55,50,1,1895.944,100,846.46,MORE,810,788,1598,3,2,-5,-0.46870423,5,-0.698430296,2.869980245,-0.964022626,105,55,50,1,-1.096976512,-0.975417129,-1.170500555,-1.107871017,1.31993356,1.31993356,-1.170500555,-0.975417129,1,0,1
5606,24,87,30,96,80,0,2777.171,60,1324.854,MORE,-478,1578,1100,4,1,-16,-1.499853537,16,1.222253018,1.335060448,-0.664586862,176,96,80,1,0.31912044,0.624266962,0,-0.582398598,0.175262885,0.175262885,0,0.624266962,1,0,0
5607,24,88,33,80,75,0,5402.038,50,2284.527,MORE,-1142,3448,2306,8,1,-5,-0.46870423,5,-0.698430296,0.951330499,0.227327543,155,80,75,1,-0.099725137,0,-0.195083426,1.519491079,-0.414846842,0.414846842,-0.195083426,0,1,1,0
5608,24,89,48,110,128,1,3141.014,80,2297.369,MORE,1118,1300,2418,3,2,18,1.687335229,18,1.571468165,2.102520346,-0.540955146,238,110,128,0,1.555712144,1.170500555,1.872800887,-1.107871017,1.593659156,1.593659156,1.872800887,1.170500555,1,0,1
5609,24,90,9,59,50,0,4355.044,10,2253.746,MORE,-2158,3796,1638,6,1,-9,-0.843667615,9,0,-0.583589298,-0.128434875,109,59,50,1,-1.017196402,-0.819350388,-1.170500555,0.46854624,-1.317785821,1.317785821,-1.170500555,-0.819350388,0,1,0
5610,24,91,44,110,119,1,2043.082,60,1686.537,MORE,266,932,1198,3,2,9,0.843667615,9,0,1.335060448,-0.914025997,229,110,119,0,1.376206896,1.170500555,1.521650721,-1.107871017,0.836470169,0.836470169,1.521650721,1.170500555,1,0,1
5611,24,92,2,52,50,0,4459.518,30,1419.662,MORE,-366,2186,1820,6,1,-2,-0.187481692,2,-1.222253018,0.183870601,-0.092935223,102,52,50,1,-1.156811594,-1.092467184,-1.170500555,0.46854624,0.274799466,0.274799466,-1.170500555,-1.092467184,1,1,1
5612,24,93,8,58,50,0,5189.438,20,1421.168,MORE,-1528,3200,1672,4,1,-8,-0.749926769,8,-0.174607574,-0.199859349,0.15508731,108,58,50,1,-1.037141429,-0.858367073,-1.170500555,-0.582398598,-0.757892556,0.757892556,-1.170500555,-0.858367073,0,0,0
5613,24,94,44,119,110,0,4414.155,30,3190.038,MORE,32,1970,2002,4,1,-9,-0.843667615,9,0,0.183870601,-0.108349304,229,119,110,1,1.376206896,1.521650721,1.170500555,-0.582398598,0.628509814,0.628509814,1.170500555,1.521650721,1,0,1
5614,24,95,34,74,80,1,3179.9,70,2419.188,MORE,30,1458,1488,5,2,6,0.562445076,6,-0.523822722,1.718790397,-0.527741911,154,74,80,0,-0.119670165,-0.234100111,0,-0.056926179,0.626732375,0.626732375,0,-0.234100111,1,1,1
5615,24,96,24,86,80,1,7117.997,20,1759.338,MORE,-2232,4586,2354,7,1,-6,-0.562445076,6,-0.523822722,-0.199859349,0.810400343,166,86,80,1,0.119670165,0.234100111,0,0.99401866,-1.383551062,1.383551062,0,0.234100111,1,1,0
5616,24,97,39,66,80,1,8100.37,10,3546.035,MORE,-3106,5476,2370,6,1,14,1.312371845,14,0.87303787,-0.583589298,1.144204924,146,66,80,0,-0.279230385,-0.546233592,0,0.46854624,-2.160291877,2.160291877,0,-0.546233592,0,1,0
5617,24,98,9,50,59,1,10991.32,0,3002.372,MORE,-2536,5016,2480,8,1,9,0.843667615,9,0,-0.967319247,2.126532772,109,50,59,0,-1.017196402,-1.170500555,-0.819350388,1.519491079,-1.65372178,1.65372178,-0.819350388,-1.170500555,0,1,0
5618,24,99,57,94,110,1,3808.033,0,1670.156,MORE,-634,2328,1694,5,1,16,1.499853537,16,1.222253018,-0.967319247,-0.314306003,204,94,110,0,0.877581209,0.546233592,1.170500555,-0.056926179,0.036622648,0.036622648,1.170500555,0.546233592,0,1,0
5619,24,100,60,110,87,0,3128.206,20,3028.859,MORE,-1406,2486,1080,4,1,-23,-2.15603946,23,2.444506035,-0.199859349,-0.545307229,197,110,87,1,0.737966017,1.170500555,0.273116796,-0.582398598,-0.649468781,0.649468781,0.273116796,1.170500555,0,0,0
5620,24,101,33,75,80,0,7991.005,0,1573.648,MORE,-2852,5106,2254,8,1,5,0.46870423,5,-0.698430296,-0.967319247,1.107043339,155,75,80,0,-0.099725137,-0.195083426,0,1.519491079,-1.934557132,1.934557132,0,-0.195083426,0,1,0
5621,24,102,15,50,45,0,4034.818,10,3440.187,MORE,-3142,4490,1348,4,1,-5,-0.46870423,5,-0.698430296,-0.583589298,-0.237245791,95,50,45,1,-1.296426786,-1.170500555,-1.36558398,-0.582398598,-2.192285778,2.192285778,-1.36558398,-1.170500555,0,0,0
5622,24,103,59,89,110,1,2980.009,80,1628.393,MORE,700,1358,2058,3,2,21,1.968557767,21,2.095290887,2.102520346,-0.5956637,199,89,110,0,0.777856072,0.351150166,1.170500555,-1.107871017,1.222174419,1.222174419,1.170500555,0.351150166,1,0,1
5623,24,104,29,80,94,1,4047.436,60,1455.4,MORE,-278,1930,1652,5,2,14,1.312371845,14,0.87303787,1.335060448,-0.232958269,174,80,94,0,0.279230385,0,0.546233592,-0.056926179,0.353006779,0.353006779,0.546233592,0,1,0,1
5624,24,105,55,110,98,0,5109.372,30,1859.247,MORE,-964,3006,2042,6,1,-12,-1.124890153,12,0.523822722,0.183870601,0.127881353,208,110,98,1,0.957361319,1.170500555,0.702300333,0.46854624,-0.256654776,0.256654776,0.702300333,1.170500555,1,1,0
5625,24,106,29,94,80,0,8951.547,10,2415.34,MORE,-4806,6960,2154,8,1,-14,-1.312371845,14,0.87303787,-0.583589298,1.433429874,174,94,80,1,0.279230385,0.546233592,0,1.519491079,-3.671114973,3.671114973,0,0.546233592,0,1,0
5626,24,107,57,110,94,0,10596.642,0,3918.82,MORE,-1514,4942,3428,10,1,-16,-1.499853537,16,1.222253018,-0.967319247,1.992423503,204,110,94,1,0.877581209,1.170500555,0.546233592,2.570435917,-0.745450484,0.745450484,0.546233592,1.170500555,0,1,0
5627,24,108,39,80,66,0,8235.019,20,1996.269,MORE,456,3770,4226,8,1,-14,-1.312371845,14,0.87303787,-0.199859349,1.189957864,146,80,66,1,-0.279230385,0,-0.546233592,1.519491079,1.005326868,1.005326868,-0.546233592,0,0,1,1
5628,24,109,4,50,54,1,3631.516,10,2881.978,MORE,-892,2614,1722,5,1,4,0.374963384,4,-0.87303787,-0.583589298,-0.374285444,104,50,54,0,-1.116921539,-1.170500555,-1.014433814,-0.056926179,-0.192666975,0.192666975,-1.014433814,-1.170500555,0,0,0
5629,24,110,55,98,110,1,5048.949,30,2004.592,MORE,198,2478,2676,6,1,12,1.124890153,12,0.523822722,0.183870601,0.107349972,208,98,110,0,0.957361319,0.702300333,1.170500555,0.46854624,0.776037246,0.776037246,1.170500555,0.702300333,1,1,1
5630,24,111,2,50,52,1,4187.921,30,2995.794,MORE,556,1846,2402,5,1,2,0.187481692,2,-1.222253018,0.183870601,-0.18522229,102,50,52,0,-1.156811594,-1.170500555,-1.092467184,-0.056926179,1.094198815,1.094198815,-1.092467184,-1.170500555,1,0,1
5631,24,112,59,110,89,0,2787.595,40,1929.354,MORE,-618,1606,988,4,1,-21,-1.968557767,21,2.095290887,0.56760055,-0.661044848,199,110,89,1,0.777856072,1.170500555,0.351150166,-0.582398598,0.05084216,0.05084216,0.351150166,1.170500555,1,0,0
5632,24,113,60,87,110,1,2740.276,60,1635.933,MORE,590,1138,1728,3,2,23,2.15603946,23,2.444506035,1.335060448,-0.677123567,197,87,110,0,0.737966017,0.273116796,1.170500555,-1.107871017,1.124415277,1.124415277,1.170500555,0.273116796,1,0,1
5633,24,114,52,110,105,0,2924.485,20,3397.733,MORE,-1496,2528,1032,4,1,-5,-0.46870423,5,-0.698430296,-0.199859349,-0.61453043,215,110,105,1,1.096976512,1.170500555,0.975417129,-0.582398598,-0.729453533,0.729453533,0.975417129,1.170500555,0,0,0
5634,24,115,30,80,96,1,1756.037,70,946.207,MORE,256,774,1030,3,2,16,1.499853537,16,1.222253018,1.718790397,-1.011562204,176,80,96,0,0.31912044,0,0.624266962,-1.107871017,0.827582975,0.827582975,0.624266962,0,1,0,1
5635,24,116,24,80,86,1,2077.14,50,2986.881,MORE,504,834,1338,3,2,6,0.562445076,6,-0.523822722,0.951330499,-0.902453289,166,80,86,0,0.119670165,0,0.234100111,-1.107871017,1.047985403,1.047985403,0.234100111,0,1,0,1
5636,24,117,5,50,55,1,2617.624,50,2315.938,MORE,184,1188,1372,5,2,5,0.46870423,5,-0.698430296,0.951330499,-0.718799997,105,50,55,0,-1.096976512,-1.170500555,-0.975417129,-0.056926179,0.763595173,0.763595173,-0.975417129,-1.170500555,1,1,1
5637,24,118,34,80,74,1,6354.756,10,1991.918,MORE,-1760,4156,2396,7,1,-6,-0.562445076,6,-0.523822722,-0.583589298,0.551055529,154,80,74,1,-0.119670165,0,-0.234100111,0.99401866,-0.964075473,0.964075473,-0.234100111,0,0,1,0
5638,24,119,15,45,50,1,4187.163,40,2292.98,MORE,-404,2208,1804,5,2,5,0.46870423,5,-0.698430296,0.56760055,-0.185479854,95,45,50,0,-1.296426786,-1.36558398,-1.170500555,-0.056926179,0.241028126,0.241028126,-1.170500555,-1.36558398,1,1,1
5639,24,120,37,69,80,1,2305.712,30,2104.922,MORE,-122,1272,1150,3,1,11,1.031149307,11,0.349215148,0.183870601,-0.824785864,149,69,80,0,-0.219395302,-0.429183537,0,-1.107871017,0.491647016,0.491647016,0,-0.429183537,1,0,1
5640,24,121,48,128,110,1,2367.847,20,1991.689,LESS,-782,1728,946,3,1,-18,-1.687335229,18,1.571468165,-0.199859349,-0.803672756,238,128,110,0,1.555712144,1.872800887,1.170500555,-1.107871017,-0.094907833,0.094907833,1.170500555,1.872800887,1,0,1
5641,24,122,8,50,58,0,4291.221,40,3620.598,LESS,-1170,2990,1820,6,1,8,0.749926769,8,-0.174607574,0.56760055,-0.150121556,108,50,58,1,-1.037141429,-1.170500555,-0.858367073,0.46854624,-0.439730987,0.439730987,-0.858367073,-1.170500555,1,1,0
5642,24,123,4,54,50,0,2944.669,0,1740.925,LESS,-1548,2562,1014,4,1,-4,-0.374963384,4,-0.87303787,-0.967319247,-0.607672025,104,54,50,0,-1.116921539,-1.014433814,-1.170500555,-0.582398598,-0.775666946,0.775666946,-1.170500555,-1.014433814,0,1,0
5643,24,124,37,80,69,1,5680.878,0,1758.434,LESS,336,3006,3342,8,1,-11,-1.031149307,11,0.349215148,-0.967319247,0.322075739,149,80,69,0,-0.219395302,0,-0.429183537,1.519491079,0.898680532,0.898680532,-0.429183537,0,0,1,1
5644,24,125,52,105,110,0,7102.719,0,1935.363,LESS,-1182,4188,3006,6,1,5,0.46870423,5,-0.698430296,-0.967319247,0.805208968,215,105,110,1,1.096976512,0.975417129,1.170500555,0.46854624,-0.45039562,0.45039562,1.170500555,0.975417129,0,1,0
5645,24,126,5,55,50,0,2670.721,10,2172.067,LESS,-1716,2614,898,4,1,-5,-0.46870423,5,-0.698430296,-0.583589298,-0.700757948,105,55,50,0,-1.096976512,-0.975417129,-1.170500555,-0.582398598,-0.924971816,0.924971816,-1.170500555,-0.975417129,0,0,0
5646,24,127,30,96,80,1,5302.469,0,2930.76,LESS,-572,3426,2854,7,1,-16,-1.499853537,16,1.222253018,-0.967319247,0.193494581,176,96,80,0,0.31912044,0.624266962,0,0.99401866,0.091723255,0.091723255,0,0.624266962,0,1,1
5647,24,128,33,80,75,0,2602.201,0,3330.835,LESS,-1308,2370,1062,4,1,-5,-0.46870423,5,-0.698430296,-0.967319247,-0.724040642,155,80,75,0,-0.099725137,0,-0.195083426,-0.582398598,-0.562374273,0.562374273,-0.195083426,0,0,0,0
5648,24,129,48,110,128,0,1755.29,40,2155.871,LESS,-606,1224,618,2,1,18,1.687335229,18,1.571468165,0.56760055,-1.01181603,238,110,128,1,1.555712144,1.170500555,1.872800887,-1.633343436,0.061506793,0.061506793,1.872800887,1.170500555,1,0,1
5649,24,130,9,59,50,1,3723.259,20,1475.09,LESS,-1280,2874,1594,4,1,-9,-0.843667615,9,0,-0.199859349,-0.343111711,109,59,50,0,-1.017196402,-0.819350388,-1.170500555,-0.582398598,-0.537490128,0.537490128,-1.170500555,-0.819350388,1,0,0
5650,24,131,44,110,119,0,2463.204,10,1505.88,LESS,-1558,2416,858,4,1,9,0.843667615,9,0,-0.583589298,-0.771271007,229,110,119,1,1.376206896,1.170500555,1.521650721,-0.582398598,-0.784554141,0.784554141,1.521650721,1.170500555,0,0,0
5651,24,132,2,52,50,0,3398.064,0,1433.317,LESS,-964,2542,1578,6,1,-2,-0.187481692,2,-1.222253018,-0.967319247,-0.453611064,102,52,50,0,-1.156811594,-1.092467184,-1.170500555,0.46854624,-0.256654776,0.256654776,-1.170500555,-1.092467184,0,1,0
5652,24,133,8,58,50,0,5685.258,0,1800.59,LESS,-652,3020,2368,5,1,-8,-0.749926769,8,-0.174607574,-0.967319247,0.323564037,108,58,50,0,-1.037141429,-0.858367073,-1.170500555,-0.056926179,0.020625698,0.020625698,-1.170500555,-0.858367073,0,1,1
5653,24,134,44,119,110,0,4908.208,0,675.77,LESS,-726,2728,2002,8,1,-9,-0.843667615,9,0,-0.967319247,0.059527006,229,119,110,0,1.376206896,1.521650721,1.170500555,1.519491079,-0.045139543,0.045139543,1.170500555,1.521650721,0,1,1
5654,24,135,34,74,80,0,7472.473,20,1839.59,LESS,410,3616,4026,6,1,6,0.562445076,6,-0.523822722,-0.199859349,0.930849208,154,74,80,1,-0.119670165,-0.234100111,0,0.46854624,0.964445773,0.964445773,0,-0.234100111,1,1,1
5655,24,136,24,86,80,1,10282.178,0,1432.716,LESS,-3350,6572,3222,10,1,-6,-0.562445076,6,-0.523822722,-0.967319247,1.885570481,166,86,80,0,0.119670165,0.234100111,0,2.570435917,-2.377139427,2.377139427,0,0.234100111,0,1,0
5656,24,137,39,66,80,0,3187.171,70,862.828,LESS,-1516,2302,786,4,1,14,1.312371845,14,0.87303787,1.718790397,-0.525271268,146,66,80,1,-0.279230385,-0.546233592,0,-0.582398598,-0.747227923,0.747227923,0,-0.546233592,1,0,0
5657,24,138,9,50,59,0,2787.333,60,1931.624,LESS,-1118,1848,730,4,1,9,0.843667615,9,0,1.335060448,-0.661133874,109,50,59,1,-1.017196402,-1.170500555,-0.819350388,-0.582398598,-0.393517575,0.393517575,-0.819350388,-1.170500555,1,0,0
5658,24,139,57,94,110,0,4138.277,20,2145.439,LESS,-1192,2812,1620,6,1,16,1.499853537,16,1.222253018,-0.199859349,-0.20209103,204,94,110,1,0.877581209,0.546233592,1.170500555,0.46854624,-0.459282815,0.459282815,1.170500555,0.546233592,1,1,0
5659,24,140,60,110,87,1,2225.688,70,1235.58,LESS,556,804,1360,3,2,-23,-2.15603946,23,2.444506035,1.718790397,-0.85197755,197,110,87,0,0.737966017,1.170500555,0.273116796,-1.107871017,1.094198815,1.094198815,0.273116796,1.170500555,1,0,1
5660,24,141,33,75,80,0,5286.922,0,2848.09,LESS,-2714,4136,1422,4,1,5,0.46870423,5,-0.698430296,-0.967319247,0.188211802,155,75,80,1,-0.099725137,-0.195083426,0,-0.582398598,-1.811913846,1.811913846,0,-0.195083426,0,0,0
5661,24,142,15,50,45,0,1671.793,70,738.74,LESS,-858,1288,430,2,1,-5,-0.46870423,5,-0.698430296,1.718790397,-1.040187821,95,50,45,0,-1.296426786,-1.170500555,-1.36558398,-1.633343436,-0.162450513,0.162450513,-1.36558398,-1.170500555,1,0,1
5662,24,143,59,89,110,0,2401.372,30,1373.809,LESS,-598,1460,862,4,1,21,1.968557767,21,2.095290887,0.183870601,-0.792281158,199,89,110,1,0.777856072,0.351150166,1.170500555,-0.582398598,0.068616549,0.068616549,1.170500555,0.351150166,1,0,1
5663,24,144,29,80,94,0,2398.838,30,1201.287,LESS,-640,1598,958,4,1,14,1.312371845,14,0.87303787,0.183870601,-0.793142196,174,80,94,1,0.279230385,0,0.546233592,-0.582398598,0.031290331,0.031290331,0.546233592,0,1,0,1
5664,24,145,55,110,98,1,6067.071,10,1273.063,LESS,564,3040,3604,8,1,-12,-1.124890153,12,0.523822722,-0.583589298,0.453301854,208,110,98,0,0.957361319,1.170500555,0.702300333,1.519491079,1.101308571,1.101308571,0.702300333,1.170500555,1,1,1
5665,24,146,29,94,80,1,3546.99,0,976.897,LESS,-322,2090,1768,6,1,-14,-1.312371845,14,0.87303787,-0.967319247,-0.403006883,174,94,80,0,0.279230385,0.546233592,0,0.46854624,0.313903122,0.313903122,0,0.546233592,0,1,1
5666,24,147,57,110,94,1,5266.732,0,2719.77,LESS,-1378,3660,2282,5,1,-16,-1.499853537,16,1.222253018,-0.967319247,0.181351358,204,110,94,0,0.877581209,1.170500555,0.546233592,-0.056926179,-0.624584636,0.624584636,0.546233592,1.170500555,0,1,0
5667,24,148,39,80,66,1,6182.813,0,1396.097,LESS,-722,3652,2930,9,1,-14,-1.312371845,14,0.87303787,-0.967319247,0.492630307,146,80,66,0,-0.279230385,0,-0.546233592,2.044963498,-0.041584665,0.041584665,-0.546233592,0,0,1,1
5668,24,149,4,50,54,0,7787.664,30,1923.183,LESS,-1048,3718,2670,8,2,4,0.374963384,4,-0.87303787,0.183870601,1.03794926,104,50,54,1,-1.116921539,-1.170500555,-1.014433814,1.519491079,-0.331307212,0.331307212,-1.014433814,-1.170500555,1,1,0
5669,24,150,55,98,110,1,6293.669,0,1434.679,LESS,-2084,4320,2236,7,1,12,1.124890153,12,0.523822722,-0.967319247,0.530298525,208,98,110,1,0.957361319,0.702300333,1.170500555,0.99401866,-1.252020581,1.252020581,1.170500555,0.702300333,0,1,0
5670,24,151,2,50,52,0,2747.01,70,1593.284,LESS,-574,1536,962,3,1,2,0.187481692,2,-1.222253018,1.718790397,-0.674835393,102,50,52,1,-1.156811594,-1.170500555,-1.092467184,-1.107871017,0.089945816,0.089945816,-1.092467184,-1.170500555,1,0,1
5671,24,152,59,110,89,1,3819.115,20,2262.805,LESS,-1084,2956,1872,5,1,-21,-1.968557767,21,2.095290887,-0.199859349,-0.310540405,199,110,89,0,0.777856072,1.170500555,0.351150166,-0.056926179,-0.363301113,0.363301113,0.351150166,1.170500555,1,1,0
5672,24,153,60,87,110,0,2608.959,80,1718.093,LESS,198,1710,1908,4,2,23,2.15603946,23,2.444506035,2.102520346,-0.721744313,197,87,110,1,0.737966017,0.273116796,1.170500555,-0.582398598,0.776037246,0.776037246,1.170500555,0.273116796,1,0,1
5673,24,154,52,110,105,0,5789.958,10,1080.975,LESS,-1246,3498,2252,4,1,-5,-0.46870423,5,-0.698430296,-0.583589298,0.359140483,215,110,105,0,1.096976512,1.170500555,0.975417129,-0.582398598,-0.507273666,0.507273666,0.975417129,1.170500555,0,0,0
5674,24,155,30,80,96,0,3137.528,0,2229.585,LESS,-1940,2866,926,3,1,16,1.499853537,16,1.222253018,-0.967319247,-0.542139668,176,80,96,1,0.31912044,0,0.624266962,-1.107871017,-1.124044977,1.124044977,0.624266962,0,0,0,0
5675,24,156,24,80,86,0,11949.455,0,2019.13,LESS,-914,6262,5348,10,1,6,0.562445076,6,-0.523822722,-0.967319247,2.452101423,166,80,86,1,0.119670165,0,0.234100111,2.570435917,-0.212218803,0.212218803,0.234100111,0,0,1,0
5676,24,157,5,50,55,0,4462.793,30,1738.284,LESS,-1580,3374,1794,6,1,5,0.46870423,5,-0.698430296,0.183870601,-0.091822397,105,50,55,1,-1.096976512,-1.170500555,-0.975417129,0.46854624,-0.804105969,0.804105969,-0.975417129,-1.170500555,1,1,0
5677,24,158,34,80,74,1,9508.517,0,2253.484,LESS,-1094,4808,3714,9,2,-6,-0.562445076,6,-0.523822722,-0.967319247,1.622685012,154,80,74,0,-0.119670165,0,-0.234100111,2.044963498,-0.372188307,0.372188307,-0.234100111,0,0,1,0
5678,24,159,15,45,50,1,2712.709,20,1505.941,LESS,-68,1660,1592,3,1,5,0.46870423,5,-0.698430296,-0.199859349,-0.686490672,95,45,50,1,-1.296426786,-1.36558398,-1.170500555,-1.107871017,0.539637867,0.539637867,-1.170500555,-1.36558398,1,0,1
5679,24,160,37,69,80,0,1579.458,10,1405.198,LESS,-1922,2366,444,2,1,11,1.031149307,11,0.349215148,-0.583589298,-1.071562712,149,69,80,1,-0.219395302,-0.429183537,0,-1.633343436,-1.108048027,1.108048027,0,-0.429183537,0,0,0
5680,24,161,3,50,53,1,4691.508,30,2644.053,MORE,986,1822,2808,5,1,3,0.281222538,3,-1.047645444,0.183870601,-0.014106382,103,50,53,0,-1.136866566,-1.170500555,-1.053450499,-0.056926179,1.476348187,1.476348187,-1.053450499,-1.170500555,1,0,1
5681,24,162,20,50,40,0,4739.589,10,2608.811,MORE,-1822,3802,1980,6,1,-10,-0.937408461,10,0.174607574,-0.583589298,0.00223126,90,50,40,1,-1.396151924,-1.170500555,-1.560667406,0.46854624,-1.01917608,1.01917608,-1.560667406,-1.170500555,0,1,0
5682,24,163,25,80,88,1,1773.614,90,1747.717,MORE,1506,726,2232,3,2,8,0.749926769,8,-0.174607574,2.486250295,-1.005589643,168,80,88,0,0.15956022,0,0.312133481,-1.107871017,1.93848231,1.93848231,0.312133481,0,1,0,1
5683,24,164,42,115,110,1,4930.746,30,1983.04,MORE,-386,2740,2354,7,1,-5,-0.46870423,5,-0.698430296,0.183870601,0.067185287,225,115,110,1,1.296426786,1.36558398,1.170500555,0.99401866,0.257025076,0.257025076,1.170500555,1.36558398,1,1,1
5684,24,165,53,103,110,1,3031.859,10,1167.226,MORE,-314,1904,1590,5,1,7,0.656185922,7,-0.349215148,-0.583589298,-0.578045374,213,103,110,0,1.057086457,0.897383758,1.170500555,-0.056926179,0.321012878,0.321012878,1.170500555,0.897383758,0,0,1
5685,24,166,26,90,80,0,2542.756,20,2449.91,MORE,-2184,3092,908,4,1,-10,-0.937408461,10,0.174607574,-0.199859349,-0.744239704,170,90,80,1,0.199450275,0.390166852,0,-0.582398598,-1.340892528,1.340892528,0,0.390166852,0,0,0
5686,24,167,35,80,72,1,2181.946,0,1613.579,MORE,-200,1588,1388,3,1,-8,-0.749926769,8,-0.174607574,-0.967319247,-0.866840825,152,80,72,1,-0.15956022,0,-0.312133481,-1.107871017,0.422326897,0.422326897,-0.312133481,0,0,0,1
5687,24,168,28,93,80,0,5720.088,10,2766.382,MORE,-2228,4400,2172,6,1,-13,-1.218630999,13,0.698430296,-0.583589298,0.335399067,173,93,80,1,0.259285357,0.507216907,0,0.46854624,-1.379996184,1.379996184,0,0.507216907,0,1,0
5688,24,169,26,80,90,1,2166.239,60,2306.325,MORE,412,650,1062,3,2,10,0.937408461,10,0.174607574,1.335060448,-0.872177971,170,80,90,0,0.199450275,0,0.390166852,-1.107871017,0.966223212,0.966223212,0.390166852,0,1,0,1
5689,24,170,25,88,80,0,2670.265,0,819.055,MORE,-1052,2082,1030,4,1,-8,-0.749926769,8,-0.174607574,-0.967319247,-0.700912894,168,88,80,1,0.15956022,0.312133481,0,-0.582398598,-0.33486209,0.33486209,0,0.312133481,0,0,0
5690,24,171,36,80,70,0,3263.573,0,2377.448,MORE,-1222,2616,1394,4,1,-10,-0.937408461,10,0.174607574,-0.967319247,-0.499310317,150,80,70,1,-0.199450275,0,-0.390166852,-0.582398598,-0.485944399,0.485944399,-0.390166852,0,0,0,0
5691,24,172,28,80,93,0,7003.096,0,2698.853,MORE,-1438,4028,2590,8,1,13,1.218630999,13,0.698430296,-0.967319247,0.771357657,173,80,93,0,0.259285357,0,0.507216907,1.519491079,-0.677907804,0.677907804,0.507216907,0,0,1,0
5692,24,173,21,82,80,1,4127.078,0,818.657,MORE,-686,2354,1668,6,1,-2,-0.187481692,2,-1.222253018,-0.967319247,-0.205896384,162,82,80,1,0.039890055,0.07803337,0,0.46854624,-0.009590764,0.009590764,0,0.07803337,0,1,0
5693,24,174,19,50,41,0,6665.635,10,1832.991,MORE,-1868,4486,2618,8,1,-9,-0.843667615,9,0,-0.583589298,0.656690389,91,50,41,1,-1.376206896,-1.170500555,-1.521650721,1.519491079,-1.060057176,1.060057176,-1.521650721,-1.170500555,0,1,0
5694,24,175,56,96,110,1,2597.019,30,2413.565,MORE,992,746,1738,3,2,14,1.312371845,14,0.87303787,0.183870601,-0.725801455,206,96,110,0,0.917471264,0.624266962,1.170500555,-1.107871017,1.481680503,1.481680503,1.170500555,0.624266962,1,0,1
5695,24,176,23,80,85,1,3825.918,40,1061.927,MORE,-140,1872,1732,5,2,5,0.46870423,5,-0.698430296,0.56760055,-0.308228785,165,80,85,0,0.099725137,0,0.195083426,-0.056926179,0.475650065,0.475650065,0.195083426,0,1,0,1
5696,24,177,10,60,50,1,3159.739,20,2220.94,MORE,-536,2044,1508,5,1,-10,-0.937408461,10,0.174607574,-0.199859349,-0.534592501,110,60,50,1,-0.997251374,-0.780333703,-1.170500555,-0.056926179,0.123717156,0.123717156,-1.170500555,-0.780333703,0,0,0
5697,24,178,19,41,50,1,6027.076,10,1670.799,MORE,-1394,3866,2472,7,1,9,0.843667615,9,0,-0.583589298,0.439711788,91,41,50,0,-1.376206896,-1.521650721,-1.170500555,0.99401866,-0.638804148,0.638804148,-1.170500555,-1.521650721,0,1,0
5698,24,179,56,110,96,1,7100.333,0,2496.966,MORE,-314,4178,3864,7,1,-14,-1.312371845,14,0.87303787,-0.967319247,0.804398219,206,110,96,1,0.917471264,1.170500555,0.624266962,0.99401866,0.321012878,0.321012878,0.624266962,1.170500555,0,1,1
5699,24,180,35,72,80,1,3118.869,0,1386.714,MORE,-234,1850,1616,5,1,8,0.749926769,8,-0.174607574,-0.967319247,-0.548479887,152,72,80,0,-0.15956022,-0.312133481,0,-0.056926179,0.392110435,0.392110435,0,-0.312133481,0,1,1
5700,24,181,11,49,50,1,3551.592,0,1876.295,MORE,-514,2534,2020,5,1,1,0.093740846,1,-1.396860592,-0.967319247,-0.40144315,99,49,50,0,-1.216646676,-1.20951724,-1.170500555,-0.056926179,0.143268984,0.143268984,-1.170500555,-1.20951724,0,1,0
5701,24,182,17,43,50,1,1701.295,20,1813.95,MORE,84,880,964,3,1,7,0.656185922,7,-0.349215148,-0.199859349,-1.030163215,93,43,50,0,-1.336316841,-1.443617351,-1.170500555,-1.107871017,0.674723226,0.674723226,-1.170500555,-1.443617351,0,0,1
5702,24,183,1,51,50,1,11519.87,20,1919.615,MORE,-1868,6078,4210,9,1,-1,-0.093740846,1,-1.396860592,-0.199859349,2.30613096,101,51,50,1,-1.176756621,-1.131483869,-1.170500555,2.044963498,-1.060057176,1.060057176,-1.170500555,-1.131483869,0,1,0
5703,24,184,41,112,110,0,2257.657,20,1810.228,MORE,-1500,2316,816,4,1,-2,-0.187481692,2,-1.222253018,-0.199859349,-0.841114671,222,112,110,1,1.236591704,1.248533925,1.170500555,-0.582398598,-0.733008411,0.733008411,1.170500555,1.248533925,0,0,0
5704,24,185,20,40,50,1,1902.204,70,864.796,MORE,356,902,1258,3,2,10,0.937408461,10,0.174607574,1.718790397,-0.961895515,90,40,50,0,-1.396151924,-1.560667406,-1.170500555,-1.107871017,0.916454922,0.916454922,-1.170500555,-1.560667406,1,0,1
5705,24,186,1,50,51,0,3278.506,10,1873.687,MORE,-1286,2684,1398,6,1,1,0.093740846,1,-1.396860592,-0.583589298,-0.494236171,101,50,51,0,-1.176756621,-1.170500555,-1.131483869,0.46854624,-0.542822445,0.542822445,-1.131483869,-1.170500555,0,1,0
5706,24,187,23,85,80,1,5836.756,10,4377.487,MORE,-952,3296,2344,6,1,-5,-0.46870423,5,-0.698430296,-0.583589298,0.375042169,165,85,80,1,0.099725137,0.195083426,0,0.46854624,-0.245990143,0.245990143,0,0.195083426,0,1,0
5707,24,188,11,50,49,0,6428.128,0,2492.695,MORE,-922,3744,2822,8,1,-1,-0.093740846,1,-1.396860592,-0.967319247,0.575986904,99,50,49,1,-1.216646676,-1.170500555,-1.20951724,1.519491079,-0.219328559,0.219328559,-1.20951724,-1.170500555,0,1,0
5708,24,189,17,50,43,1,3240.047,10,1579.052,MORE,-1008,2368,1360,4,1,-7,-0.656185922,7,-0.349215148,-0.583589298,-0.507304314,93,50,43,1,-1.336316841,-1.170500555,-1.443617351,-0.582398598,-0.295758433,0.295758433,-1.443617351,-1.170500555,0,0,0
5709,24,190,21,80,82,1,2056.268,60,1417.259,MORE,406,810,1216,2,2,2,0.187481692,2,-1.222253018,1.335060448,-0.909545472,162,80,82,0,0.039890055,0,0.07803337,-1.633343436,0.960890895,0.960890895,0.07803337,0,1,0,1
5710,24,191,10,50,60,1,2066.19,40,2015.443,MORE,-206,1310,1104,3,1,10,0.937408461,10,0.174607574,0.56760055,-0.906174035,110,50,60,0,-0.997251374,-1.170500555,-0.780333703,-1.107871017,0.41699458,0.41699458,-0.780333703,-1.170500555,1,0,1
5711,24,192,3,53,50,0,6681.316,20,1637.29,MORE,-2442,4304,1862,6,1,-3,-0.281222538,3,-1.047645444,-0.199859349,0.662018701,103,53,50,1,-1.136866566,-1.053450499,-1.170500555,0.46854624,-1.57018215,1.57018215,-1.170500555,-1.053450499,0,1,0
5712,24,193,45,122,110,0,9861.942,0,1893.07,MORE,716,4310,5026,8,1,-12,-1.124890153,12,0.523822722,-0.967319247,1.742776754,232,122,110,1,1.436041979,1.638700776,1.170500555,1.519491079,1.23639393,1.23639393,1.170500555,1.638700776,0,1,1
5713,24,194,38,67,80,1,2324.637,70,962.059,MORE,310,986,1296,3,2,13,1.218630999,13,0.698430296,1.718790397,-0.81835526,147,67,80,0,-0.259285357,-0.507216907,0,-1.107871017,0.875573826,0.875573826,0,-0.507216907,1,0,1
5714,24,195,38,80,67,0,6921.754,20,1649.917,MORE,-822,3434,2612,6,1,-13,-1.218630999,13,0.698430296,-0.199859349,0.743718123,147,80,67,1,-0.259285357,0,-0.507216907,0.46854624,-0.130456612,0.130456612,-0.507216907,0,0,1,0
5715,24,196,36,70,80,1,2406.314,20,1629.79,MORE,190,1008,1198,3,2,10,0.937408461,10,0.174607574,-0.199859349,-0.790601895,150,70,80,0,-0.199450275,-0.390166852,0,-1.107871017,0.76892749,0.76892749,0,-0.390166852,0,0,1
5716,24,197,45,110,122,1,2452.491,50,2233.167,MORE,262,1140,1402,3,2,12,1.124890153,12,0.523822722,0.951330499,-0.774911221,232,110,122,0,1.436041979,1.170500555,1.638700776,-1.107871017,0.832915292,0.832915292,1.638700776,1.170500555,1,0,1
5717,24,198,42,110,115,1,2897.344,50,2296.802,MORE,40,1198,1238,5,2,5,0.46870423,5,-0.698430296,0.951330499,-0.623752782,225,110,115,0,1.296426786,1.170500555,1.36558398,-0.056926179,0.63561957,0.63561957,1.36558398,1.170500555,1,0,1
5718,24,199,41,110,112,1,3221.279,10,1811.547,MORE,162,1594,1756,4,1,2,0.187481692,2,-1.222253018,-0.583589298,-0.51368157,222,110,112,0,1.236591704,1.170500555,1.248533925,-0.582398598,0.744043345,0.744043345,1.248533925,1.170500555,0,0,1
5719,24,200,53,110,103,1,6580.304,0,3142.961,MORE,-1070,3438,2368,6,2,-7,-0.656185922,7,-0.349215148,-0.967319247,0.627695416,213,110,103,1,1.057086457,1.170500555,0.897383758,0.46854624,-0.35085904,0.35085904,0.897383758,1.170500555,0,1,0
5720,24,201,3,50,53,0,2888.724,10,1041.789,LESS,-1178,2186,1008,3,1,3,0.281222538,3,-1.047645444,-0.583589298,-0.626681808,103,50,53,1,-1.136866566,-1.170500555,-1.053450499,-1.107871017,-0.446840743,0.446840743,-1.053450499,-1.170500555,0,0,0
5721,24,202,20,50,40,1,4297.435,0,2077.628,LESS,-378,2452,2074,5,1,-10,-0.937408461,10,0.174607574,-0.967319247,-0.148010075,90,50,40,0,-1.396151924,-1.170500555,-1.560667406,-0.056926179,0.264134832,0.264134832,-1.560667406,-1.170500555,0,1,1
5722,24,203,25,80,88,0,2260.145,0,1643.565,LESS,-1240,2078,838,4,1,8,0.749926769,8,-0.174607574,-0.967319247,-0.840269264,168,80,88,1,0.15956022,0,0.312133481,-0.582398598,-0.50194135,0.50194135,0.312133481,0,0,0,0
5723,24,204,42,115,110,1,1960.698,0,2234.769,LESS,-446,1926,1480,3,1,-5,-0.46870423,5,-0.698430296,-0.967319247,-0.942019597,225,115,110,0,1.296426786,1.36558398,1.170500555,-1.107871017,0.203701908,0.203701908,1.170500555,1.36558398,0,0,1
5724,24,205,53,103,110,1,3239.019,0,1046.699,LESS,-8,1866,1858,5,1,7,0.656185922,7,-0.349215148,-0.967319247,-0.507653622,213,103,110,1,1.057086457,0.897383758,1.170500555,-0.056926179,0.592961035,0.592961035,1.170500555,0.897383758,0,1,1
5725,24,206,26,90,80,1,2213.529,40,1340.78,LESS,418,794,1212,4,1,-10,-0.937408461,10,0.174607574,0.56760055,-0.856109107,170,90,80,0,0.199450275,0.390166852,0,-0.582398598,0.971555529,0.971555529,0,0.390166852,1,0,1
5726,24,207,35,80,72,0,2944.044,0,2125.16,LESS,-1426,2558,1132,4,1,-8,-0.749926769,8,-0.174607574,-0.967319247,-0.607884396,152,80,72,0,-0.15956022,0,-0.312133481,-0.582398598,-0.667243171,0.667243171,-0.312133481,0,0,0,0
5727,24,208,28,93,80,0,5211.769,0,1507.384,LESS,-1230,3274,2044,6,1,-13,-1.218630999,13,0.698430296,-0.967319247,0.162675253,173,93,80,0,0.259285357,0.507216907,0,0.46854624,-0.493054155,0.493054155,0,0.507216907,0,1,0
5728,24,209,26,80,90,0,3964.665,0,1701.608,LESS,-944,2910,1966,6,1,10,0.937408461,10,0.174607574,-0.967319247,-0.261083369,170,80,90,1,0.199450275,0,0.390166852,0.46854624,-0.238880387,0.238880387,0.390166852,0,0,1,0
5729,24,210,25,88,80,1,3423.163,20,1396.146,LESS,22,1766,1788,6,1,-8,-0.749926769,8,-0.174607574,-0.199859349,-0.445082571,168,88,80,0,0.15956022,0.312133481,0,0.46854624,0.619622619,0.619622619,0,0.312133481,1,1,1
5730,24,211,36,80,70,1,2643.279,60,1180.299,LESS,342,1068,1410,5,2,-10,-0.937408461,10,0.174607574,1.335060448,-0.710082578,150,80,70,0,-0.199450275,0,-0.390166852,-0.056926179,0.904012849,0.904012849,-0.390166852,0,1,1,1
5731,24,212,28,80,93,0,4970.891,20,1667.656,LESS,-1390,3020,1630,6,1,13,1.218630999,13,0.698430296,-0.199859349,0.080826322,173,80,93,1,0.259285357,0,0.507216907,0.46854624,-0.63524927,0.63524927,0.507216907,0,1,1,0
5732,24,213,21,82,80,1,3342.673,10,1915.926,LESS,-240,2246,2006,5,1,-2,-0.187481692,2,-1.222253018,-0.583589298,-0.472432601,162,82,80,0,0.039890055,0.07803337,0,-0.056926179,0.386778119,0.386778119,0,0.07803337,0,1,1
5733,24,214,19,50,41,1,1978.514,60,1126.782,LESS,172,924,1096,3,2,-9,-0.843667615,9,0,1.335060448,-0.935965825,91,50,41,0,-1.376206896,-1.170500555,-1.521650721,-1.107871017,0.752930539,0.752930539,-1.521650721,-1.170500555,1,0,1
5734,24,215,56,96,110,0,6042.265,60,1716.679,LESS,-1054,3346,2292,8,1,14,1.312371845,14,0.87303787,1.335060448,0.444872921,206,96,110,1,0.917471264,0.624266962,1.170500555,1.519491079,-0.336639529,0.336639529,1.170500555,0.624266962,1,1,0
5735,24,216,23,80,85,0,2930.168,0,2132.242,LESS,-1388,2426,1038,4,1,5,0.46870423,5,-0.698430296,-0.967319247,-0.61259938,165,80,85,1,0.099725137,0,0.195083426,-0.582398598,-0.633471831,0.633471831,0.195083426,0,0,0,0
5736,24,217,10,60,50,0,6251.257,10,2752.489,LESS,-3316,4950,1634,6,1,-10,-0.937408461,10,0.174607574,-0.583589298,0.515887176,110,60,50,0,-0.997251374,-0.780333703,-1.170500555,0.46854624,-2.346922966,2.346922966,-1.170500555,-0.780333703,0,1,0
5737,24,218,19,41,50,0,1759.21,70,1853.746,LESS,-406,1122,716,2,1,9,0.843667615,9,0,1.718790397,-1.010484037,91,41,50,1,-1.376206896,-1.521650721,-1.170500555,-1.633343436,0.239250687,0.239250687,-1.170500555,-1.521650721,1,0,1
5738,24,219,56,110,96,1,4677.634,0,1588.027,LESS,-128,2566,2438,7,1,-14,-1.312371845,14,0.87303787,-0.967319247,-0.018820686,206,110,96,0,0.917471264,1.170500555,0.624266962,0.99401866,0.486314699,0.486314699,0.624266962,1.170500555,0,1,1
5739,24,220,35,72,80,0,2788.571,30,1994.351,LESS,-1374,2510,1136,4,1,8,0.749926769,8,-0.174607574,0.183870601,-0.660713209,152,72,80,1,-0.15956022,-0.312133481,0,-0.582398598,-0.621029758,0.621029758,0,-0.312133481,1,0,0
5740,24,221,11,49,50,0,2701.609,70,718.12,LESS,-254,1554,1300,4,2,1,0.093740846,1,-1.396860592,1.718790397,-0.690262387,99,49,50,1,-1.216646676,-1.20951724,-1.170500555,-0.582398598,0.374336046,0.374336046,-1.170500555,-1.20951724,1,0,1
5741,24,222,17,43,50,0,2059.749,90,716.688,LESS,-104,1312,1208,4,2,7,0.656185922,7,-0.349215148,2.486250295,-0.908362649,93,43,50,1,-1.336316841,-1.443617351,-1.170500555,-0.582398598,0.507643966,0.507643966,-1.170500555,-1.443617351,1,0,1
5742,24,223,1,51,50,0,2985.155,20,1186.114,LESS,-1640,2614,974,4,1,-1,-0.093740846,1,-1.396860592,-0.199859349,-0.59391512,101,51,50,0,-1.176756621,-1.131483869,-1.170500555,-0.582398598,-0.857429137,0.857429137,-1.170500555,-1.131483869,1,0,0
5743,24,224,41,112,110,0,3842.488,0,1369.382,LESS,-1270,2652,1382,5,1,-2,-0.187481692,2,-1.222253018,-0.967319247,-0.302598397,222,112,110,0,1.236591704,1.248533925,1.170500555,-0.056926179,-0.528602934,0.528602934,1.170500555,1.248533925,0,1,0
5744,24,225,20,40,50,0,1674.875,100,606.025,LESS,12,1030,1042,2,2,10,0.937408461,10,0.174607574,2.869980245,-1.039140576,90,40,50,1,-1.396151924,-1.560667406,-1.170500555,-1.633343436,0.610735425,0.610735425,-1.170500555,-1.560667406,1,0,1
5745,24,226,1,50,51,1,3977.509,30,1528.599,LESS,534,1438,1972,5,2,1,0.093740846,1,-1.396860592,0.183870601,-0.256719053,101,50,51,1,-1.176756621,-1.170500555,-1.131483869,-0.056926179,1.074646987,1.074646987,-1.131483869,-1.170500555,1,1,1
5746,24,227,23,85,80,0,6565.472,0,1111.009,LESS,-694,3402,2708,8,1,-5,-0.46870423,5,-0.698430296,-0.967319247,0.62265559,165,85,80,0,0.099725137,0.195083426,0,1.519491079,-0.01670052,0.01670052,0,0.195083426,0,1,1
5747,24,228,11,50,49,0,2701.208,80,780.156,LESS,74,1510,1584,4,2,-1,-0.093740846,1,-1.396860592,2.102520346,-0.690398644,99,50,49,0,-1.216646676,-1.170500555,-1.20951724,-0.582398598,0.665836032,0.665836032,-1.20951724,-1.170500555,1,0,1
5748,24,229,17,50,43,0,4268.8,20,1476.894,LESS,182,1818,2000,4,1,-7,-0.656185922,7,-0.349215148,-0.199859349,-0.15774008,93,50,43,0,-1.336316841,-1.170500555,-1.443617351,-0.582398598,0.761817734,0.761817734,-1.443617351,-1.170500555,1,0,1
5749,24,230,21,80,82,0,4315.806,0,3020.35,LESS,-1456,3192,1736,6,1,2,0.187481692,2,-1.222253018,-0.967319247,-0.141767717,162,80,82,1,0.039890055,0,0.07803337,0.46854624,-0.693904755,0.693904755,0.07803337,0,0,1,0
5750,24,231,10,50,60,0,3440.885,60,1796.761,LESS,-730,2074,1344,4,1,10,0.937408461,10,0.174607574,1.335060448,-0.43906074,110,50,60,1,-0.997251374,-1.170500555,-0.780333703,-0.582398598,-0.048694421,0.048694421,-0.780333703,-1.170500555,1,0,1
5751,24,232,3,53,50,0,3279.55,60,1414.808,LESS,-50,1556,1506,4,2,-3,-0.281222538,3,-1.047645444,1.335060448,-0.493881426,103,53,50,0,-1.136866566,-1.053450499,-1.170500555,-0.582398598,0.555634817,0.555634817,-1.170500555,-1.053450499,1,0,1
5752,24,233,45,122,110,1,4856.092,0,900.742,LESS,450,1762,2212,7,2,-12,-1.124890153,12,0.523822722,-0.967319247,0.041818295,232,122,110,0,1.436041979,1.638700776,1.170500555,0.99401866,0.999994552,0.999994552,1.170500555,1.638700776,0,1,1
5753,24,234,38,67,80,0,2480.809,30,2844.72,LESS,-702,1578,876,4,1,13,1.218630999,13,0.698430296,0.183870601,-0.765288931,147,67,80,1,-0.259285357,-0.507216907,0,-0.582398598,-0.023810276,0.023810276,0,-0.507216907,1,0,1
5754,24,235,38,80,67,0,6157.77,10,1910.24,LESS,-1106,3382,2276,8,1,-13,-1.218630999,13,0.698430296,-0.583589298,0.484120842,147,80,67,0,-0.259285357,0,-0.507216907,1.519491079,-0.382852941,0.382852941,-0.507216907,0,0,1,0
5755,24,236,36,70,80,0,2544.731,80,2092.882,LESS,282,1556,1838,4,2,10,0.937408461,10,0.174607574,2.102520346,-0.743568611,150,70,80,1,-0.199450275,-0.390166852,0,-0.582398598,0.850689681,0.850689681,0,-0.390166852,1,0,1
5756,24,237,45,110,122,0,2351.11,20,1296.011,LESS,-684,1492,808,4,1,12,1.124890153,12,0.523822722,-0.199859349,-0.80935989,232,110,122,1,1.436041979,1.170500555,1.638700776,-0.582398598,-0.007813325,0.007813325,1.638700776,1.170500555,1,0,1
5757,24,238,42,110,115,0,2895.454,0,2457.08,LESS,-1532,2382,850,4,1,5,0.46870423,5,-0.698430296,-0.967319247,-0.624394993,225,110,115,1,1.296426786,1.170500555,1.36558398,-0.582398598,-0.761447434,0.761447434,1.36558398,1.170500555,0,0,0
5758,24,239,41,110,112,0,3671.883,0,1060.336,LESS,-1196,2806,1610,6,1,2,0.187481692,2,-1.222253018,-0.967319247,-0.360568974,222,110,112,1,1.236591704,1.170500555,1.248533925,0.46854624,-0.462837693,0.462837693,1.248533925,1.170500555,0,1,0
5759,24,240,53,110,103,1,5307.49,0,1882.147,LESS,704,2152,2856,4,1,-7,-0.656185922,7,-0.349215148,-0.967319247,0.195200687,213,110,103,0,1.057086457,1.170500555,0.897383758,-0.582398598,1.225729296,1.225729296,0.897383758,1.170500555,0,0,1
5760,25,1,49,110,131,0,10605.34,4,2316.401,LESS,-4108,7376,3268,6,1,21,1.968557767,21,2.095290887,-1.259371076,0.987576908,241,110,131,1,1.615547226,1.170500555,1.989850943,1.147158426,-1.843103328,1.843103328,1.989850943,1.170500555,0,1,0
5761,25,2,13,47,50,0,6873.107,14,2518.451,LESS,-1730,4706,2976,4,1,3,0.281222538,3,-1.047645444,-0.489505925,0.020594337,97,47,50,1,-1.256536731,-1.28755061,-1.170500555,0.01416245,-0.394091108,0.394091108,-1.170500555,-1.28755061,1,0,0
5762,25,3,16,50,44,0,9148.281,4,3420.894,LESS,-3480,6388,2908,6,1,-6,-0.562445076,6,-0.523822722,-1.259371076,0.610068146,94,50,44,0,-1.316371814,-1.170500555,-1.404600665,1.147158426,-1.460437359,1.460437359,-1.404600665,-1.170500555,0,1,0
5763,25,4,7,57,50,1,9435.773,14,2636.511,LESS,-1670,5696,4026,5,1,-7,-0.656185922,7,-0.349215148,-0.489505925,0.68455432,107,57,50,0,-1.057086457,-0.897383758,-1.170500555,0.580660438,-0.357530665,0.357530665,-1.170500555,-0.897383758,1,1,0
5764,25,5,18,42,50,0,5681.378,14,1826.936,LESS,-3688,4538,850,2,1,8,0.749926769,8,-0.174607574,-0.489505925,-0.288170193,92,42,50,1,-1.356261869,-1.482634036,-1.170500555,-1.118833527,-1.587180228,1.587180228,-1.170500555,-1.482634036,1,0,0
5765,25,6,51,108,110,0,14484.907,4,2868.844,LESS,-5850,10522,4672,5,1,2,0.187481692,2,-1.222253018,-1.259371076,1.992732178,218,108,110,1,1.156811594,1.092467184,1.170500555,0.580660438,-2.904574854,2.904574854,1.170500555,1.092467184,0,1,0
5766,25,7,31,78,80,1,20821.753,4,3094.095,LESS,-2456,10058,7602,7,1,2,0.187481692,2,-1.222253018,-1.259371076,3.63454276,158,78,80,1,-0.039890055,-0.07803337,0,1.713656414,-0.836472467,0.836472467,0,-0.07803337,0,1,0
5767,25,8,58,110,92,1,5124.241,24,4217.061,LESS,-1712,3552,1840,3,1,-18,-1.687335229,18,1.571468165,0.280359226,-0.432518568,202,110,92,0,0.837691154,1.170500555,0.468200222,-0.552335538,-0.383122975,0.383122975,0.468200222,1.170500555,1,0,0
5768,25,9,12,50,48,1,4464.752,14,2806.906,LESS,-1878,3758,1880,4,1,-2,-0.187481692,2,-1.222253018,-0.489505925,-0.603385277,98,50,48,0,-1.236591704,-1.170500555,-1.248533925,0.01416245,-0.484273533,0.484273533,-1.248533925,-1.170500555,0,0,0
5769,25,10,54,110,101,0,12785.335,4,2251,LESS,-4066,8028,3962,2,1,-9,-0.843667615,9,0,-1.259371076,1.552390833,211,110,101,0,1.017196402,1.170500555,0.819350388,-1.118833527,-1.817511018,1.817511018,0.819350388,1.170500555,0,0,0
5770,25,11,14,46,50,0,11620.869,14,1150.332,LESS,-5824,8714,2890,6,1,4,0.374963384,4,-0.87303787,-0.489505925,1.25068986,96,46,50,1,-1.276481759,-1.326567295,-1.170500555,1.147158426,-2.888731996,2.888731996,-1.170500555,-1.326567295,0,1,0
5771,25,12,22,80,83,0,6066.034,14,2004.16,LESS,-1582,3612,2030,6,1,3,0.281222538,3,-1.047645444,-0.489505925,-0.188509843,163,80,83,1,0.059835082,0,0.117050055,1.147158426,-0.303908682,0.303908682,0.117050055,0,0,1,0
5772,25,13,6,50,56,0,14469.857,4,1295.322,LESS,-4254,9140,4886,10,1,6,0.562445076,6,-0.523822722,-1.259371076,1.98883288,106,50,56,1,-1.077031484,-1.170500555,-0.936400444,3.413150379,-1.932067073,1.932067073,-0.936400444,-1.170500555,0,1,0
5773,25,14,13,50,47,0,14354.673,4,3287.061,LESS,98,6988,7086,7,1,-3,-0.281222538,3,-1.047645444,-1.259371076,1.95898991,97,50,47,0,-1.256536731,-1.170500555,-1.28755061,1.713656414,0.71978372,0.71978372,-1.28755061,-1.170500555,0,1,1
5774,25,15,46,110,124,0,8853.375,14,2963.717,LESS,-762,5084,4322,3,1,14,1.312371845,14,0.87303787,-0.489505925,0.533661083,234,110,124,1,1.475932034,1.170500555,1.716734147,-0.552335538,0.195750705,0.195750705,1.716734147,1.170500555,0,0,1
5775,25,16,27,91,80,1,8577.71,14,2093.802,LESS,1112,3448,4560,5,1,-11,-1.031149307,11,0.349215148,-0.489505925,0.462239163,171,91,80,0,0.219395302,0.429183537,0,0.580660438,1.337655205,1.337655205,0,0.429183537,0,1,1
5776,25,17,40,64,80,0,22884.768,14,1360.861,LESS,3882,7340,11222,7,1,16,1.499853537,16,1.222253018,-0.489505925,4.169048389,144,64,80,1,-0.31912044,-0.624266962,0,1.713656414,3.025528986,3.025528986,0,-0.624266962,0,1,1
5777,25,18,22,83,80,1,18738.581,4,1103.152,LESS,-5984,10218,4234,8,1,-3,-0.281222538,3,-1.047645444,-1.259371076,3.094814663,163,83,80,0,0.059835082,0.117050055,0,2.280154402,-2.98622651,2.98622651,0,0.117050055,0,1,0
5778,25,19,54,101,110,0,7137.299,14,1845.347,LESS,-1700,4270,2570,3,1,9,0.843667615,9,0,-0.489505925,0.089043724,211,101,110,1,1.017196402,0.819350388,1.170500555,-0.552335538,-0.375810886,0.375810886,1.170500555,0.819350388,0,0,0
5779,25,20,6,56,50,1,7638.14,24,1541.85,LESS,1724,2488,4212,3,1,-6,-0.562445076,6,-0.523822722,0.280359226,0.218806394,106,56,50,0,-1.077031484,-0.936400444,-1.170500555,-0.552335538,1.710571723,1.710571723,-1.170500555,-0.936400444,1,0,1
5780,25,21,18,50,42,1,5032.886,24,2205.122,LESS,1976,1440,3416,3,2,-8,-0.749926769,8,-0.174607574,0.280359226,-0.456187694,92,50,42,0,-1.356261869,-1.170500555,-1.482634036,-0.552335538,1.864125583,1.864125583,-1.482634036,-1.170500555,1,0,1
5781,25,22,43,110,117,0,5773.341,14,1338.019,LESS,-3516,4860,1344,4,1,7,0.656185922,7,-0.349215148,-0.489505925,-0.264343541,227,110,117,1,1.336316841,1.170500555,1.443617351,0.01416245,-1.482373625,1.482373625,1.443617351,1.170500555,0,0,0
5782,25,23,32,77,80,1,18916.334,10,1193.419,LESS,1348,7150,8498,7,1,3,0.281222538,3,-1.047645444,-0.797451985,3.140868608,157,77,80,1,-0.059835082,-0.117050055,0,1.713656414,1.481459614,1.481459614,0,-0.117050055,0,1,1
5783,25,24,27,80,91,0,3767.677,24,3399.959,LESS,-3066,4092,1026,4,1,11,1.031149307,11,0.349215148,0.280359226,-0.783990125,171,80,91,1,0.219395302,0,0.429183537,0.01416245,-1.208170303,1.208170303,0.429183537,0,1,0,0
5784,25,25,16,44,50,0,8356.347,4,1279.957,LESS,-1060,4728,3668,4,1,6,0.562445076,6,-0.523822722,-1.259371076,0.404886322,94,44,50,1,-1.316371814,-1.404600665,-1.170500555,0.01416245,0.014167172,0.014167172,-1.170500555,-1.404600665,0,1,1
5785,25,26,7,50,57,0,10362.932,14,1684.601,LESS,-2470,6272,3802,6,1,7,0.656185922,7,-0.349215148,-0.489505925,0.924771528,107,50,57,1,-1.057086457,-1.170500555,-0.897383758,1.147158426,-0.845003237,0.845003237,-0.897383758,-1.170500555,1,1,0
5786,25,27,14,50,46,1,18878.189,4,798.083,LESS,-774,7924,7150,10,1,-4,-0.374963384,4,-0.87303787,-1.259371076,3.130985637,96,50,46,0,-1.276481759,-1.170500555,-1.326567295,3.413150379,0.188438616,0.188438616,-1.326567295,-1.170500555,0,1,1
5787,25,28,51,110,108,0,16446.413,0,2903.029,LESS,-7400,11778,4378,9,1,-2,-0.187481692,2,-1.222253018,-1.567317136,2.500937886,218,110,108,0,1.156811594,1.170500555,1.092467184,2.84665239,-3.849052963,3.849052963,1.092467184,1.170500555,0,1,0
5788,25,29,50,133,110,1,6331.503,24,1739.592,LESS,-2298,4498,2200,4,1,-23,-2.15603946,23,2.444506035,0.280359226,-0.119729599,243,133,110,0,1.655437281,2.067884313,1.170500555,0.01416245,-0.740196634,0.740196634,1.170500555,2.067884313,1,1,0
5789,25,30,49,131,110,1,4537.676,24,3742.15,LESS,-3108,4778,1670,5,1,-21,-1.968557767,21,2.095290887,0.280359226,-0.584491431,241,131,110,0,1.615547226,1.989850943,1.170500555,0.580660438,-1.233762613,1.233762613,1.170500555,1.989850943,1,1,0
5790,25,31,47,126,110,1,4827.674,14,2619.109,LESS,-616,2652,2036,5,1,-16,-1.499853537,16,1.222253018,-0.489505925,-0.509355979,236,126,110,0,1.515822089,1.794767517,1.170500555,0.580660438,0.284714449,0.284714449,1.170500555,1.794767517,0,1,1
5791,25,32,50,110,133,0,4442.857,14,2701.952,LESS,-1530,3574,2044,4,1,23,2.15603946,23,2.444506035,-0.489505925,-0.609058043,243,110,133,1,1.655437281,1.170500555,2.067884313,0.01416245,-0.272222965,0.272222965,2.067884313,1.170500555,0,1,0
5792,25,33,47,110,126,0,4583.469,24,2165.923,LESS,-3478,4906,1428,4,1,16,1.499853537,16,1.222253018,0.280359226,-0.572626943,236,110,126,1,1.515822089,1.170500555,1.794767517,0.01416245,-1.459218678,1.459218678,1.794767517,1.170500555,1,1,0
5793,25,34,12,48,50,0,6211.153,24,1769.459,LESS,-188,2950,2762,4,1,2,0.187481692,2,-1.222253018,0.280359226,-0.150911027,98,48,50,1,-1.236591704,-1.248533925,-1.170500555,0.01416245,0.545512275,0.545512275,-1.170500555,-1.248533925,1,1,1
5794,25,35,32,80,77,1,11220.262,4,982.316,LESS,460,4900,5360,7,1,-3,-0.281222538,3,-1.047645444,-1.259371076,1.146896772,157,80,77,0,-0.059835082,0,-0.117050055,1.713656414,0.940365059,0.940365059,-0.117050055,0,0,1,1
5795,25,36,43,117,110,1,9336.648,14,2396.665,LESS,-1086,4386,3300,4,1,-7,-0.656185922,7,-0.349215148,-0.489505925,0.658872068,227,117,110,0,1.336316841,1.443617351,1.170500555,0.01416245,-0.001675687,0.001675687,1.170500555,1.443617351,1,1,1
5796,25,37,40,80,64,1,8353.089,24,1603.546,LESS,-1630,4494,2864,5,1,-16,-1.499853537,16,1.222253018,0.280359226,0.404042209,144,80,64,0,-0.31912044,0,-0.624266962,0.580660438,-0.333157036,0.333157036,-0.624266962,0,1,1,0
5797,25,38,31,80,78,1,10986.937,24,3083.335,LESS,-1388,5656,4268,6,1,-2,-0.187481692,2,-1.222253018,0.280359226,1.086444703,158,80,78,0,-0.039890055,0,-0.07803337,1.147158426,-0.185696583,0.185696583,-0.07803337,0,1,1,1
5798,25,39,46,124,110,1,3494.054,34,2710.315,LESS,-704,2282,1578,4,1,-14,-1.312371845,14,0.87303787,1.050224376,-0.854882985,234,124,110,0,1.475932034,1.716734147,1.170500555,0.01416245,0.231092466,0.231092466,1.170500555,1.716734147,1,1,1
5799,25,40,58,92,110,0,5148.55,44,2518.615,LESS,-2470,3524,1054,3,1,18,1.687335229,18,1.571468165,1.820089527,-0.42622036,202,92,110,1,0.837691154,0.468200222,1.170500555,-0.552335538,-0.845003237,0.845003237,1.170500555,0.468200222,1,0,0
5800,25,41,49,110,131,1,2573.855,34,1426.429,MORE,8,1078,1086,3,1,21,1.968557767,21,2.095290887,1.050224376,-1.093296931,241,110,131,0,1.615547226,1.170500555,1.989850943,-0.552335538,0.664943056,0.664943056,1.989850943,1.170500555,1,0,1
5801,25,42,13,47,50,1,2276.933,34,1358.422,MORE,94,968,1062,3,2,3,0.281222538,3,-1.047645444,1.050224376,-1.170226318,97,47,50,0,-1.256536731,-1.28755061,-1.170500555,-0.552335538,0.717346357,0.717346357,-1.170500555,-1.28755061,1,0,1
5802,25,43,16,50,44,0,6313.423,24,2465.487,MORE,-3014,4864,1850,5,1,-6,-0.562445076,6,-0.523822722,0.280359226,-0.124413939,94,50,44,1,-1.316371814,-1.170500555,-1.404600665,0.580660438,-1.176484586,1.176484586,-1.404600665,-1.170500555,1,1,0
5803,25,44,7,57,50,0,4063.28,24,1591.708,MORE,-1646,2682,1036,4,1,-7,-0.656185922,7,-0.349215148,0.280359226,-0.707402477,107,57,50,1,-1.057086457,-0.897383758,-1.170500555,0.01416245,-0.342906488,0.342906488,-1.170500555,-0.897383758,1,1,0
5804,25,45,18,42,50,1,2272.777,24,3530.791,MORE,184,926,1110,3,2,8,0.749926769,8,-0.174607574,0.280359226,-1.171303094,92,42,50,0,-1.356261869,-1.482634036,-1.170500555,-0.552335538,0.772187021,0.772187021,-1.170500555,-1.482634036,1,0,1
5805,25,46,51,108,110,1,7273.913,34,1492.131,MORE,418,3094,3512,5,2,2,0.187481692,2,-1.222253018,1.050224376,0.124438984,218,108,110,0,1.156811594,1.092467184,1.170500555,0.580660438,0.914772749,0.914772749,1.170500555,1.092467184,1,1,1
5806,25,47,31,78,80,0,7112.329,24,1337.695,MORE,-3632,4984,1352,4,1,2,0.187481692,2,-1.222253018,0.280359226,0.082574258,158,78,80,0,-0.039890055,-0.07803337,0,0.01416245,-1.553057148,1.553057148,0,-0.07803337,0,1,0
5807,25,48,58,110,92,0,4954.129,34,1501.587,MORE,416,1594,2010,3,1,-18,-1.687335229,18,1.571468165,1.050224376,-0.47659281,202,110,92,1,0.837691154,1.170500555,0.468200222,-0.552335538,0.913554067,0.913554067,0.468200222,1.170500555,1,0,1
5808,25,49,12,50,48,0,7277.992,14,1677.093,MORE,-1418,3812,2394,6,1,-2,-0.187481692,2,-1.222253018,-0.489505925,0.12549581,98,50,48,1,-1.236591704,-1.170500555,-1.248533925,1.147158426,-0.203976804,0.203976804,-1.248533925,-1.170500555,0,1,0
5809,25,50,54,110,101,1,10290.151,24,2059.916,MORE,-22,3892,3870,6,2,-9,-0.843667615,9,0,0.280359226,0.905914732,211,110,101,1,1.017196402,1.170500555,0.819350388,1.147158426,0.646662834,0.646662834,0.819350388,1.170500555,1,1,1
5810,25,51,14,46,50,1,2719.824,34,2030.219,MORE,242,1012,1254,3,2,4,0.374963384,4,-0.87303787,1.050224376,-1.055477888,96,46,50,0,-1.276481759,-1.326567295,-1.170500555,-0.552335538,0.807528783,0.807528783,-1.170500555,-1.326567295,1,0,1
5811,25,52,22,80,83,0,4433.277,34,1159.777,MORE,-630,2454,1824,4,1,3,0.281222538,3,-1.047645444,1.050224376,-0.611540121,163,80,83,0,0.059835082,0,0.117050055,0.01416245,0.276183679,0.276183679,0.117050055,0,1,1,0
5812,25,53,6,50,56,1,2834.537,24,1222.892,MORE,-474,1514,1040,3,2,6,0.562445076,6,-0.523822722,0.280359226,-1.025756949,106,50,56,0,-1.077031484,-1.170500555,-0.936400444,-0.552335538,0.371240831,0.371240831,-0.936400444,-1.170500555,0,0,1
5813,25,54,13,50,47,1,3205.162,34,2266.878,MORE,614,1092,1706,3,2,-3,-0.281222538,3,-1.047645444,1.050224376,-0.929731884,97,50,47,1,-1.256536731,-1.170500555,-1.28755061,-0.552335538,1.034203529,1.034203529,-1.28755061,-1.170500555,1,0,1
5814,25,55,46,110,124,1,7905.951,20,1787.94,MORE,-3608,4912,1304,3,1,14,1.312371845,14,0.87303787,-0.027586835,0.288193425,234,110,124,0,1.475932034,1.170500555,1.716734147,-0.552335538,-1.538432971,1.538432971,1.716734147,1.170500555,0,0,0
5815,25,56,27,91,80,0,9726.995,34,1987.922,MORE,1748,3436,5184,4,1,-11,-1.031149307,11,0.349215148,1.050224376,0.760006897,171,91,80,1,0.219395302,0.429183537,0,0.01416245,1.7251959,1.7251959,0,0.429183537,1,1,1
5816,25,57,40,64,80,1,5668.465,24,2603.55,MORE,-438,2758,2320,5,2,16,1.499853537,16,1.222253018,0.280359226,-0.291515817,144,64,80,0,-0.31912044,-0.624266962,0,0.580660438,0.393177097,0.393177097,0,-0.624266962,0,1,1
5817,25,58,22,83,80,1,6087.764,24,1042.571,MORE,-306,2786,2480,4,2,-3,-0.281222538,3,-1.047645444,0.280359226,-0.182879827,163,83,80,1,0.059835082,0.117050055,0,0.01416245,0.473610071,0.473610071,0,0.117050055,0,1,1
5818,25,59,54,101,110,1,5074.383,14,1146.652,MORE,-1440,2614,1174,3,2,9,0.843667615,9,0,-0.489505925,-0.445436255,211,101,110,0,1.017196402,0.819350388,1.170500555,-0.552335538,-0.2173823,0.2173823,1.170500555,0.819350388,0,0,0
5819,25,60,6,56,50,0,5837.491,24,1189.985,MORE,-1886,3652,1766,4,1,-6,-0.562445076,6,-0.523822722,0.280359226,-0.247722946,106,56,50,1,-1.077031484,-0.936400444,-1.170500555,0.01416245,-0.489148259,0.489148259,-1.170500555,-0.936400444,0,1,0
5820,25,61,18,50,42,0,10204.94,14,1141.051,MORE,-1392,5132,3740,4,1,-8,-0.749926769,8,-0.174607574,-0.489505925,0.883837452,92,50,42,1,-1.356261869,-1.170500555,-1.482634036,0.01416245,-0.188133946,0.188133946,-1.482634036,-1.170500555,0,1,0
5821,25,62,43,110,117,1,4410.447,34,2333.203,MORE,124,1824,1948,2,2,7,0.656185922,7,-0.349215148,1.050224376,-0.617455135,227,110,117,0,1.336316841,1.170500555,1.443617351,-1.118833527,0.735626578,0.735626578,1.443617351,1.170500555,1,0,1
5822,25,63,32,77,80,1,3228.403,14,2035.005,MORE,-436,1550,1114,2,1,3,0.281222538,3,-1.047645444,-0.489505925,-0.923710384,157,77,80,0,-0.059835082,-0.117050055,0,-1.118833527,0.394395778,0.394395778,0,-0.117050055,0,0,1
5823,25,64,27,80,91,1,3140.789,24,1115.687,MORE,-836,1976,1140,3,2,11,1.031149307,11,0.349215148,0.280359226,-0.946410256,171,80,91,0,0.219395302,0,0.429183537,-0.552335538,0.150659492,0.150659492,0.429183537,0,0,0,0
5824,25,65,16,44,50,1,5966.109,34,1391.48,MORE,-172,2594,2422,5,2,6,0.562445076,6,-0.523822722,1.050224376,-0.214399367,94,44,50,0,-1.316371814,-1.404600665,-1.170500555,0.580660438,0.555261727,0.555261727,-1.170500555,-1.404600665,1,1,1
5825,25,66,7,50,57,1,2245.362,34,1066.58,MORE,-334,1380,1046,3,1,7,0.656185922,7,-0.349215148,1.050224376,-1.178406034,107,50,57,0,-1.057086457,-1.170500555,-0.897383758,-0.552335538,0.456548531,0.456548531,-0.897383758,-1.170500555,1,1,1
5826,25,67,14,50,46,1,5074.143,4,2324.733,MORE,-716,3040,2324,5,1,-4,-0.374963384,4,-0.87303787,-1.259371076,-0.445498437,96,50,46,1,-1.276481759,-1.170500555,-1.326567295,0.580660438,0.223780378,0.223780378,-1.326567295,-1.170500555,0,1,0
5827,25,68,51,110,108,0,3602.406,34,796.659,MORE,-718,2020,1302,2,1,-2,-0.187481692,2,-1.222253018,1.050224376,-0.826810114,218,110,108,1,1.156811594,1.170500555,1.092467184,-1.118833527,0.222561696,0.222561696,1.092467184,1.170500555,1,0,0
5828,25,69,50,133,110,0,6713.881,34,1253.795,MORE,-844,3146,2302,3,1,-23,-2.15603946,23,2.444506035,1.050224376,-0.020659455,243,133,110,1,1.655437281,2.067884313,1.170500555,-0.552335538,0.145784766,0.145784766,1.170500555,2.067884313,1,0,0
5829,25,70,49,131,110,0,8546.707,14,1677.506,MORE,-616,3454,2838,2,1,-21,-1.968557767,21,2.095290887,-0.489505925,0.454206609,241,131,110,1,1.615547226,1.989850943,1.170500555,-1.118833527,0.284714449,0.284714449,1.170500555,1.989850943,0,0,0
5830,25,71,47,126,110,1,8338.258,14,1856.842,MORE,2544,1768,4312,3,1,-16,-1.499853537,16,1.222253018,-0.489505925,0.400199651,236,126,110,1,1.515822089,1.794767517,1.170500555,-0.552335538,2.210231109,2.210231109,1.170500555,1.794767517,0,0,1
5831,25,72,50,110,133,1,2436.319,24,1777.136,MORE,-128,1284,1156,3,1,23,2.15603946,23,2.444506035,0.280359226,-1.128931071,243,110,133,0,1.655437281,1.170500555,2.067884313,-0.552335538,0.582072718,0.582072718,2.067884313,1.170500555,1,1,1
5832,25,73,47,110,126,1,4491.683,34,1345.583,MORE,-80,1894,1814,2,2,16,1.499853537,16,1.222253018,1.050224376,-0.596407736,236,110,126,0,1.515822089,1.170500555,1.794767517,-1.118833527,0.611321073,0.611321073,1.794767517,1.170500555,1,0,1
5833,25,74,12,48,50,1,6058.228,24,1096.328,MORE,-624,2828,2204,4,2,2,0.187481692,2,-1.222253018,0.280359226,-0.190532296,98,48,50,0,-1.236591704,-1.248533925,-1.170500555,0.01416245,0.279839723,0.279839723,-1.170500555,-1.248533925,1,1,0
5834,25,75,32,80,77,0,9096.82,4,2734.943,MORE,-3948,7076,3128,6,1,-3,-0.281222538,3,-1.047645444,-1.259371076,0.596735139,157,80,77,1,-0.059835082,0,-0.117050055,1.147158426,-1.745608814,1.745608814,-0.117050055,0,0,1,0
5835,25,76,43,117,110,1,8202.511,14,1461.689,MORE,-1684,4012,2328,3,1,-7,-0.656185922,7,-0.349215148,-0.489505925,0.365029022,227,117,110,1,1.336316841,1.443617351,1.170500555,-0.552335538,-0.366061435,0.366061435,1.170500555,1.443617351,0,0,0
5836,25,77,40,80,64,0,4408.043,24,1101.58,MORE,-1000,2686,1686,4,1,-16,-1.499853537,16,1.222253018,0.280359226,-0.618077986,144,80,64,1,-0.31912044,0,-0.624266962,0.01416245,0.050727615,0.050727615,-0.624266962,0,1,1,0
5837,25,78,31,80,78,1,8096.268,24,1479.607,MORE,774,2646,3420,3,2,-2,-0.187481692,2,-1.222253018,0.280359226,0.337502571,158,80,78,1,-0.039890055,0,-0.07803337,-0.552335538,1.131698043,1.131698043,-0.07803337,0,1,0,1
5838,25,79,46,124,110,0,9448.103,14,3251.85,MORE,-476,4432,3956,6,1,-14,-1.312371845,14,0.87303787,-0.489505925,0.687748894,234,124,110,1,1.475932034,1.716734147,1.170500555,1.147158426,0.370022149,0.370022149,1.170500555,1.716734147,0,1,1
5839,25,80,58,92,110,1,2913.902,34,1859.341,MORE,-404,1600,1196,3,2,18,1.687335229,18,1.571468165,1.050224376,-1.005194306,202,92,110,0,0.837691154,0.468200222,1.170500555,-0.552335538,0.413894681,0.413894681,1.170500555,0.468200222,1,0,1
5840,25,81,48,128,110,1,5272.922,14,984.661,LESS,-1418,3064,1646,3,1,-18,-1.687335229,18,1.571468165,-0.489505925,-0.393996875,238,128,110,0,1.555712144,1.872800887,1.170500555,-0.552335538,-0.203976804,0.203976804,1.170500555,1.872800887,1,0,0
5841,25,82,8,50,58,0,3494.499,14,940.273,LESS,-1686,2668,982,4,1,8,0.749926769,8,-0.174607574,-0.489505925,-0.854767691,108,50,58,1,-1.037141429,-1.170500555,-0.858367073,0.01416245,-0.367280116,0.367280116,-0.858367073,-1.170500555,1,1,0
5842,25,83,4,54,50,0,1748.989,14,1128.545,LESS,-1320,1790,470,2,1,-4,-0.374963384,4,-0.87303787,-0.489505925,-1.307011092,104,54,50,0,-1.116921539,-1.014433814,-1.170500555,-1.118833527,-0.144261414,0.144261414,-1.170500555,-1.014433814,1,0,1
5843,25,84,37,80,69,1,5231.227,24,1593.327,LESS,-678,3106,2428,5,1,-11,-1.031149307,11,0.349215148,0.280359226,-0.404799614,149,80,69,0,-0.219395302,0,-0.429183537,0.580660438,0.246935325,0.246935325,-0.429183537,0,1,1,1
5844,25,85,52,105,110,1,5080.765,0,1763.715,LESS,-750,3238,2488,5,1,5,0.46870423,5,-0.698430296,-1.567317136,-0.443782746,215,105,110,1,1.096976512,0.975417129,1.170500555,0.580660438,0.203062793,0.203062793,1.170500555,0.975417129,0,1,1
5845,25,86,5,55,50,1,4836.079,34,1603.998,LESS,458,2164,2622,5,1,-5,-0.46870423,5,-0.698430296,1.050224376,-0.507178331,105,55,50,0,-1.096976512,-0.975417129,-1.170500555,0.580660438,0.939146377,0.939146377,-1.170500555,-0.975417129,1,1,1
5846,25,87,30,96,80,1,4108.556,4,1052.647,LESS,-1306,2706,1400,3,1,-16,-1.499853537,16,1.222253018,-1.259371076,-0.695671938,176,96,80,0,0.31912044,0.624266962,0,-0.552335538,-0.135730644,0.135730644,0,0.624266962,0,0,1
5847,25,88,33,80,75,1,3867.341,24,1887.49,LESS,-708,2180,1472,5,1,-5,-0.46870423,5,-0.698430296,0.280359226,-0.758168224,155,80,75,0,-0.099725137,0,-0.195083426,0.580660438,0.228655103,0.228655103,-0.195083426,0,1,1,1
5848,25,89,48,110,128,0,4352.233,0,2435.416,LESS,-2406,3482,1076,4,1,18,1.687335229,18,1.571468165,-1.567317136,-0.632537774,238,110,128,1,1.555712144,1.170500555,1.872800887,0.01416245,-0.806005431,0.806005431,1.872800887,1.170500555,0,1,0
5849,25,90,9,59,50,1,6863.626,24,3318.672,LESS,-22,3726,3704,7,1,-9,-0.843667615,9,0,0.280359226,0.018137909,109,59,50,0,-1.017196402,-0.819350388,-1.170500555,1.713656414,0.646662834,0.646662834,-1.170500555,-0.819350388,1,1,1
5850,25,91,44,110,119,0,1729.758,14,2124.627,LESS,-1118,1476,358,2,1,9,0.843667615,9,0,-0.489505925,-1.311993643,229,110,119,1,1.376206896,1.170500555,1.521650721,-1.118833527,-0.02117459,0.02117459,1.521650721,1.170500555,1,0,1
5851,25,92,2,52,50,1,10487.373,54,1960.654,LESS,-6710,8288,1578,3,2,-2,-0.187481692,2,-1.222253018,2.589954678,0.957012891,102,52,50,0,-1.156811594,-1.092467184,-1.170500555,-0.552335538,-3.42860787,3.42860787,-1.170500555,-1.092467184,1,0,0
5852,25,93,8,58,50,1,9844.776,24,1707.222,LESS,1846,3188,5034,5,2,-8,-0.749926769,8,-0.174607574,0.280359226,0.790522723,108,58,50,0,-1.037141429,-0.858367073,-1.170500555,0.580660438,1.78491129,1.78491129,-1.170500555,-0.858367073,1,1,1
5853,25,94,44,119,110,0,2258.015,0,1299.563,LESS,-2012,2484,472,2,1,-9,-0.843667615,9,0,-1.567317136,-1.175127774,229,119,110,0,1.376206896,1.521650721,1.170500555,-1.118833527,-0.565925189,0.565925189,1.170500555,1.521650721,0,0,0
5854,25,95,34,74,80,0,7393.847,24,1526.868,LESS,-3890,5680,1790,4,1,6,0.562445076,6,-0.523822722,0.280359226,0.15551263,154,74,80,1,-0.119670165,-0.234100111,0,0.01416245,-1.710267053,1.710267053,0,-0.234100111,1,0,0
5855,25,96,24,86,80,0,4631.108,34,2791.27,LESS,-2822,3504,682,2,1,-6,-0.562445076,6,-0.523822722,1.050224376,-0.560284176,166,86,80,0,0.119670165,0.234100111,0,-1.118833527,-1.059491169,1.059491169,0,0.234100111,1,0,0
5856,25,97,39,66,80,0,6976.254,44,1668.703,LESS,-244,3462,3218,2,1,14,1.312371845,14,0.87303787,1.820089527,0.047318647,146,66,80,1,-0.279230385,-0.546233592,0,-1.118833527,0.511389195,0.511389195,0,-0.546233592,1,0,1
5857,25,98,9,50,59,0,3445.728,44,1352.54,LESS,-1570,2310,740,2,1,9,0.843667615,9,0,1.820089527,-0.867403747,109,50,59,1,-1.017196402,-1.170500555,-0.819350388,-1.118833527,-0.296596593,0.296596593,-0.819350388,-1.170500555,1,0,0
5858,25,99,57,94,110,0,14442.578,24,1612.413,LESS,-3114,8082,4968,10,1,16,1.499853537,16,1.222253018,0.280359226,1.981765176,204,94,110,1,0.877581209,0.546233592,1.170500555,3.413150379,-1.237418657,1.237418657,1.170500555,0.546233592,1,1,0
5859,25,100,60,110,87,1,7163.538,14,1199.874,LESS,1474,2612,4086,5,2,-23,-2.15603946,23,2.444506035,-0.489505925,0.095841975,197,110,87,0,0.737966017,1.170500555,0.273116796,0.580660438,1.558236544,1.558236544,0.273116796,1.170500555,1,1,1
5860,25,101,33,75,80,0,17352.241,14,2555.515,LESS,-3144,8478,5334,6,1,5,0.46870423,5,-0.698430296,-0.489505925,2.735628455,155,75,80,1,-0.099725137,-0.195083426,0,1.147158426,-1.255698879,1.255698879,0,-0.195083426,1,1,0
5861,25,102,15,50,45,1,12157.872,44,1685.624,LESS,-3274,6240,2966,4,2,-5,-0.46870423,5,-0.698430296,1.820089527,1.389821726,95,50,45,0,-1.296426786,-1.170500555,-1.36558398,0.01416245,-1.334913172,1.334913172,-1.36558398,-1.170500555,1,0,0
5862,25,103,59,89,110,0,6527.306,14,1395.246,LESS,-880,3510,2630,4,1,21,1.968557767,21,2.095290887,-0.489505925,-0.068999088,199,89,110,1,0.777856072,0.351150166,1.170500555,0.01416245,0.1238485,0.1238485,1.170500555,0.351150166,1,0,1
5863,25,104,29,80,94,0,10886.82,24,2275.221,LESS,-2690,5952,3262,5,1,14,1.312371845,14,0.87303787,0.280359226,1.060505435,174,80,94,1,0.279230385,0,0.546233592,0.580660438,-0.979058194,0.979058194,0.546233592,0,1,1,0
5864,25,105,55,110,98,1,4584.629,24,1873.459,LESS,-1244,2800,1556,2,1,-12,-1.124890153,12,0.523822722,0.280359226,-0.572326399,208,110,98,0,0.957361319,1.170500555,0.702300333,-1.118833527,-0.09795152,0.09795152,0.702300333,1.170500555,1,0,1
5865,25,106,29,94,80,1,4392.289,34,4422.033,LESS,1728,990,2718,3,2,-14,-1.312371845,14,0.87303787,1.050224376,-0.622159683,174,94,80,0,0.279230385,0.546233592,0,-0.552335538,1.713009086,1.713009086,0,0.546233592,1,0,1
5866,25,107,57,110,94,1,3026.221,34,1172.2,LESS,486,1222,1708,3,2,-16,-1.499853537,16,1.222253018,1.050224376,-0.976093627,204,110,94,0,0.877581209,1.170500555,0.546233592,-0.552335538,0.956207917,0.956207917,0.546233592,1.170500555,1,0,1
5867,25,108,39,80,66,1,2553.148,24,1519.703,LESS,464,1024,1488,3,2,-14,-1.312371845,14,0.87303787,0.280359226,-1.098661898,146,80,66,0,-0.279230385,0,-0.546233592,-0.552335538,0.942802422,0.942802422,-0.546233592,0,1,0,1
5868,25,109,4,50,54,0,12648.333,34,1541.418,LESS,-1436,6294,4858,6,1,4,0.374963384,4,-0.87303787,1.050224376,1.516895046,104,50,54,1,-1.116921539,-1.170500555,-1.014433814,1.147158426,-0.214944937,0.214944937,-1.014433814,-1.170500555,1,1,0
5869,25,110,55,98,110,0,14784.401,0,1745.071,LESS,-3716,8974,5258,6,1,12,1.124890153,12,0.523822722,-1.567317136,2.070327944,208,98,110,1,0.957361319,0.702300333,1.170500555,1.147158426,-1.604241768,1.604241768,1.170500555,0.702300333,0,1,0
5870,25,111,2,50,52,1,9254.688,4,1264.751,LESS,-1948,5216,3268,6,1,2,0.187481692,2,-1.222253018,-1.259371076,0.637637088,102,50,52,1,-1.156811594,-1.170500555,-1.092467184,1.147158426,-0.526927384,0.526927384,-1.092467184,-1.170500555,0,1,0
5871,25,112,59,110,89,1,6988.265,24,1875.113,LESS,-156,3196,3040,5,2,-21,-1.968557767,21,2.095290887,0.280359226,0.050430572,199,110,89,0,0.777856072,1.170500555,0.351150166,0.580660438,0.565011178,0.565011178,0.351150166,1.170500555,1,1,1
5872,25,113,60,87,110,0,4438.115,24,2114.827,LESS,-462,2242,1780,1,1,23,2.15603946,23,2.444506035,0.280359226,-0.610286645,197,87,110,1,0.737966017,0.273116796,1.170500555,-1.685331515,0.378552919,0.378552919,1.170500555,0.273116796,1,0,1
5873,25,114,52,110,105,0,13030.08,4,2403.75,LESS,-2792,7296,4504,6,1,-5,-0.46870423,5,-0.698430296,-1.259371076,1.615801705,215,110,105,0,1.096976512,1.170500555,0.975417129,1.147158426,-1.041210947,1.041210947,0.975417129,1.170500555,0,1,0
5874,25,115,30,80,96,0,4169.67,24,4132.783,LESS,-3372,4248,876,2,1,16,1.499853537,16,1.222253018,0.280359226,-0.67983794,176,80,96,1,0.31912044,0,0.624266962,-1.118833527,-1.394628562,1.394628562,0.624266962,0,1,0,0
5875,25,116,24,80,86,1,14829.522,14,2490.427,LESS,670,5880,6550,8,1,6,0.562445076,6,-0.523822722,-0.489505925,2.082018323,166,80,86,1,0.119670165,0,0.234100111,2.280154402,1.068326609,1.068326609,0.234100111,0,1,1,1
5876,25,117,5,50,55,0,4997.609,24,1149.592,LESS,-72,2196,2124,4,1,5,0.46870423,5,-0.698430296,0.280359226,-0.465327596,105,50,55,1,-1.096976512,-1.170500555,-0.975417129,0.01416245,0.616195798,0.616195798,-0.975417129,-1.170500555,1,1,1
5877,25,118,34,80,74,1,12149.061,0,1045.568,LESS,-1758,5734,3976,8,1,-6,-0.562445076,6,-0.523822722,-1.567317136,1.387538888,154,80,74,0,-0.119670165,0,-0.234100111,2.280154402,-0.411152648,0.411152648,-0.234100111,0,0,1,0
5878,25,119,15,45,50,1,9155.211,24,2075.681,LESS,-244,4364,4120,7,2,5,0.46870423,5,-0.698430296,0.280359226,0.611863637,95,45,50,1,-1.296426786,-1.36558398,-1.170500555,1.713656414,0.511389195,0.511389195,-1.170500555,-1.36558398,1,1,1
5879,25,120,37,69,80,0,7639.21,4,2263.74,LESS,-3266,5704,2438,6,1,11,1.031149307,11,0.349215148,-1.259371076,0.219083619,149,69,80,1,-0.219395302,-0.429183537,0,1.147158426,-1.330038446,1.330038446,0,-0.429183537,0,1,0
5880,25,121,48,128,110,0,6615.136,24,1679.148,MORE,-1864,3748,1884,4,1,-18,-1.687335229,18,1.571468165,0.280359226,-0.046243253,238,128,110,1,1.555712144,1.872800887,1.170500555,0.01416245,-0.475742763,0.475742763,1.170500555,1.872800887,0,1,0
5881,25,122,8,50,58,1,5430.728,24,1258.232,MORE,2166,1266,3432,3,2,8,0.749926769,8,-0.174607574,0.280359226,-0.353110989,108,50,58,0,-1.037141429,-1.170500555,-0.858367073,-0.552335538,1.979900319,1.979900319,-0.858367073,-1.170500555,1,1,1
5882,25,123,4,54,50,0,7244.234,34,2447.712,MORE,-2532,4742,2210,7,2,-4,-0.374963384,4,-0.87303787,1.050224376,0.116749465,104,54,50,1,-1.116921539,-1.014433814,-1.170500555,1.713656414,-0.882782361,0.882782361,-1.170500555,-1.014433814,1,1,0
5883,25,124,37,80,69,0,9260.72,14,1195.417,MORE,-1420,4370,2950,6,1,-11,-1.031149307,11,0.349215148,-0.489505925,0.639199916,149,80,69,1,-0.219395302,0,-0.429183537,1.147158426,-0.205195486,0.205195486,-0.429183537,0,0,1,0
5884,25,125,52,105,110,1,6270.738,24,2253.867,MORE,-54,2596,2542,3,2,5,0.46870423,5,-0.698430296,0.280359226,-0.135473176,215,105,110,0,1.096976512,0.975417129,1.170500555,-0.552335538,0.627163931,0.627163931,1.170500555,0.975417129,1,0,1
5885,25,126,5,55,50,0,9983.241,4,1230.641,MORE,-1748,5248,3500,6,1,-5,-0.46870423,5,-0.698430296,-1.259371076,0.826397558,105,55,50,1,-1.096976512,-0.975417129,-1.170500555,1.147158426,-0.40505924,0.40505924,-1.170500555,-0.975417129,0,1,0
5886,25,127,30,96,80,0,6964.184,24,1683.377,MORE,530,2716,3246,3,1,-16,-1.499853537,16,1.222253018,0.280359226,0.044191436,176,96,80,1,0.31912044,0.624266962,0,-0.552335538,0.983018909,0.983018909,0,0.624266962,1,0,1
5887,25,128,33,80,75,0,2931.471,24,1169.441,MORE,-392,1644,1252,2,1,-5,-0.46870423,5,-0.698430296,0.280359226,-1.000642362,155,80,75,1,-0.099725137,0,-0.195083426,-1.118833527,0.421206769,0.421206769,-0.195083426,0,1,0,1
5888,25,129,48,110,128,1,5759.629,24,1341.828,MORE,356,2562,2918,3,2,18,1.687335229,18,1.571468165,0.280359226,-0.267896177,238,110,128,0,1.555712144,1.170500555,1.872800887,-0.552335538,0.876993624,0.876993624,1.872800887,1.170500555,0,1,1
5889,25,130,9,59,50,0,3920.8,44,1735.616,MORE,122,1816,1938,4,1,-9,-0.843667615,9,0,1.820089527,-0.744317556,109,59,50,1,-1.017196402,-0.819350388,-1.170500555,0.01416245,0.734407897,0.734407897,-1.170500555,-0.819350388,1,1,1
5890,25,131,44,110,119,1,10235.104,24,1274.908,MORE,158,4458,4616,4,2,9,0.843667615,9,0,0.280359226,0.891652629,229,110,119,0,1.376206896,1.170500555,1.521650721,0.01416245,0.756344163,0.756344163,1.521650721,1.170500555,0,1,1
5891,25,132,2,52,50,1,7471.273,0,2802.17,MORE,-1684,5190,3506,3,1,-2,-0.187481692,2,-1.222253018,-1.567317136,0.175572898,102,52,50,1,-1.156811594,-1.092467184,-1.170500555,-0.552335538,-0.366061435,0.366061435,-1.170500555,-1.092467184,0,1,0
5892,25,133,8,58,50,0,4530.887,24,1076.717,MORE,-1116,2504,1388,4,1,-8,-0.749926769,8,-0.174607574,0.280359226,-0.58625039,108,58,50,1,-1.037141429,-0.858367073,-1.170500555,0.01416245,-0.019955908,0.019955908,-1.170500555,-0.858367073,0,1,0
5893,25,134,44,119,110,0,4484.656,44,1049.666,MORE,-2348,3460,1112,2,1,-9,-0.843667615,9,0,1.820089527,-0.598228359,229,119,110,1,1.376206896,1.521650721,1.170500555,-1.118833527,-0.77066367,0.77066367,1.170500555,1.521650721,1,0,0
5894,25,135,34,74,80,1,9936.325,34,2466.375,MORE,1412,3994,5406,7,2,6,0.562445076,6,-0.523822722,1.050224376,0.814242112,154,74,80,0,-0.119670165,-0.234100111,0,1.713656414,1.52045742,1.52045742,0,-0.234100111,1,1,1
5895,25,136,24,86,80,0,16153.568,44,2413.943,MORE,4728,4864,9592,6,1,-6,-0.562445076,6,-0.523822722,1.820089527,2.425064806,166,86,80,1,0.119670165,0.234100111,0,1.147158426,3.541031231,3.541031231,0,0.234100111,1,1,1
5896,25,137,39,66,80,1,3876.481,34,1392.611,MORE,504,1434,1938,2,2,14,1.312371845,14,0.87303787,1.050224376,-0.755800146,146,66,80,0,-0.279230385,-0.546233592,0,-1.118833527,0.96717605,0.96717605,0,-0.546233592,1,0,1
5897,25,138,9,50,59,1,5081.794,24,1174.178,MORE,1024,1918,2942,4,1,9,0.843667615,9,0,0.280359226,-0.443516143,109,50,59,0,-1.017196402,-1.170500555,-0.819350388,0.01416245,1.284033222,1.284033222,-0.819350388,-1.170500555,0,1,1
5898,25,139,57,94,110,1,7911.395,24,1390.965,MORE,-856,3558,2702,3,1,16,1.499853537,16,1.222253018,0.280359226,0.289603909,204,94,110,0,0.877581209,0.546233592,1.170500555,-0.552335538,0.138472678,0.138472678,1.170500555,0.546233592,0,0,0
5899,25,140,60,110,87,0,3683.951,44,1821.658,MORE,-518,1980,1462,2,1,-23,-2.15603946,23,2.444506035,1.820089527,-0.805682657,197,110,87,1,0.737966017,1.170500555,0.273116796,-1.118833527,0.344429839,0.344429839,0.273116796,1.170500555,1,0,1
5900,25,141,33,75,80,1,10024.49,14,1966.396,MORE,322,4580,4902,4,1,5,0.46870423,5,-0.698430296,-0.489505925,0.837084742,155,75,80,0,-0.099725137,-0.195083426,0,0.01416245,0.85627604,0.85627604,0,-0.195083426,0,1,1
5901,25,142,15,50,45,0,6029.848,24,2180.159,MORE,-2740,4268,1528,2,1,-5,-0.46870423,5,-0.698430296,0.280359226,-0.197885258,95,50,45,1,-1.296426786,-1.170500555,-1.36558398,-1.118833527,-1.00952523,1.00952523,-1.36558398,-1.170500555,0,0,0
5902,25,143,59,89,110,1,4898.047,54,1327.06,MORE,-246,2276,2030,3,1,21,1.968557767,21,2.095290887,2.589954678,-0.49112307,199,89,110,0,0.777856072,0.351150166,1.170500555,-0.552335538,0.510170514,0.510170514,1.170500555,0.351150166,1,0,1
5903,25,144,29,80,94,1,10050.236,24,2505.546,MORE,1308,4300,5608,3,1,14,1.312371845,14,0.87303787,0.280359226,0.843755262,174,80,94,0,0.279230385,0,0.546233592,-0.552335538,1.457085985,1.457085985,0.546233592,0,0,0,1
5904,25,145,55,110,98,0,9459.282,4,1957.317,MORE,-3238,6356,3118,4,1,-12,-1.124890153,12,0.523822722,-1.259371076,0.690645256,208,110,98,1,0.957361319,1.170500555,0.702300333,0.01416245,-1.312976906,1.312976906,0.702300333,1.170500555,0,1,0
5905,25,146,29,94,80,0,6726.878,34,1612.679,MORE,-1502,3986,2484,4,1,-14,-1.312371845,14,0.87303787,1.050224376,-0.017292068,174,94,80,1,0.279230385,0.546233592,0,0.01416245,-0.255161425,0.255161425,0,0.546233592,1,1,0
5906,25,147,57,110,94,0,4227.071,34,1281.269,MORE,-2338,3162,824,2,1,-16,-1.499853537,16,1.222253018,1.050224376,-0.66496594,204,110,94,1,0.877581209,1.170500555,0.546233592,-1.118833527,-0.764570262,0.764570262,0.546233592,1.170500555,1,0,0
5907,25,148,39,80,66,0,2647.691,34,1360.89,MORE,-690,1624,934,2,1,-14,-1.312371845,14,0.87303787,1.050224376,-1.074166795,146,80,66,1,-0.279230385,0,-0.546233592,-1.118833527,0.239623236,0.239623236,-0.546233592,0,1,0,0
5908,25,149,4,50,54,1,4261.383,34,2449.007,MORE,38,1700,1738,2,2,4,0.374963384,4,-0.87303787,1.050224376,-0.65607606,104,50,54,0,-1.116921539,-1.170500555,-1.014433814,-1.118833527,0.683223277,0.683223277,-1.014433814,-1.170500555,1,0,1
5909,25,150,55,98,110,0,8863.916,14,1582.855,MORE,-1950,5016,3066,4,1,12,1.124890153,12,0.523822722,-0.489505925,0.536392146,208,98,110,0,0.957361319,0.702300333,1.170500555,0.01416245,-0.528146065,0.528146065,1.170500555,0.702300333,0,1,0
5910,25,151,2,50,52,1,9317.731,4,3026.483,MORE,-802,5780,4978,7,1,2,0.187481692,2,-1.222253018,-1.259371076,0.653970871,102,50,52,0,-1.156811594,-1.170500555,-1.092467184,1.713656414,0.171377076,0.171377076,-1.092467184,-1.170500555,0,1,0
5911,25,152,59,110,89,0,5333.204,34,2807.195,MORE,-488,2890,2402,2,1,-21,-1.968557767,21,2.095290887,1.050224376,-0.378378439,199,110,89,1,0.777856072,1.170500555,0.351150166,-1.118833527,0.362710061,0.362710061,0.351150166,1.170500555,1,0,1
5912,25,153,60,87,110,1,2054.79,24,1901.1,MORE,-1038,2112,1074,2,1,23,2.15603946,23,2.444506035,0.280359226,-1.227781248,197,87,110,0,0.737966017,0.273116796,1.170500555,-1.118833527,0.027572667,0.027572667,1.170500555,0.273116796,0,0,0
5913,25,154,52,110,105,0,4031.124,24,1259.272,MORE,-1854,2956,1102,2,1,-5,-0.46870423,5,-0.698430296,0.280359226,-0.715733761,215,110,105,1,1.096976512,1.170500555,0.975417129,-1.118833527,-0.469649356,0.469649356,0.975417129,1.170500555,0,0,0
5914,25,155,30,80,96,1,4050.984,24,1830.995,MORE,-1688,3084,1396,2,1,16,1.499853537,16,1.222253018,0.280359226,-0.710588242,176,80,96,0,0.31912044,0,0.624266962,-1.118833527,-0.368498798,0.368498798,0.624266962,0,0,0,0
5915,25,156,24,80,86,1,2207.765,4,796.279,MORE,-448,1460,1012,4,1,6,0.562445076,6,-0.523822722,-1.259371076,-1.188147024,166,80,86,0,0.119670165,0,0.234100111,0.01416245,0.387083689,0.387083689,0.234100111,0,0,1,1
5916,25,157,5,50,55,1,9500.898,14,2644.792,MORE,366,4490,4856,7,1,5,0.46870423,5,-0.698430296,-0.489505925,0.701427526,105,50,55,0,-1.096976512,-1.170500555,-0.975417129,1.713656414,0.883087032,0.883087032,-0.975417129,-1.170500555,0,1,1
5917,25,158,34,80,74,0,3232.877,34,1496.717,MORE,-504,1856,1352,2,1,-6,-0.562445076,6,-0.523822722,1.050224376,-0.922551217,154,80,74,1,-0.119670165,0,-0.234100111,-1.118833527,0.352960609,0.352960609,-0.234100111,0,1,0,1
5918,25,159,15,45,50,1,2478.6,14,2125.772,MORE,-752,2074,1322,3,1,5,0.46870423,5,-0.698430296,-0.489505925,-1.117976506,95,45,50,0,-1.296426786,-1.36558398,-1.170500555,-0.552335538,0.201844112,0.201844112,-1.170500555,-1.36558398,0,0,0
5919,25,160,37,69,80,1,2495.215,34,2361.678,MORE,-1404,2200,796,2,1,11,1.031149307,11,0.349215148,1.050224376,-1.113671733,149,69,80,0,-0.219395302,-0.429183537,0,-1.118833527,-0.195446034,0.195446034,0,-0.429183537,1,0,0
5920,25,161,3,50,53,1,10451.447,4,1526.366,LESS,-990,5078,4088,9,1,3,0.281222538,3,-1.047645444,-1.259371076,0.94770484,103,50,53,1,-1.136866566,-1.170500555,-1.053450499,2.84665239,0.056821022,0.056821022,-1.053450499,-1.170500555,0,1,1
5921,25,162,20,50,40,1,3062.126,14,2563.921,LESS,-1002,2254,1252,3,1,-10,-0.937408461,10,0.174607574,-0.489505925,-0.966791017,90,50,40,0,-1.396151924,-1.170500555,-1.560667406,-0.552335538,0.049508933,0.049508933,-1.560667406,-1.170500555,0,0,1
5922,25,163,25,80,88,0,2317.785,24,2049.9,LESS,-1514,2140,626,2,1,8,0.749926769,8,-0.174607574,0.280359226,-1.159641992,168,80,88,1,0.15956022,0,0.312133481,-1.118833527,-0.262473513,0.262473513,0.312133481,0,1,0,0
5923,25,164,42,115,110,1,3715.88,14,1749.755,LESS,32,1852,1884,3,1,-5,-0.46870423,5,-0.698430296,-0.489505925,-0.797410187,225,115,110,0,1.296426786,1.36558398,1.170500555,-0.552335538,0.679567233,0.679567233,1.170500555,1.36558398,0,0,1
5924,25,165,53,103,110,1,5518.65,0,2278.78,LESS,-1328,3550,2222,3,1,7,0.656185922,7,-0.349215148,-1.567317136,-0.330331318,213,103,110,1,1.057086457,0.897383758,1.170500555,-0.552335538,-0.14913614,0.14913614,1.170500555,0.897383758,0,0,1
5925,25,166,26,90,80,1,3033.609,14,1959.976,LESS,-464,2018,1554,3,1,-10,-0.937408461,10,0.174607574,-0.489505925,-0.974179474,170,90,80,0,0.199450275,0.390166852,0,-0.552335538,0.377334238,0.377334238,0,0.390166852,0,0,1
5926,25,167,35,80,72,0,6281.081,0,2127.768,LESS,-2120,4664,2544,4,1,-8,-0.749926769,8,-0.174607574,-1.567317136,-0.132793413,152,80,72,0,-0.15956022,0,-0.312133481,0.01416245,-0.631733987,0.631733987,-0.312133481,0,0,0,0
5927,25,168,28,93,80,1,5961.882,24,2023.202,LESS,-632,2884,2252,3,1,-13,-1.218630999,13,0.698430296,0.280359226,-0.215494538,173,93,80,0,0.259285357,0.507216907,0,-0.552335538,0.274964998,0.274964998,0,0.507216907,1,0,1
5928,25,169,26,80,90,0,3211.206,4,1080.095,LESS,-2340,2958,618,2,1,10,0.937408461,10,0.174607574,-1.259371076,-0.928165947,170,80,90,1,0.199450275,0,0.390166852,-1.118833527,-0.765788944,0.765788944,0.390166852,0,0,0,0
5929,25,170,25,88,80,1,3237.87,14,1221.817,LESS,-1198,2322,1124,3,1,-8,-0.749926769,8,-0.174607574,-0.489505925,-0.921257583,168,88,80,0,0.15956022,0.312133481,0,-0.552335538,-0.069921847,0.069921847,0,0.312133481,0,0,1
5930,25,171,36,80,70,1,6432.154,24,1827.685,LESS,-456,3328,2872,4,2,-10,-0.937408461,10,0.174607574,0.280359226,-0.093651977,150,80,70,0,-0.199450275,0,-0.390166852,0.01416245,0.382208964,0.382208964,-0.390166852,0,1,0,1
5931,25,172,28,80,93,0,10040.522,10,1844.342,LESS,-1504,5874,4370,6,1,13,1.218630999,13,0.698430296,-0.797451985,0.841238466,173,80,93,1,0.259285357,0,0.507216907,1.147158426,-0.256380106,0.256380106,0.507216907,0,0,1,0
5932,25,173,21,82,80,0,2498.547,14,2327.613,LESS,-2274,2938,664,2,1,-2,-0.187481692,2,-1.222253018,-0.489505925,-1.112808447,162,82,80,0,0.039890055,0.07803337,0,-1.118833527,-0.725572457,0.725572457,0,0.07803337,1,0,0
5933,25,174,19,50,41,1,3623.451,34,1638.756,LESS,-202,1846,1644,3,2,-9,-0.843667615,9,0,1.050224376,-0.821357575,91,50,41,0,-1.376206896,-1.170500555,-1.521650721,-0.552335538,0.536981505,0.536981505,-1.521650721,-1.170500555,1,0,1
5934,25,175,56,96,110,0,3671.973,14,1126.954,LESS,-2808,3524,716,2,1,14,1.312371845,14,0.87303787,-0.489505925,-0.808786032,206,96,110,1,0.917471264,0.624266962,1.170500555,-1.118833527,-1.050960399,1.050960399,1.170500555,0.624266962,0,0,0
5935,25,176,23,80,85,1,11918.43,4,2308.041,LESS,416,5210,5626,5,1,5,0.46870423,5,-0.698430296,-1.259371076,1.327784806,165,80,85,1,0.099725137,0,0.195083426,0.580660438,0.913554067,0.913554067,0.195083426,0,0,1,1
5936,25,177,10,60,50,1,3124.596,34,1970.055,LESS,-84,1916,1832,4,1,-10,-0.937408461,10,0.174607574,1.050224376,-0.950605693,110,60,50,0,-0.997251374,-0.780333703,-1.170500555,0.01416245,0.60888371,0.60888371,-1.170500555,-0.780333703,1,1,1
5937,25,178,19,41,50,0,2185.444,54,1330.852,LESS,-1388,1950,562,2,1,9,0.843667615,9,0,2.589954678,-1.193930162,91,41,50,1,-1.376206896,-1.521650721,-1.170500555,-1.118833527,-0.185696583,0.185696583,-1.170500555,-1.521650721,1,0,1
5938,25,179,56,110,96,1,5332.1,34,1360.503,LESS,1082,1500,2582,2,2,-14,-1.312371845,14,0.87303787,1.050224376,-0.378664473,206,110,96,0,0.917471264,1.170500555,0.624266962,-1.118833527,1.319374984,1.319374984,0.624266962,1.170500555,1,0,1
5939,25,180,35,72,80,1,9531.317,14,1650.377,LESS,1200,3242,4442,4,1,8,0.749926769,8,-0.174607574,-0.489505925,0.709308772,152,72,80,1,-0.15956022,-0.312133481,0,0.01416245,1.391277188,1.391277188,0,-0.312133481,1,1,1
5940,25,181,11,49,50,1,7351.037,14,1533.54,LESS,-448,2912,2464,2,1,1,0.093740846,1,-1.396860592,-0.489505925,0.144421006,99,49,50,1,-1.216646676,-1.20951724,-1.170500555,-1.118833527,0.387083689,0.387083689,-1.170500555,-1.20951724,0,0,1
5941,25,182,17,43,50,0,11476.7,0,2171.316,LESS,-3496,6894,3398,3,1,7,0.656185922,7,-0.349215148,-1.567317136,1.213337179,93,43,50,1,-1.336316841,-1.443617351,-1.170500555,-0.552335538,-1.470186811,1.470186811,-1.170500555,-1.443617351,0,0,0
5942,25,183,1,51,50,1,7324.7,14,2688.127,LESS,-1336,4278,2942,4,2,-1,-0.093740846,1,-1.396860592,-0.489505925,0.137597365,101,51,50,0,-1.176756621,-1.131483869,-1.170500555,0.01416245,-0.154010866,0.154010866,-1.170500555,-1.131483869,0,1,1
5943,25,184,41,112,110,1,8582.713,0,3551.193,LESS,-1982,4960,2978,3,1,-2,-0.187481692,2,-1.222253018,-1.567317136,0.463535388,222,112,110,0,1.236591704,1.248533925,1.170500555,-0.552335538,-0.547644968,0.547644968,1.170500555,1.248533925,0,0,0
5944,25,185,20,40,50,0,1807.66,34,1610.1,LESS,-886,1334,448,2,1,10,0.937408461,10,0.174607574,1.050224376,-1.291810049,90,40,50,1,-1.396151924,-1.560667406,-1.170500555,-1.118833527,0.120192456,0.120192456,-1.170500555,-1.560667406,1,0,1
5945,25,186,1,50,51,1,7903.485,14,2070.411,LESS,-858,3778,2920,3,1,1,0.093740846,1,-1.396860592,-0.489505925,0.28755451,101,50,51,1,-1.176756621,-1.170500555,-1.131483869,-0.552335538,0.137253996,0.137253996,-1.131483869,-1.170500555,0,0,1
5946,25,187,23,85,80,1,9877.773,0,1234.477,LESS,1332,3940,5272,6,1,-5,-0.46870423,5,-0.698430296,-1.567317136,0.799071901,165,85,80,0,0.099725137,0.195083426,0,1.147158426,1.471710162,1.471710162,0,0.195083426,0,1,1
5947,25,188,11,50,49,0,6297.153,24,1388.408,LESS,192,2542,2734,2,1,-1,-0.093740846,1,-1.396860592,0.280359226,-0.128629326,99,50,49,0,-1.216646676,-1.170500555,-1.20951724,-1.118833527,0.777061747,0.777061747,-1.20951724,-1.170500555,1,0,1
5948,25,189,17,50,43,0,8252.668,4,2452.514,LESS,-1746,5074,3328,4,1,-7,-0.656185922,7,-0.349215148,-1.259371076,0.378024177,93,50,43,0,-1.336316841,-1.170500555,-1.443617351,0.01416245,-0.403840559,0.403840559,-1.443617351,-1.170500555,0,0,0
5949,25,190,21,80,82,0,6010.176,0,1742.5,LESS,-1534,3990,2456,6,1,2,0.187481692,2,-1.222253018,-1.567317136,-0.202982067,162,80,82,1,0.039890055,0,0.07803337,1.147158426,-0.274660327,0.274660327,0.07803337,0,0,1,0
5950,25,191,10,50,60,0,3384.727,14,2378.46,LESS,-1974,2936,962,4,1,10,0.937408461,10,0.174607574,-0.489505925,-0.883208469,110,50,60,1,-0.997251374,-1.170500555,-0.780333703,0.01416245,-0.542770242,0.542770242,-0.780333703,-1.170500555,1,0,0
5951,25,192,3,53,50,0,7329.265,0,1785.738,LESS,-2028,4910,2882,4,1,-3,-0.281222538,3,-1.047645444,-1.567317136,0.138780109,103,53,50,0,-1.136866566,-1.053450499,-1.170500555,0.01416245,-0.575674641,0.575674641,-1.170500555,-1.053450499,0,0,0
5952,25,193,45,122,110,1,7596.478,4,972.983,LESS,-2462,4574,2112,3,1,-12,-1.124890153,12,0.523822722,-1.259371076,0.208012205,232,122,110,0,1.436041979,1.638700776,1.170500555,-0.552335538,-0.840128511,0.840128511,1.170500555,1.638700776,0,0,0
5953,25,194,38,67,80,0,6557.638,4,1291.393,LESS,-624,3804,3180,4,1,13,1.218630999,13,0.698430296,-1.259371076,-0.061140384,147,67,80,1,-0.259285357,-0.507216907,0,0.01416245,0.279839723,0.279839723,0,-0.507216907,0,0,1
5954,25,195,38,80,67,0,9484.053,0,1698.083,LESS,1888,3826,5714,2,1,-13,-1.218630999,13,0.698430296,-1.567317136,0.697063163,147,80,67,0,-0.259285357,0,-0.507216907,-1.118833527,1.8105036,1.8105036,-0.507216907,0,0,0,1
5955,25,196,36,70,80,0,14925.51,0,1692.135,LESS,-1278,7584,6306,6,1,10,0.937408461,10,0.174607574,-1.567317136,2.106887811,150,70,80,1,-0.199450275,-0.390166852,0,1.147158426,-0.118669104,0.118669104,0,-0.390166852,0,1,1
5956,25,197,45,110,122,0,11435.305,0,2310.527,LESS,-3988,7582,3594,5,1,12,1.124890153,12,0.523822722,-1.567317136,1.202612167,232,110,122,1,1.436041979,1.170500555,1.638700776,0.580660438,-1.769982443,1.769982443,1.638700776,1.170500555,0,1,0
5957,25,198,42,110,115,0,8143.982,4,1774.34,LESS,-268,4470,4202,2,1,5,0.46870423,5,-0.698430296,-1.259371076,0.34986477,225,110,115,1,1.296426786,1.170500555,1.36558398,-1.118833527,0.496765018,0.496765018,1.36558398,1.170500555,0,0,1
5958,25,199,41,110,112,1,13629.316,4,1541.629,LESS,-2234,6912,4678,4,1,2,0.187481692,2,-1.222253018,-1.259371076,1.77105749,222,110,112,1,1.236591704,1.170500555,1.248533925,0.01416245,-0.701198828,0.701198828,1.248533925,1.170500555,0,0,0
5959,25,200,53,110,103,0,11410.918,4,2623.418,LESS,-3690,7290,3600,4,1,-7,-0.656185922,7,-0.349215148,-1.259371076,1.19629375,213,110,103,0,1.057086457,1.170500555,0.897383758,0.01416245,-1.588398909,1.588398909,0.897383758,1.170500555,0,0,0
5960,25,201,3,50,53,1,4797.221,24,1400.337,MORE,-1226,2854,1628,3,1,3,0.281222538,3,-1.047645444,0.280359226,-0.517246033,103,50,53,0,-1.136866566,-1.170500555,-1.053450499,-0.552335538,-0.086983387,0.086983387,-1.053450499,-1.170500555,0,0,0
5961,25,202,20,50,40,0,4452.768,34,1102.008,MORE,-1558,2998,1440,4,1,-10,-0.937408461,10,0.174607574,1.050224376,-0.606490206,90,50,40,1,-1.396151924,-1.170500555,-1.560667406,0.01416245,-0.289284505,0.289284505,-1.560667406,-1.170500555,1,1,0
5962,25,203,25,80,88,1,2917.58,24,1721.116,MORE,-1662,2686,1024,2,1,8,0.749926769,8,-0.174607574,0.280359226,-1.004241375,168,80,88,0,0.15956022,0,0.312133481,-1.118833527,-0.352655939,0.352655939,0.312133481,0,0,0,0
5963,25,204,42,115,110,0,7974.617,24,1297.596,MORE,-2626,4542,1916,2,1,-5,-0.46870423,5,-0.698430296,0.280359226,0.305984068,225,115,110,1,1.296426786,1.36558398,1.170500555,-1.118833527,-0.940060388,0.940060388,1.170500555,1.36558398,0,0,0
5964,25,205,53,103,110,1,6034.192,14,2830.419,MORE,1178,2358,3536,2,1,7,0.656185922,7,-0.349215148,-0.489505925,-0.196759773,213,103,110,0,1.057086457,0.897383758,1.170500555,-1.118833527,1.377871692,1.377871692,1.170500555,0.897383758,0,0,1
5965,25,206,26,90,80,0,4698.9,24,1758.559,MORE,-1108,2530,1422,4,1,-10,-0.937408461,10,0.174607574,0.280359226,-0.542719977,170,90,80,1,0.199450275,0.390166852,0,0.01416245,-0.015081183,0.015081183,0,0.390166852,0,1,0
5966,25,207,35,80,72,0,10533.239,34,1854.522,MORE,740,4296,5036,8,1,-8,-0.749926769,8,-0.174607574,1.050224376,0.968896292,152,80,72,1,-0.15956022,0,-0.312133481,2.280154402,1.110980459,1.110980459,-0.312133481,0,1,1,1
5967,25,208,28,93,80,0,5401.655,34,3020.769,MORE,-576,2726,2150,6,1,-13,-1.218630999,13,0.698430296,1.050224376,-0.3606435,173,93,80,1,0.259285357,0.507216907,0,1.147158426,0.309088078,0.309088078,0,0.507216907,1,1,1
5968,25,209,26,80,90,1,2049.338,44,2007.279,MORE,222,880,1102,3,2,10,0.937408461,10,0.174607574,1.820089527,-1.229193805,170,80,90,0,0.199450275,0,0.390166852,-0.552335538,0.795341969,0.795341969,0.390166852,0,1,0,1
5969,25,210,25,88,80,0,6868.522,4,2253.474,MORE,-3424,5308,1884,5,1,-8,-0.749926769,8,-0.174607574,-1.259371076,0.019406412,168,88,80,1,0.15956022,0.312133481,0,0.580660438,-1.426314279,1.426314279,0,0.312133481,0,1,0
5970,25,211,36,80,70,0,8182.444,14,2417.556,MORE,-2422,5482,3060,6,1,-10,-0.937408461,10,0.174607574,-0.489505925,0.359829872,150,80,70,1,-0.199450275,0,-0.390166852,1.147158426,-0.815754883,0.815754883,-0.390166852,0,0,1,0
5971,25,212,28,80,93,1,2063.279,24,1465.408,MORE,-828,1690,862,4,1,13,1.218630999,13,0.698430296,0.280359226,-1.225581837,173,80,93,0,0.259285357,0,0.507216907,0.01416245,0.155534218,0.155534218,0.507216907,0,0,1,0
5972,25,213,21,82,80,0,3914.681,34,1447.163,MORE,-1166,2436,1270,4,1,-2,-0.187481692,2,-1.222253018,1.050224376,-0.745902925,162,82,80,1,0.039890055,0.07803337,0,0.01416245,-0.050422944,0.050422944,0,0.07803337,1,1,0
5973,25,214,19,50,41,0,2949.97,4,2594.524,MORE,-1514,2498,984,4,1,-9,-0.843667615,9,0,-1.259371076,-0.995849464,91,50,41,1,-1.376206896,-1.170500555,-1.521650721,0.01416245,-0.262473513,0.262473513,-1.521650721,-1.170500555,0,1,0
5974,25,215,56,96,110,1,1976.353,24,1190.715,MORE,-12,1032,1020,2,1,14,1.312371845,14,0.87303787,0.280359226,-1.248103455,206,96,110,0,0.917471264,0.624266962,1.170500555,-1.118833527,0.652756241,0.652756241,1.170500555,0.624266962,1,0,1
5975,25,216,23,80,85,1,1498.183,14,2150.75,MORE,-1410,2396,986,2,1,5,0.46870423,5,-0.698430296,-0.489505925,-1.371992306,165,80,85,0,0.099725137,0,0.195083426,-1.118833527,-0.199102079,0.199102079,0.195083426,0,0,0,0
5976,25,217,10,60,50,0,4731.632,34,1369.319,MORE,-1058,2640,1582,4,1,-10,-0.937408461,10,0.174607574,1.050224376,-0.534239458,110,60,50,1,-0.997251374,-0.780333703,-1.170500555,0.01416245,0.015385853,0.015385853,-1.170500555,-0.780333703,1,1,0
5977,25,218,19,41,50,1,2406.173,24,1376.069,MORE,-54,1160,1106,3,2,9,0.843667615,9,0,0.280359226,-1.136741585,91,41,50,0,-1.376206896,-1.521650721,-1.170500555,-0.552335538,0.627163931,0.627163931,-1.170500555,-1.521650721,0,0,1
5978,25,219,56,110,96,0,3846.133,44,3448.913,MORE,-1000,2398,1398,2,1,-14,-1.312371845,14,0.87303787,1.820089527,-0.763662996,206,110,96,1,0.917471264,1.170500555,0.624266962,-1.118833527,0.050727615,0.050727615,0.624266962,1.170500555,1,0,0
5979,25,220,35,72,80,1,5041.701,44,1228.694,MORE,220,2270,2490,5,1,8,0.749926769,8,-0.174607574,1.820089527,-0.45390382,152,72,80,0,-0.15956022,-0.312133481,0,0.580660438,0.794123287,0.794123287,0,-0.312133481,1,1,1
5980,25,221,11,49,50,1,3976.439,14,955.235,MORE,-690,2182,1492,3,2,1,0.093740846,1,-1.396860592,-0.489505925,-0.729902073,99,49,50,0,-1.216646676,-1.20951724,-1.170500555,-0.552335538,0.239623236,0.239623236,-1.170500555,-1.20951724,0,0,0
5981,25,222,17,43,50,1,6041.11,4,1143.798,MORE,-3308,4754,1446,5,1,7,0.656185922,7,-0.349215148,-1.259371076,-0.194967391,93,43,50,0,-1.336316841,-1.443617351,-1.170500555,0.580660438,-1.355630756,1.355630756,-1.170500555,-1.443617351,0,1,0
5982,25,223,1,51,50,1,10959.667,0,1288.284,MORE,-2564,6536,3972,7,1,-1,-0.093740846,1,-1.396860592,-1.567317136,1.079379331,101,51,50,1,-1.176756621,-1.131483869,-1.170500555,1.713656414,-0.902281264,0.902281264,-1.170500555,-1.131483869,0,1,0
5983,25,224,41,112,110,0,2929.594,34,1071.999,MORE,-1418,2248,830,2,1,-2,-0.187481692,2,-1.222253018,1.050224376,-1.001128673,222,112,110,1,1.236591704,1.248533925,1.170500555,-1.118833527,-0.203976804,0.203976804,1.170500555,1.248533925,1,0,0
5984,25,225,20,40,50,1,1842.801,14,1284.839,MORE,-608,1532,924,1,1,10,0.937408461,10,0.174607574,-0.489505925,-1.282705383,90,40,50,0,-1.396151924,-1.560667406,-1.170500555,-1.685331515,0.289589175,0.289589175,-1.170500555,-1.560667406,0,0,1
5985,25,226,1,50,51,0,9067.473,34,1473.257,MORE,1028,3528,4556,5,1,1,0.093740846,1,-1.396860592,1.050224376,0.589131638,101,50,51,0,-1.176756621,-1.170500555,-1.131483869,0.580660438,1.286470585,1.286470585,-1.131483869,-1.170500555,1,1,1
5986,25,227,23,85,80,0,9167.467,44,1522.638,MORE,578,3772,4350,6,1,-5,-0.46870423,5,-0.698430296,1.820089527,0.615039039,165,85,80,1,0.099725137,0.195083426,0,1.147158426,1.012267263,1.012267263,0,0.195083426,1,1,1
5987,25,228,11,50,49,0,12136.964,4,959.934,MORE,-514,5978,5464,6,1,-1,-0.093740846,1,-1.396860592,-1.259371076,1.384404682,99,50,49,1,-1.216646676,-1.170500555,-1.20951724,1.147158426,0.346867202,0.346867202,-1.20951724,-1.170500555,0,1,1
5988,25,229,17,50,43,1,2698.169,24,808.255,MORE,100,1274,1374,1,2,-7,-0.656185922,7,-0.349215148,0.280359226,-1.061088472,93,50,43,1,-1.336316841,-1.170500555,-1.443617351,-1.685331515,0.721002401,0.721002401,-1.443617351,-1.170500555,0,0,1
5989,25,230,21,80,82,1,4628.875,34,917.993,MORE,92,2188,2280,3,2,2,0.187481692,2,-1.222253018,1.050224376,-0.560862723,162,80,82,0,0.039890055,0,0.07803337,-0.552335538,0.716127676,0.716127676,0.07803337,0,1,0,1
5990,25,231,10,50,60,1,3754.417,4,2527.058,MORE,-1204,3090,1886,3,1,10,0.937408461,10,0.174607574,-1.259371076,-0.787425653,110,50,60,0,-0.997251374,-1.170500555,-0.780333703,-0.552335538,-0.073577891,0.073577891,-0.780333703,-1.170500555,0,0,0
5991,25,232,3,53,50,0,4177.62,24,1047.933,MORE,-1788,2882,1094,4,1,-3,-0.281222538,3,-1.047645444,0.280359226,-0.677778178,103,53,50,1,-1.136866566,-1.053450499,-1.170500555,0.01416245,-0.429432869,0.429432869,-1.170500555,-1.053450499,0,1,0
5992,25,233,45,122,110,0,3395.043,44,1948.428,MORE,-350,1824,1474,2,1,-12,-1.124890153,12,0.523822722,1.820089527,-0.880535701,232,122,110,1,1.436041979,1.638700776,1.170500555,-1.118833527,0.446799079,0.446799079,1.170500555,1.638700776,1,0,1
5993,25,234,38,67,80,1,4928.446,14,1218.23,MORE,364,2240,2604,3,1,13,1.218630999,13,0.698430296,-0.489505925,-0.483247007,147,67,80,0,-0.259285357,-0.507216907,0,-0.552335538,0.88186835,0.88186835,0,-0.507216907,0,0,1
5994,25,235,38,80,67,0,2868.349,44,1196.653,MORE,-1094,1902,808,2,1,-13,-1.218630999,13,0.698430296,1.820089527,-1.016996613,147,80,67,1,-0.259285357,0,-0.507216907,-1.118833527,-0.006550413,0.006550413,-0.507216907,0,1,0,0
5995,25,236,36,70,80,1,9406.728,24,2230.634,MORE,-578,4436,3858,4,1,10,0.937408461,10,0.174607574,0.280359226,0.677029064,150,70,80,0,-0.199450275,-0.390166852,0,0.01416245,0.307869396,0.307869396,0,-0.390166852,0,1,1
5996,25,237,45,110,122,0,7354.094,4,1660.745,MORE,-364,4150,3786,4,1,12,1.124890153,12,0.523822722,-1.259371076,0.145213043,232,110,122,0,1.436041979,1.170500555,1.638700776,0.01416245,0.438268309,0.438268309,1.638700776,1.170500555,0,1,1
5997,25,238,42,110,115,1,7369.732,34,1733.737,MORE,-910,3748,2838,5,2,5,0.46870423,5,-0.698430296,1.050224376,0.149264685,225,110,115,0,1.296426786,1.170500555,1.36558398,0.580660438,0.105568279,0.105568279,1.36558398,1.170500555,1,1,0
5998,25,239,41,110,112,1,4304.453,34,1504.214,MORE,-24,2168,2144,3,1,2,0.187481692,2,-1.222253018,1.050224376,-0.644917073,222,110,112,0,1.236591704,1.170500555,1.248533925,-0.552335538,0.645444153,0.645444153,1.248533925,1.170500555,1,0,1
5999,25,240,53,110,103,0,3459.006,44,1596.291,MORE,-1486,2580,1094,2,1,-7,-0.656185922,7,-0.349215148,1.820089527,-0.863963556,213,110,103,1,1.057086457,1.170500555,0.897383758,-1.118833527,-0.245411973,0.245411973,0.897383758,1.170500555,1,0,0
6000,26,1,49,110,131,1,3954.36,50,1478.248,MORE,316,1516,1832,2,2,21,1.968557767,21,2.095290887,-0.071731354,0.038478081,241,110,131,0,1.615547226,1.170500555,1.989850943,-0.827644453,0.332385507,0.332385507,1.989850943,1.170500555,0,0,1
6001,26,2,13,47,50,1,3430.104,40,1201.641,MORE,38,1610,1648,3,1,3,0.281222538,3,-1.047645444,-0.472092397,-0.243520966,97,47,50,0,-1.256536731,-1.28755061,-1.170500555,0.118234922,0.071905333,0.071905333,-1.170500555,-1.28755061,0,0,0
6002,26,3,16,50,44,0,4790.332,0,925.194,MORE,-600,2832,2232,4,1,-6,-0.562445076,6,-0.523822722,-2.073536573,0.4881502,94,50,44,1,-1.316371814,-1.170500555,-1.404600665,1.064114296,-0.525887295,0.525887295,-1.404600665,-1.170500555,0,1,0
6003,26,4,7,57,50,0,2293.717,70,990.236,MORE,-662,1424,762,2,1,-7,-0.656185922,7,-0.349215148,0.728990734,-0.854787313,107,57,50,1,-1.057086457,-0.897383758,-1.170500555,-0.827644453,-0.583979996,0.583979996,-1.170500555,-0.897383758,1,0,0
6004,26,5,18,42,50,1,1600.204,40,1085.661,MORE,474,636,1110,1,2,8,0.749926769,8,-0.174607574,-0.472092397,-1.227830262,92,42,50,0,-1.356261869,-1.482634036,-1.170500555,-1.773523827,0.480428196,0.480428196,-1.170500555,-1.482634036,0,0,1
6005,26,6,51,108,110,1,3382.276,60,1567.66,MORE,1482,1014,2496,2,2,2,0.187481692,2,-1.222253018,0.32862969,-0.269247806,218,108,110,0,1.156811594,1.092467184,1.170500555,-0.827644453,1.42490307,1.42490307,1.170500555,1.092467184,1,0,1
6006,26,7,31,78,80,0,5924.823,60,1836.241,MORE,-20,2602,2582,5,2,2,0.187481692,2,-1.222253018,0.32862969,1.098396683,158,78,80,0,-0.039890055,-0.07803337,0,2.009993671,0.017560549,0.017560549,0,-0.07803337,1,1,0
6007,26,8,58,110,92,1,3778.703,20,1899.364,MORE,62,1654,1716,3,2,-18,-1.687335229,18,1.571468165,-1.272814485,-0.056008404,202,110,92,1,0.837691154,1.170500555,0.468200222,0.118234922,0.09439283,0.09439283,0.468200222,1.170500555,0,0,0
6008,26,9,12,50,48,0,5725.532,30,2061.277,MORE,-1882,3660,1778,4,1,-2,-0.187481692,2,-1.222253018,-0.872453441,0.991197391,98,50,48,1,-1.236591704,-1.170500555,-1.248533925,1.064114296,-1.727094427,1.727094427,-1.248533925,-1.170500555,0,1,0
6009,26,10,54,110,101,1,5110.158,70,2431.172,MORE,776,1892,2668,4,2,-9,-0.843667615,9,0,0.728990734,0.660185669,211,110,101,1,1.017196402,1.170500555,0.819350388,1.064114296,0.763395866,0.763395866,0.819350388,1.170500555,1,1,1
6010,26,11,14,46,50,1,2845.064,90,2266.151,MORE,1384,1072,2456,3,2,4,0.374963384,4,-0.87303787,1.529712821,-0.558215927,96,46,50,0,-1.276481759,-1.326567295,-1.170500555,0.118234922,1.333079124,1.333079124,-1.170500555,-1.326567295,1,0,1
6011,26,12,22,80,83,0,4896.907,50,1754.362,MORE,-1436,3174,1738,4,1,3,0.281222538,3,-1.047645444,-0.071731354,0.545477247,163,80,83,0,0.059835082,0,0.117050055,1.064114296,-1.309201774,1.309201774,0.117050055,0,0,1,0
6012,26,13,6,50,56,1,3161.734,60,1018.496,MORE,478,1154,1632,3,2,6,0.562445076,6,-0.523822722,0.32862969,-0.387878081,106,50,56,0,-1.077031484,-1.170500555,-0.936400444,0.118234922,0.484176112,0.484176112,-0.936400444,-1.170500555,1,0,1
6013,26,14,13,50,47,1,4104.913,70,951.241,MORE,-34,1896,1862,3,2,-3,-0.281222538,3,-1.047645444,0.728990734,0.11946104,97,50,47,1,-1.256536731,-1.170500555,-1.28755061,0.118234922,0.004442842,0.004442842,-1.28755061,-1.170500555,1,1,0
6014,26,15,46,110,124,1,3033.454,50,1274.325,MORE,682,1018,1700,3,2,14,1.312371845,14,0.87303787,-0.071731354,-0.45688032,234,110,124,0,1.475932034,1.170500555,1.716734147,0.118234922,0.675319836,0.675319836,1.716734147,1.170500555,0,1,1
6015,26,16,27,91,80,0,3098.95,50,1123.656,MORE,-584,1652,1068,2,1,-11,-1.031149307,11,0.349215148,-0.071731354,-0.421649804,171,91,80,1,0.219395302,0.429183537,0,-0.827644453,-0.510895631,0.510895631,0,0.429183537,0,0,0
6016,26,17,40,64,80,1,3006.867,70,1797.835,MORE,898,1102,2000,3,2,16,1.499853537,16,1.222253018,0.728990734,-0.471181556,144,64,80,0,-0.31912044,-0.624266962,0,0.118234922,0.877707309,0.877707309,0,-0.624266962,1,1,1
6017,26,18,22,83,80,1,2611.25,60,1090.873,MORE,-126,1012,886,1,2,-3,-0.281222538,3,-1.047645444,0.32862969,-0.683985256,163,83,80,1,0.059835082,0.117050055,0,-1.773523827,-0.08175923,0.08175923,0,0.117050055,1,0,0
6018,26,19,54,101,110,0,5021.21,60,1014.321,MORE,-90,2144,2054,4,1,9,0.843667615,9,0,0.32862969,0.612340244,211,101,110,0,1.017196402,0.819350388,1.170500555,1.064114296,-0.048027984,0.048027984,1.170500555,0.819350388,1,1,0
6019,26,20,6,56,50,0,5364.197,70,1821.563,MORE,270,2404,2674,4,1,-6,-0.562445076,6,-0.523822722,0.728990734,0.796834092,106,56,50,1,-1.077031484,-0.936400444,-1.170500555,1.064114296,0.289284471,0.289284471,-1.170500555,-0.936400444,1,1,1
6020,26,21,18,50,42,0,15268.943,60,1117.601,MORE,-8534,10476,1942,2,1,-8,-0.749926769,8,-0.174607574,0.32862969,6.124629911,92,50,42,1,-1.356261869,-1.170500555,-1.482634036,-0.827644453,-7.959879013,7.959879013,-1.482634036,-1.170500555,1,0,0
6021,26,22,43,110,117,0,3485.132,0,2106.605,MORE,-832,2156,1324,2,1,7,0.656185922,7,-0.349215148,-2.073536573,-0.213921221,227,110,117,0,1.336316841,1.170500555,1.443617351,-0.827644453,-0.743266433,0.743266433,1.443617351,1.170500555,0,0,0
6022,26,23,32,77,80,0,7177.329,50,1513.503,MORE,-1516,4280,2764,4,1,3,0.281222538,3,-1.047645444,-0.071731354,1.772123826,157,77,80,0,-0.059835082,-0.117050055,0,1.064114296,-1.384160098,1.384160098,0,-0.117050055,0,1,0
6023,26,24,27,80,91,1,3908.625,50,1569.461,MORE,-458,2008,1550,3,1,11,1.031149307,11,0.349215148,-0.071731354,0.013877072,171,80,91,0,0.219395302,0,0.429183537,0.118234922,-0.392836271,0.392836271,0.429183537,0,0,1,0
6024,26,25,16,44,50,1,2896.952,100,1230.408,MORE,1088,978,2066,2,2,6,0.562445076,6,-0.523822722,1.930073865,-0.5303052,94,44,50,0,-1.316371814,-1.404600665,-1.170500555,-0.827644453,1.055733327,1.055733327,-1.170500555,-1.404600665,1,0,1
6025,26,26,7,50,57,0,7720.648,40,1249.017,MORE,470,2616,3086,4,1,7,0.656185922,7,-0.349215148,-0.472092397,2.064376923,107,50,57,0,-1.057086457,-1.170500555,-0.897383758,1.064114296,0.476680279,0.476680279,-0.897383758,-1.170500555,0,1,1
6026,26,27,14,50,46,0,2694.369,50,1407.612,MORE,-1072,1930,858,2,1,-4,-0.374963384,4,-0.87303787,-0.071731354,-0.639275269,96,50,46,1,-1.276481759,-1.170500555,-1.326567295,-0.827644453,-0.968141403,0.968141403,-1.326567295,-1.170500555,0,0,0
6027,26,28,51,110,108,1,5572.055,40,893.743,MORE,1936,1370,3306,2,2,-2,-0.187481692,2,-1.222253018,-0.472092397,0.908641602,218,110,108,1,1.156811594,1.170500555,1.092467184,-0.827644453,1.850291555,1.850291555,1.092467184,1.170500555,0,0,1
6028,26,29,50,133,110,0,10583.331,70,1380.3,MORE,-574,5078,4504,3,1,-23,-2.15603946,23,2.444506035,0.728990734,3.604223631,243,133,110,1,1.655437281,2.067884313,1.170500555,0.118234922,-0.50152584,0.50152584,1.170500555,2.067884313,1,0,0
6029,26,30,49,131,110,0,9587.822,90,3052.149,MORE,462,4472,4934,4,2,-21,-1.968557767,21,2.095290887,1.529712821,3.068736029,241,131,110,1,1.615547226,1.989850943,1.170500555,1.064114296,0.469184447,0.469184447,1.170500555,1.989850943,1,1,1
6030,26,31,47,126,110,0,3651.797,50,1587.11,MORE,-918,1790,872,2,1,-16,-1.499853537,16,1.222253018,-0.071731354,-0.124271563,236,126,110,1,1.515822089,1.794767517,1.170500555,-0.827644453,-0.823846631,0.823846631,1.170500555,1.794767517,0,0,0
6031,26,32,50,110,133,1,4992.643,60,1218.723,MORE,-52,2038,1986,2,2,23,2.15603946,23,2.444506035,0.32862969,0.59697396,243,110,133,0,1.655437281,1.170500555,2.067884313,-0.827644453,-0.01242278,0.01242278,2.067884313,1.170500555,1,0,0
6032,26,33,47,110,126,0,4595.107,60,1190.033,MORE,310,2104,2414,2,1,16,1.499853537,16,1.222253018,0.32862969,0.383138023,236,110,126,0,1.515822089,1.170500555,1.794767517,-0.827644453,0.326763633,0.326763633,1.794767517,1.170500555,1,0,1
6033,26,34,12,48,50,1,4694.762,70,1092.213,MORE,1354,1680,3034,3,2,2,0.187481692,2,-1.222253018,0.728990734,0.436742779,98,48,50,0,-1.236591704,-1.248533925,-1.170500555,0.118234922,1.304969752,1.304969752,-1.170500555,-1.248533925,1,1,1
6034,26,35,32,80,77,1,7557.36,50,1609.441,MORE,502,2818,3320,5,2,-3,-0.281222538,3,-1.047645444,-0.071731354,1.976543765,157,80,77,1,-0.059835082,0,-0.117050055,2.009993671,0.506663609,0.506663609,-0.117050055,0,0,1,1
6035,26,36,43,117,110,0,2468.382,60,1163.309,MORE,-396,1634,1238,3,2,-7,-0.656185922,7,-0.349215148,0.32862969,-0.760834428,227,117,110,1,1.336316841,1.443617351,1.170500555,0.118234922,-0.334743571,0.334743571,1.170500555,1.443617351,1,1,0
6036,26,37,40,80,64,0,3474.492,20,1643.623,MORE,-1284,2238,954,1,1,-16,-1.499853537,16,1.222253018,-1.272814485,-0.219644513,144,80,64,1,-0.31912044,0,-0.624266962,-1.773523827,-1.16678096,1.16678096,-0.624266962,0,0,0,0
6037,26,38,31,80,78,0,2846.675,70,1303.329,MORE,-986,1882,896,2,1,-2,-0.187481692,2,-1.222253018,0.728990734,-0.557349365,158,80,78,1,-0.039890055,0,-0.07803337,-0.827644453,-0.887561205,0.887561205,-0.07803337,0,1,0,0
6038,26,39,46,124,110,0,2255.533,40,1117.065,MORE,-862,1660,798,2,1,-14,-1.312371845,14,0.87303787,-0.472092397,-0.875326613,234,124,110,1,1.475932034,1.716734147,1.170500555,-0.827644453,-0.771375804,0.771375804,1.170500555,1.716734147,0,0,0
6039,26,40,58,92,110,0,3640.418,60,1172.529,MORE,-766,2026,1260,1,1,18,1.687335229,18,1.571468165,0.32862969,-0.130392365,202,92,110,0,0.837691154,0.468200222,1.170500555,-1.773523827,-0.681425816,0.681425816,1.170500555,0.468200222,1,0,0
6040,26,41,49,110,131,0,2493.757,80,2022.452,LESS,-588,1476,888,2,2,21,1.968557767,21,2.095290887,1.129351778,-0.747185131,241,110,131,1,1.615547226,1.170500555,1.989850943,-0.827644453,-0.514643547,0.514643547,1.989850943,1.170500555,1,0,0
6041,26,42,13,47,50,0,2694.086,60,866.424,LESS,-490,1466,976,2,1,3,0.281222538,3,-1.047645444,0.32862969,-0.639427496,97,47,50,1,-1.256536731,-1.28755061,-1.170500555,-0.827644453,-0.422819601,0.422819601,-1.170500555,-1.28755061,1,0,0
6042,26,43,16,50,44,1,3082.664,50,1063.218,LESS,48,1462,1510,3,2,-6,-0.562445076,6,-0.523822722,-0.071731354,-0.430410097,94,50,44,0,-1.316371814,-1.170500555,-1.404600665,0.118234922,0.081275124,0.081275124,-1.404600665,-1.170500555,0,1,1
6043,26,44,7,57,50,0,2189.881,0,1932.297,LESS,-688,1556,868,2,1,-7,-0.656185922,7,-0.349215148,-2.073536573,-0.910641042,107,57,50,0,-1.057086457,-0.897383758,-1.170500555,-0.827644453,-0.608341451,0.608341451,-1.170500555,-0.897383758,0,0,0
6044,26,45,18,42,50,0,2006.645,60,1041.604,LESS,-382,1134,752,2,1,8,0.749926769,8,-0.174607574,0.32862969,-1.009204296,92,42,50,1,-1.356261869,-1.482634036,-1.170500555,-0.827644453,-0.321625864,0.321625864,-1.170500555,-1.482634036,1,0,0
6045,26,46,51,108,110,0,2061.51,40,1497.221,LESS,-504,1238,734,2,1,2,0.187481692,2,-1.222253018,-0.472092397,-0.97969223,218,108,110,1,1.156811594,1.092467184,1.170500555,-0.827644453,-0.435937307,0.435937307,1.170500555,1.092467184,0,0,0
6046,26,47,31,78,80,1,3270.151,0,1807.722,LESS,-516,2524,2008,3,1,2,0.187481692,2,-1.222253018,-2.073536573,-0.329560216,158,78,80,1,-0.039890055,-0.07803337,0,0.118234922,-0.447181056,0.447181056,0,-0.07803337,0,1,0
6047,26,48,58,110,92,1,2749.182,10,1301.301,LESS,176,1316,1492,3,1,-18,-1.687335229,18,1.571468165,-1.673175529,-0.609791174,202,110,92,0,0.837691154,1.170500555,0.468200222,0.118234922,0.201208441,0.201208441,0.468200222,1.170500555,0,1,1
6048,26,49,12,50,48,0,1961.831,80,1504.866,LESS,68,1002,1070,2,2,-2,-0.187481692,2,-1.222253018,1.129351778,-1.033309896,98,50,48,0,-1.236591704,-1.170500555,-1.248533925,-0.827644453,0.100014705,0.100014705,-1.248533925,-1.170500555,1,0,1
6049,26,50,54,110,101,1,2567.314,40,1336.588,LESS,348,1292,1640,4,1,-9,-0.843667615,9,0,-0.472092397,-0.707618576,211,110,101,0,1.017196402,1.170500555,0.819350388,1.064114296,0.362368836,0.362368836,0.819350388,1.170500555,0,1,1
6050,26,51,14,46,50,0,2440.868,10,1342.604,LESS,-728,1694,966,2,1,4,0.374963384,4,-0.87303787,-1.673175529,-0.7756343,96,46,50,1,-1.276481759,-1.326567295,-1.170500555,-0.827644453,-0.645820613,0.645820613,-1.170500555,-1.326567295,0,0,0
6051,26,52,22,80,83,0,2501.371,70,1120.348,LESS,-680,1570,890,2,2,3,0.281222538,3,-1.047645444,0.728990734,-0.743089535,163,80,83,1,0.059835082,0,0.117050055,-0.827644453,-0.600845619,0.600845619,0.117050055,0,1,0,0
6052,26,53,6,50,56,0,2034.693,70,1333.583,LESS,524,1096,1620,2,2,6,0.562445076,6,-0.523822722,0.728990734,-0.994117184,106,50,56,1,-1.077031484,-1.170500555,-0.936400444,-0.827644453,0.527277148,0.527277148,-0.936400444,-1.170500555,1,0,1
6053,26,54,13,50,47,0,2186.896,40,1446.418,LESS,-284,1170,886,2,1,-3,-0.281222538,3,-1.047645444,-0.472092397,-0.912246684,97,50,47,0,-1.256536731,-1.170500555,-1.28755061,-0.827644453,-0.229801918,0.229801918,-1.28755061,-1.170500555,0,0,0
6054,26,55,46,110,124,0,3497.84,50,1861.231,LESS,-274,1808,1534,1,1,14,1.312371845,14,0.87303787,-0.071731354,-0.207085546,234,110,124,1,1.475932034,1.170500555,1.716734147,-1.773523827,-0.220432128,0.220432128,1.716734147,1.170500555,0,0,0
6055,26,56,27,91,80,0,4301.24,30,1319.106,LESS,76,2080,2156,3,1,-11,-1.031149307,11,0.349215148,-0.872453441,0.225065986,171,91,80,0,0.219395302,0.429183537,0,0.118234922,0.107510537,0.107510537,0,0.429183537,0,1,1
6056,26,57,40,64,80,0,2002.954,80,1883.718,LESS,442,1220,1662,2,2,16,1.499853537,16,1.222253018,1.129351778,-1.011189698,144,64,80,1,-0.31912044,-0.624266962,0,-0.827644453,0.450444866,0.450444866,0,-0.624266962,1,0,1
6057,26,58,22,83,80,1,4178.732,60,1509.806,LESS,838,1678,2516,3,2,-3,-0.281222538,3,-1.047645444,0.32862969,0.159168526,163,83,80,0,0.059835082,0.117050055,0,0.118234922,0.821488567,0.821488567,0,0.117050055,1,1,1
6058,26,59,54,101,110,0,2498.799,40,1285.335,LESS,-658,1466,808,2,1,9,0.843667615,9,0,-0.472092397,-0.744473023,211,101,110,1,1.017196402,0.819350388,1.170500555,-0.827644453,-0.58023208,0.58023208,1.170500555,0.819350388,0,0,0
6059,26,60,6,56,50,0,4576.566,50,1409.133,LESS,-286,2234,1948,4,1,-6,-0.562445076,6,-0.523822722,-0.071731354,0.373164758,106,56,50,0,-1.077031484,-0.936400444,-1.170500555,1.064114296,-0.231675876,0.231675876,-1.170500555,-0.936400444,1,1,0
6060,26,61,18,50,42,1,3470.541,50,1208.667,LESS,502,1326,1828,3,2,-8,-0.749926769,8,-0.174607574,-0.071731354,-0.221769769,92,50,42,0,-1.356261869,-1.170500555,-1.482634036,0.118234922,0.506663609,0.506663609,-1.482634036,-1.170500555,1,1,1
6061,26,62,43,110,117,1,3723.311,60,1150.079,LESS,1374,1078,2452,3,2,7,0.656185922,7,-0.349215148,0.32862969,-0.085803945,227,110,117,1,1.336316841,1.170500555,1.443617351,0.118234922,1.323709333,1.323709333,1.443617351,1.170500555,1,1,1
6062,26,63,32,77,80,1,3684.998,30,1175.747,LESS,180,1614,1794,3,2,3,0.281222538,3,-1.047645444,-0.872453441,-0.106412635,157,77,80,1,-0.059835082,-0.117050055,0,0.118234922,0.204956357,0.204956357,0,-0.117050055,0,1,1
6063,26,64,27,80,91,1,4086.338,60,1037.062,LESS,518,1432,1950,3,2,11,1.031149307,11,0.349215148,0.32862969,0.109469486,171,80,91,1,0.219395302,0,0.429183537,0.118234922,0.521655273,0.521655273,0.429183537,0,1,1,1
6064,26,65,16,44,50,1,5223.016,40,791.042,LESS,708,2002,2710,3,2,6,0.562445076,6,-0.523822722,-0.472092397,0.720892363,94,44,50,1,-1.316371814,-1.404600665,-1.170500555,0.118234922,0.699681291,0.699681291,-1.170500555,-1.404600665,0,1,1
6065,26,66,7,50,57,1,4457.953,10,2392.258,LESS,-958,3192,2234,3,1,7,0.656185922,7,-0.349215148,-1.673175529,0.30936243,107,50,57,1,-1.057086457,-1.170500555,-0.897383758,0.118234922,-0.861325792,0.861325792,-0.897383758,-1.170500555,0,1,0
6066,26,67,14,50,46,0,7896.099,20,1630.267,LESS,822,3138,3960,4,1,-4,-0.374963384,4,-0.87303787,-1.272814485,2.1587526,96,50,46,0,-1.276481759,-1.170500555,-1.326567295,1.064114296,0.806496902,0.806496902,-1.326567295,-1.170500555,0,1,1
6067,26,68,51,110,108,1,5371.976,40,1621.485,LESS,530,2248,2778,3,1,-2,-0.187481692,2,-1.222253018,-0.472092397,0.801018442,218,110,108,0,1.156811594,1.170500555,1.092467184,0.118234922,0.532899022,0.532899022,1.092467184,1.170500555,0,1,1
6068,26,69,50,133,110,1,4946.858,50,1613.074,LESS,1832,1106,2938,2,2,-23,-2.15603946,23,2.444506035,-0.071731354,0.572346056,243,133,110,0,1.655437281,2.067884313,1.170500555,-0.827644453,1.752845734,1.752845734,1.170500555,2.067884313,1,0,1
6069,26,70,49,131,110,1,3588.377,70,1261.025,LESS,834,1502,2336,3,2,-21,-1.968557767,21,2.095290887,0.728990734,-0.158385392,241,131,110,0,1.615547226,1.989850943,1.170500555,0.118234922,0.817740651,0.817740651,1.170500555,1.989850943,1,1,1
6070,26,71,47,126,110,0,3142.813,50,1348,LESS,-262,1646,1384,2,1,-16,-1.499853537,16,1.222253018,-0.071731354,-0.39805575,236,126,110,0,1.515822089,1.794767517,1.170500555,-0.827644453,-0.209188379,0.209188379,1.170500555,1.794767517,1,0,1
6071,26,72,50,110,133,0,4487.395,30,1692.601,LESS,-1164,2796,1632,2,1,23,2.15603946,23,2.444506035,-0.872453441,0.32519938,243,110,133,1,1.655437281,1.170500555,2.067884313,-0.827644453,-1.054343475,1.054343475,2.067884313,1.170500555,0,0,0
6072,26,73,47,110,126,0,2063.181,80,1477.402,LESS,412,966,1378,2,2,16,1.499853537,16,1.222253018,1.129351778,-0.978793394,236,110,126,1,1.515822089,1.170500555,1.794767517,-0.827644453,0.422335495,0.422335495,1.794767517,1.170500555,1,0,1
6073,26,74,12,48,50,0,2060.215,90,2060.994,LESS,678,1108,1786,1,2,2,0.187481692,2,-1.222253018,1.529712821,-0.980388815,98,48,50,1,-1.236591704,-1.248533925,-1.170500555,-1.773523827,0.67157192,0.67157192,-1.170500555,-1.248533925,1,0,1
6074,26,75,32,80,77,0,2384.944,100,1660.481,LESS,900,1200,2100,2,2,-3,-0.281222538,3,-1.047645444,1.930073865,-0.805716006,157,80,77,0,-0.059835082,0,-0.117050055,-0.827644453,0.879581267,0.879581267,-0.117050055,0,1,0,1
6075,26,76,43,117,110,1,2822.85,70,988.937,LESS,806,1074,1880,3,2,-7,-0.656185922,7,-0.349215148,0.728990734,-0.570164912,227,117,110,0,1.336316841,1.443617351,1.170500555,0.118234922,0.791505237,0.791505237,1.170500555,1.443617351,1,1,1
6076,26,77,40,80,64,0,2110.343,80,1401.195,LESS,562,974,1536,2,2,-16,-1.499853537,16,1.222253018,1.129351778,-0.953424797,144,80,64,0,-0.31912044,0,-0.624266962,-0.827644453,0.562882351,0.562882351,-0.624266962,0,1,0,1
6077,26,78,31,80,78,0,2032.518,60,1920.414,LESS,-94,908,814,2,1,-2,-0.187481692,2,-1.222253018,0.32862969,-0.995287124,158,80,78,0,-0.039890055,0,-0.07803337,-0.827644453,-0.0517759,0.0517759,-0.07803337,0,1,0,1
6078,26,79,46,124,110,0,4916.421,40,1365.603,LESS,-520,2662,2142,4,1,-14,-1.312371845,14,0.87303787,-0.472092397,0.555973893,234,124,110,0,1.475932034,1.716734147,1.170500555,1.064114296,-0.450928972,0.450928972,1.170500555,1.716734147,0,1,0
6079,26,80,58,92,110,0,3463.87,30,1676.758,LESS,-542,1970,1428,2,1,18,1.687335229,18,1.571468165,-0.872453441,-0.225358122,202,92,110,1,0.837691154,0.468200222,1.170500555,-0.827644453,-0.471542511,0.471542511,1.170500555,0.468200222,0,0,0
6080,26,81,48,128,110,0,6962.221,80,1780.233,MORE,-426,3066,2640,3,2,-18,-1.687335229,18,1.571468165,1.129351778,1.656416517,238,128,110,1,1.555712144,1.872800887,1.170500555,0.118234922,-0.362852942,0.362852942,1.170500555,1.872800887,1,1,0
6081,26,82,8,50,58,1,3006.345,100,2588.931,MORE,1554,1290,2844,3,2,8,0.749926769,8,-0.174607574,1.930073865,-0.471462341,108,50,58,0,-1.037141429,-1.170500555,-0.858367073,0.118234922,1.492365561,1.492365561,-0.858367073,-1.170500555,1,1,1
6082,26,83,4,54,50,1,4687.366,70,961.486,MORE,668,2200,2868,3,2,-4,-0.374963384,4,-0.87303787,0.728990734,0.432764446,104,54,50,1,-1.116921539,-1.014433814,-1.170500555,0.118234922,0.66220213,0.66220213,-1.170500555,-1.014433814,1,1,1
6083,26,84,37,80,69,0,2758.795,50,1147.372,MORE,232,1196,1428,4,1,-11,-1.031149307,11,0.349215148,-0.071731354,-0.60462031,149,80,69,1,-0.219395302,0,-0.429183537,1.064114296,0.253679267,0.253679267,-0.429183537,0,0,1,1
6084,26,85,52,105,110,1,2739.147,80,1874.052,MORE,890,1190,2080,3,2,5,0.46870423,5,-0.698430296,1.129351778,-0.615189034,215,105,110,0,1.096976512,0.975417129,1.170500555,0.118234922,0.870211477,0.870211477,1.170500555,0.975417129,1,1,1
6085,26,86,5,55,50,0,3927.039,50,1124.224,MORE,-360,1928,1568,4,1,-5,-0.46870423,5,-0.698430296,-0.071731354,0.023782024,105,55,50,1,-1.096976512,-0.975417129,-1.170500555,1.064114296,-0.301012325,0.301012325,-1.170500555,-0.975417129,0,1,0
6086,26,87,30,96,80,0,4294.75,30,3094.475,MORE,-366,2068,1702,5,1,-16,-1.499853537,16,1.222253018,-0.872453441,0.221574994,176,96,80,1,0.31912044,0.624266962,0,2.009993671,-0.3066342,0.3066342,0,0.624266962,0,1,0
6087,26,88,33,80,75,1,2454.979,90,1177.911,MORE,820,894,1714,3,2,-5,-0.46870423,5,-0.698430296,1.529712821,-0.768043946,155,80,75,1,-0.099725137,0,-0.195083426,0.118234922,0.804622944,0.804622944,-0.195083426,0,1,1,1
6088,26,89,48,110,128,1,2496.827,70,2690.24,MORE,1566,842,2408,3,2,18,1.687335229,18,1.571468165,0.728990734,-0.745533768,238,110,128,0,1.555712144,1.170500555,1.872800887,0.118234922,1.503609309,1.503609309,1.872800887,1.170500555,1,1,1
6089,26,90,9,59,50,1,6324.076,30,1832.97,MORE,290,2648,2938,5,2,-9,-0.843667615,9,0,-0.872453441,1.313156199,109,59,50,1,-1.017196402,-0.819350388,-1.170500555,2.009993671,0.308024052,0.308024052,-1.170500555,-0.819350388,0,1,1
6090,26,91,44,110,119,1,11780.841,50,1112.164,MORE,3230,2716,5946,5,2,9,0.843667615,9,0,-0.071731354,4.248368243,229,110,119,0,1.376206896,1.170500555,1.521650721,2.009993671,3.062742435,3.062742435,1.521650721,1.170500555,0,1,1
6091,26,92,2,52,50,0,9034.696,0,2082.326,MORE,-636,3968,3332,4,1,-2,-0.187481692,2,-1.222253018,-2.073536573,2.771207713,102,52,50,1,-1.156811594,-1.092467184,-1.170500555,1.064114296,-0.559618541,0.559618541,-1.170500555,-1.092467184,0,1,0
6092,26,93,8,58,50,0,2735.087,10,1696.283,MORE,-1036,2006,970,2,1,-8,-0.749926769,8,-0.174607574,-1.673175529,-0.617372922,108,58,50,1,-1.037141429,-0.858367073,-1.170500555,-0.827644453,-0.934410158,0.934410158,-1.170500555,-0.858367073,0,0,0
6093,26,94,44,119,110,0,4886.065,30,1771.77,MORE,-274,2356,2082,4,1,-9,-0.843667615,9,0,-0.872453441,0.539645299,229,119,110,1,1.376206896,1.521650721,1.170500555,1.064114296,-0.220432128,0.220432128,1.170500555,1.521650721,0,1,0
6094,26,95,34,74,80,1,8591.544,40,1690.784,MORE,982,3346,4328,4,1,6,0.562445076,6,-0.523822722,-0.472092397,2.532834779,154,74,80,0,-0.119670165,-0.234100111,0,1.064114296,0.956413549,0.956413549,0,-0.234100111,0,1,1
6095,26,96,24,86,80,1,5016.858,60,2928.079,MORE,-148,2482,2334,4,1,-6,-0.562445076,6,-0.523822722,0.32862969,0.609999289,166,86,80,1,0.119670165,0.234100111,0,1.064114296,-0.102372768,0.102372768,0,0.234100111,1,1,0
6096,26,97,39,66,80,0,3983.471,50,1340.879,MORE,118,1700,1818,3,2,14,1.312371845,14,0.87303787,-0.071731354,0.054136984,146,66,80,0,-0.279230385,-0.546233592,0,0.118234922,0.146863657,0.146863657,0,-0.546233592,0,1,0
6097,26,98,9,50,59,1,3944.317,20,2202.493,MORE,-582,2110,1528,4,1,9,0.843667615,9,0,-1.272814485,0.033075918,109,50,59,0,-1.017196402,-1.170500555,-0.819350388,1.064114296,-0.509021673,0.509021673,-0.819350388,-1.170500555,0,1,0
6098,26,99,57,94,110,1,3322.85,60,1053.581,MORE,348,1314,1662,3,2,16,1.499853537,16,1.222253018,0.32862969,-0.301213249,204,94,110,0,0.877581209,0.546233592,1.170500555,0.118234922,0.362368836,0.362368836,1.170500555,0.546233592,1,1,1
6099,26,100,60,110,87,0,5648.852,20,1156.532,MORE,-740,2898,2158,2,1,-23,-2.15603946,23,2.444506035,-1.272814485,0.949950964,197,110,87,1,0.737966017,1.170500555,0.273116796,-0.827644453,-0.657064361,0.657064361,0.273116796,1.170500555,0,0,0
6100,26,101,33,75,80,1,3192.225,90,1965.136,MORE,830,1196,2026,3,2,5,0.46870423,5,-0.698430296,1.529712821,-0.371476871,155,75,80,0,-0.099725137,-0.195083426,0,0.118234922,0.813992734,0.813992734,0,-0.195083426,1,1,1
6101,26,102,15,50,45,1,5584.85,70,1404.162,MORE,26,2532,2558,5,2,-5,-0.46870423,5,-0.698430296,0.728990734,0.915524075,95,50,45,1,-1.296426786,-1.170500555,-1.36558398,2.009993671,0.060661585,0.060661585,-1.36558398,-1.170500555,1,1,0
6102,26,103,59,89,110,0,3800.955,50,1899.69,MORE,-1586,2742,1156,2,1,21,1.968557767,21,2.095290887,-0.071731354,-0.044038979,199,89,110,0,0.777856072,0.351150166,1.170500555,-0.827644453,-1.449748631,1.449748631,1.170500555,0.351150166,0,0,0
6103,26,104,29,80,94,1,2762.286,90,1937.265,MORE,1154,1144,2298,3,2,14,1.312371845,14,0.87303787,1.529712821,-0.602742489,174,80,94,0,0.279230385,0,0.546233592,0.118234922,1.117573944,1.117573944,0.546233592,0,1,1,1
6104,26,105,55,110,98,0,2369.886,60,1419.478,MORE,-608,1388,780,2,1,-12,-1.124890153,12,0.523822722,0.32862969,-0.813815754,208,110,98,1,0.957361319,1.170500555,0.702300333,-0.827644453,-0.533383128,0.533383128,0.702300333,1.170500555,1,0,0
6105,26,106,29,94,80,0,4778.094,50,1271.559,MORE,-476,2414,1938,4,1,-14,-1.312371845,14,0.87303787,-0.071731354,0.481567339,174,94,80,1,0.279230385,0.546233592,0,1.064114296,-0.409701894,0.409701894,0,0.546233592,0,1,0
6106,26,107,57,110,94,0,3005.013,60,955.334,MORE,-444,1572,1128,2,1,-16,-1.499853537,16,1.222253018,0.32862969,-0.472178828,204,110,94,1,0.877581209,1.170500555,0.546233592,-0.827644453,-0.379718565,0.379718565,0.546233592,1.170500555,1,0,0
6107,26,108,39,80,66,0,3246.13,20,1108.887,MORE,-764,1850,1086,2,1,-14,-1.312371845,14,0.87303787,-1.272814485,-0.342481192,146,80,66,1,-0.279230385,0,-0.546233592,-0.827644453,-0.679551858,0.679551858,-0.546233592,0,0,0,0
6108,26,109,4,50,54,1,2716.209,50,1659.859,MORE,36,1212,1248,3,2,4,0.374963384,4,-0.87303787,-0.071731354,-0.627527461,104,50,54,0,-1.116921539,-1.170500555,-1.014433814,0.118234922,0.070031375,0.070031375,-1.014433814,-1.170500555,0,1,0
6109,26,110,55,98,110,0,5576.069,20,1706.032,MORE,-1004,2714,1710,3,1,12,1.124890153,12,0.523822722,-1.272814485,0.910800746,208,98,110,0,0.957361319,0.702300333,1.170500555,0.118234922,-0.904426828,0.904426828,1.170500555,0.702300333,0,1,0
6110,26,111,2,50,52,1,2473.142,100,2048.577,MORE,1142,936,2078,3,2,2,0.187481692,2,-1.222253018,1.930073865,-0.758274008,102,50,52,0,-1.156811594,-1.170500555,-1.092467184,0.118234922,1.106330195,1.106330195,-1.092467184,-1.170500555,1,1,1
6111,26,112,59,110,89,0,3912.157,80,1067.85,MORE,28,1776,1804,3,2,-21,-1.968557767,21,2.095290887,1.129351778,0.015776947,199,110,89,1,0.777856072,1.170500555,0.351150166,0.118234922,0.062535543,0.062535543,0.351150166,1.170500555,1,0,0
6112,26,113,60,87,110,1,3462.278,60,2014.497,MORE,440,1324,1764,3,2,23,2.15603946,23,2.444506035,0.32862969,-0.226214464,197,87,110,0,0.737966017,0.273116796,1.170500555,0.118234922,0.448570908,0.448570908,1.170500555,0.273116796,1,0,1
6113,26,114,52,110,105,0,6806.876,50,1101.565,MORE,-1128,2914,1786,4,1,-5,-0.46870423,5,-0.698430296,-0.071731354,1.572855925,215,110,105,1,1.096976512,1.170500555,0.975417129,1.064114296,-1.020612229,1.020612229,0.975417129,1.170500555,0,1,0
6114,26,115,30,80,96,1,3689.885,90,2523.943,MORE,614,1968,2582,3,2,16,1.499853537,16,1.222253018,1.529712821,-0.103783902,176,80,96,0,0.31912044,0,0.624266962,0.118234922,0.611605261,0.611605261,0.624266962,0,1,0,1
6115,26,116,24,80,86,1,4854.366,0,1733.9,MORE,-1744,3346,1602,3,1,6,0.562445076,6,-0.523822722,-2.073536573,0.522594302,166,80,86,0,0.119670165,0,0.234100111,0.118234922,-1.597791319,1.597791319,0.234100111,0,0,0,0
6116,26,117,5,50,55,1,2165.553,100,2087.501,MORE,928,780,1708,3,2,5,0.46870423,5,-0.698430296,1.930073865,-0.923727155,105,50,55,0,-1.096976512,-1.170500555,-0.975417129,0.118234922,0.90581668,0.90581668,-0.975417129,-1.170500555,1,0,1
6117,26,118,34,80,74,0,2967.995,10,1641.343,MORE,-806,2250,1444,4,1,-6,-0.562445076,6,-0.523822722,-1.673175529,-0.492090934,154,80,74,1,-0.119670165,0,-0.234100111,1.064114296,-0.718904978,0.718904978,-0.234100111,0,0,1,0
6118,26,119,15,45,50,1,2533.616,90,1668.756,MORE,1456,1172,2628,3,2,5,0.46870423,5,-0.698430296,1.529712821,-0.725744843,95,45,50,0,-1.296426786,-1.36558398,-1.170500555,0.118234922,1.400541615,1.400541615,-1.170500555,-1.36558398,1,0,1
6119,26,120,37,69,80,0,2814.158,50,949.61,MORE,-772,1630,858,2,1,11,1.031149307,11,0.349215148,-0.071731354,-0.574840368,149,69,80,0,-0.219395302,-0.429183537,0,-0.827644453,-0.687047691,0.687047691,0,-0.429183537,0,0,0
6120,26,121,48,128,110,1,6310.878,20,1023.08,LESS,-658,3194,2536,5,1,-18,-1.687335229,18,1.571468165,-1.272814485,1.306056951,238,128,110,0,1.555712144,1.872800887,1.170500555,2.009993671,-0.58023208,0.58023208,1.170500555,1.872800887,0,1,0
6121,26,122,8,50,58,0,2225.929,100,1334.813,LESS,360,1480,1840,3,2,8,0.749926769,8,-0.174607574,1.930073865,-0.891250703,108,50,58,1,-1.037141429,-1.170500555,-0.858367073,0.118234922,0.373612585,0.373612585,-0.858367073,-1.170500555,1,1,1
6122,26,123,4,54,50,1,5577.786,50,1431.944,LESS,408,2286,2694,5,2,-4,-0.374963384,4,-0.87303787,-0.071731354,0.911724326,104,54,50,0,-1.116921539,-1.014433814,-1.170500555,2.009993671,0.418587579,0.418587579,-1.170500555,-1.014433814,1,1,1
6123,26,124,37,80,69,1,3762.645,40,1164.27,LESS,588,1432,2020,3,2,-11,-1.031149307,11,0.349215148,-0.472092397,-0.064646055,149,80,69,0,-0.219395302,0,-0.429183537,0.118234922,0.587243806,0.587243806,-0.429183537,0,0,1,1
6124,26,125,52,105,110,0,6337.387,70,2636.757,LESS,-1720,3458,1738,4,1,5,0.46870423,5,-0.698430296,0.728990734,1.32031623,215,105,110,1,1.096976512,0.975417129,1.170500555,1.064114296,-1.575303822,1.575303822,1.170500555,0.975417129,1,1,0
6125,26,126,5,55,50,0,5171.295,20,1798.196,LESS,-422,2624,2202,4,1,-5,-0.46870423,5,-0.698430296,-1.272814485,0.693071465,105,55,50,0,-1.096976512,-0.975417129,-1.170500555,1.064114296,-0.359105026,0.359105026,-1.170500555,-0.975417129,0,1,0
6126,26,127,30,96,80,1,3259.466,20,1565.677,LESS,608,1210,1818,3,2,-16,-1.499853537,16,1.222253018,-1.272814485,-0.335307713,176,96,80,0,0.31912044,0.624266962,0,0.118234922,0.605983387,0.605983387,0,0.624266962,0,1,1
6127,26,128,33,80,75,0,5783.933,0,2750.435,LESS,-2340,4446,2106,4,1,-5,-0.46870423,5,-0.698430296,-2.073536573,1.022611483,155,80,75,0,-0.099725137,0,-0.195083426,1.064114296,-2.156230828,2.156230828,-0.195083426,0,0,1,0
6128,26,129,48,110,128,0,2434.332,90,1937.524,LESS,978,1334,2312,2,2,18,1.687335229,18,1.571468165,1.529712821,-0.779150036,238,110,128,1,1.555712144,1.170500555,1.872800887,-0.827644453,0.952665633,0.952665633,1.872800887,1.170500555,1,0,1
6129,26,130,9,59,50,1,4499.962,10,1376.049,LESS,-426,2682,2256,5,1,-9,-0.843667615,9,0,-1.673175529,0.331959211,109,59,50,0,-1.017196402,-0.819350388,-1.170500555,2.009993671,-0.362852942,0.362852942,-1.170500555,-0.819350388,0,1,0
6130,26,131,44,110,119,0,6346.889,30,1460.357,LESS,-620,2832,2212,4,1,9,0.843667615,9,0,-0.872453441,1.325427388,229,110,119,1,1.376206896,1.170500555,1.521650721,1.064114296,-0.544626876,0.544626876,1.521650721,1.170500555,0,1,0
6131,26,132,2,52,50,0,10257.774,20,1523.695,LESS,3226,2970,6196,6,1,-2,-0.187481692,2,-1.222253018,-1.272814485,3.429105438,102,52,50,0,-1.156811594,-1.092467184,-1.170500555,2.955873046,3.058994518,3.058994518,-1.170500555,-1.092467184,0,1,1
6132,26,133,8,58,50,0,3939.51,40,1534.336,LESS,144,1816,1960,4,1,-8,-0.749926769,8,-0.174607574,-0.472092397,0.030490216,108,58,50,0,-1.037141429,-0.858367073,-1.170500555,1.064114296,0.171225112,0.171225112,-1.170500555,-0.858367073,0,1,1
6133,26,134,44,119,110,1,5972.627,60,2473.812,LESS,1420,2054,3474,6,1,-9,-0.843667615,9,0,0.32862969,1.124110613,229,119,110,0,1.376206896,1.521650721,1.170500555,2.955873046,1.366810369,1.366810369,1.170500555,1.521650721,1,1,1
6134,26,135,34,74,80,0,2583.198,50,1676.813,LESS,-864,1738,874,2,1,6,0.562445076,6,-0.523822722,-0.071731354,-0.69907452,154,74,80,1,-0.119670165,-0.234100111,0,-0.827644453,-0.773249762,0.773249762,0,-0.234100111,0,0,0
6135,26,136,24,86,80,1,5884.523,50,1433.756,LESS,1882,1588,3470,3,2,-6,-0.562445076,6,-0.523822722,-0.071731354,1.076719179,166,86,80,0,0.119670165,0.234100111,0,0.118234922,1.799694686,1.799694686,0,0.234100111,1,1,1
6136,26,137,39,66,80,0,2442.05,60,1367.224,LESS,-966,1694,728,2,1,14,1.312371845,14,0.87303787,0.32862969,-0.774998499,146,66,80,1,-0.279230385,-0.546233592,0,-0.827644453,-0.868821625,0.868821625,0,-0.546233592,1,0,0
6137,26,138,9,50,59,0,2534.487,20,1149.8,LESS,-1226,2014,788,2,1,9,0.843667615,9,0,-1.272814485,-0.725276329,109,50,59,1,-1.017196402,-1.170500555,-0.819350388,-0.827644453,-1.112436175,1.112436175,-0.819350388,-1.170500555,0,0,0
6138,26,139,57,94,110,0,2364.845,60,1803.31,LESS,-900,1688,788,2,1,16,1.499853537,16,1.222253018,0.32862969,-0.816527325,204,94,110,1,0.877581209,0.546233592,1.170500555,-0.827644453,-0.806981008,0.806981008,1.170500555,0.546233592,1,0,0
6139,26,140,60,110,87,1,4377.315,60,1535.485,LESS,-306,1656,1350,3,2,-23,-2.15603946,23,2.444506035,0.32862969,0.265986982,197,110,87,0,0.737966017,1.170500555,0.273116796,0.118234922,-0.250415457,0.250415457,0.273116796,1.170500555,1,1,0
6140,26,141,33,75,80,1,5945.525,80,2302.447,LESS,982,2554,3536,5,2,5,0.46870423,5,-0.698430296,1.129351778,1.109532357,155,75,80,1,-0.099725137,-0.195083426,0,2.009993671,0.956413549,0.956413549,0,-0.195083426,1,1,1
6141,26,142,15,50,45,0,3650.664,30,1107.574,LESS,-1702,2510,808,2,1,-5,-0.46870423,5,-0.698430296,-0.872453441,-0.124881008,95,50,45,0,-1.296426786,-1.170500555,-1.36558398,-0.827644453,-1.558438199,1.558438199,-1.36558398,-1.170500555,0,0,0
6142,26,143,59,89,110,0,2038.65,80,2586.992,LESS,-158,1406,1248,2,2,21,1.968557767,21,2.095290887,1.129351778,-0.9919887,199,89,110,1,0.777856072,0.351150166,1.170500555,-0.827644453,-0.111742559,0.111742559,1.170500555,0.351150166,1,0,1
6143,26,144,29,80,94,0,2173.383,40,1038.604,LESS,-464,1202,738,2,1,14,1.312371845,14,0.87303787,-0.472092397,-0.919515372,174,80,94,1,0.279230385,0,0.546233592,-0.827644453,-0.398458146,0.398458146,0.546233592,0,0,0,0
6144,26,145,55,110,98,1,5711.783,40,1279.779,LESS,324,2572,2896,3,2,-12,-1.124890153,12,0.523822722,-0.472092397,0.983801758,208,110,98,0,0.957361319,1.170500555,0.702300333,0.118234922,0.339881339,0.339881339,0.702300333,1.170500555,0,1,1
6145,26,146,29,94,80,1,6388.109,50,972.174,LESS,1892,1554,3446,2,2,-14,-1.312371845,14,0.87303787,-0.071731354,1.347599763,174,94,80,0,0.279230385,0.546233592,0,-0.827644453,1.809064477,1.809064477,0,0.546233592,0,0,1
6146,26,147,57,110,94,1,4760.737,40,1583.069,LESS,-484,2546,2062,4,1,-16,-1.499853537,16,1.222253018,-0.472092397,0.472230951,204,110,94,0,0.877581209,1.170500555,0.546233592,1.064114296,-0.417197727,0.417197727,0.546233592,1.170500555,0,1,0
6147,26,148,39,80,66,1,4125.136,50,1072.228,LESS,596,1600,2196,3,2,-14,-1.312371845,14,0.87303787,-0.071731354,0.130339059,146,80,66,0,-0.279230385,0,-0.546233592,0.118234922,0.594739639,0.594739639,-0.546233592,0,0,1,1
6148,26,149,4,50,54,0,4116.57,60,1849.159,LESS,-654,2156,1502,4,1,4,0.374963384,4,-0.87303787,0.32862969,0.125731379,104,50,54,1,-1.116921539,-1.170500555,-1.014433814,1.064114296,-0.576484164,0.576484164,-1.014433814,-1.170500555,1,1,0
6149,26,150,55,98,110,0,2502.618,90,1413.109,LESS,162,1504,1666,1,2,12,1.124890153,12,0.523822722,1.529712821,-0.74241877,208,98,110,1,0.957361319,0.702300333,1.170500555,-1.773523827,0.188090734,0.188090734,1.170500555,0.702300333,1,0,1
6150,26,151,2,50,52,0,1974.829,100,2515.818,LESS,942,1084,2026,2,2,2,0.187481692,2,-1.222253018,1.930073865,-1.026318229,102,50,52,1,-1.156811594,-1.170500555,-1.092467184,-0.827644453,0.918934387,0.918934387,-1.092467184,-1.170500555,1,0,1
6151,26,152,59,110,89,0,2485.767,40,1582.752,LESS,-772,1498,726,2,1,-21,-1.968557767,21,2.095290887,-0.472092397,-0.751482979,199,110,89,0,0.777856072,1.170500555,0.351150166,-0.827644453,-0.687047691,0.687047691,0.351150166,1.170500555,0,0,0
6152,26,153,60,87,110,0,2519.234,80,958.899,LESS,-196,1598,1402,2,2,23,2.15603946,23,2.444506035,1.129351778,-0.733480968,197,87,110,1,0.737966017,0.273116796,1.170500555,-0.827644453,-0.147347762,0.147347762,1.170500555,0.273116796,1,0,1
6153,26,154,52,110,105,0,5623.303,50,1332.377,LESS,-242,2122,1880,4,1,-5,-0.46870423,5,-0.698430296,-0.071731354,0.936208072,215,110,105,0,1.096976512,1.170500555,0.975417129,1.064114296,-0.190448798,0.190448798,0.975417129,1.170500555,0,1,1
6154,26,155,30,80,96,0,4310.302,60,2318.21,LESS,-1072,2254,1182,1,1,16,1.499853537,16,1.222253018,0.32862969,0.229940466,176,80,96,1,0.31912044,0,0.624266962,-1.773523827,-0.968141403,0.968141403,0.624266962,0,1,0,0
6155,26,156,24,80,86,0,10034.304,40,1373.784,LESS,-1666,5522,3856,3,1,6,0.562445076,6,-0.523822722,-0.472092397,3.308900182,166,80,86,1,0.119670165,0,0.234100111,0.118234922,-1.524706954,1.524706954,0.234100111,0,0,1,0
6156,26,157,5,50,55,0,3917.847,30,2128.134,LESS,-1192,2082,890,2,1,5,0.46870423,5,-0.698430296,-0.872453441,0.018837617,105,50,55,1,-1.096976512,-1.170500555,-0.975417129,-0.827644453,-1.080578888,1.080578888,-0.975417129,-1.170500555,0,0,0
6157,26,158,34,80,74,0,3621.119,0,1717.731,LESS,-1296,2738,1442,2,1,-6,-0.562445076,6,-0.523822722,-2.073536573,-0.140773362,154,80,74,0,-0.119670165,0,-0.234100111,-0.827644453,-1.178024708,1.178024708,-0.234100111,0,0,0,0
6158,26,159,15,45,50,0,5296.541,70,1816.307,LESS,-888,2886,1998,2,2,5,0.46870423,5,-0.698430296,0.728990734,0.760441705,95,45,50,1,-1.296426786,-1.36558398,-1.170500555,-0.827644453,-0.795737259,0.795737259,-1.170500555,-1.36558398,1,0,0
6159,26,160,37,69,80,0,2968.852,70,1566.947,LESS,-1608,2338,730,2,1,11,1.031149307,11,0.349215148,0.728990734,-0.491629951,149,69,80,1,-0.219395302,-0.429183537,0,-0.827644453,-1.470362169,1.470362169,0,-0.429183537,1,0,0
6160,26,161,3,50,53,1,2681.53,60,1756.965,MORE,98,1410,1508,4,1,3,0.281222538,3,-1.047645444,0.32862969,-0.64618141,103,50,53,0,-1.136866566,-1.170500555,-1.053450499,1.064114296,0.128124076,0.128124076,-1.053450499,-1.170500555,0,1,0
6161,26,162,20,50,40,0,6612.498,80,1483.983,MORE,-1546,3720,2174,5,2,-10,-0.937408461,10,0.174607574,1.129351778,1.468299352,90,50,40,1,-1.396151924,-1.170500555,-1.560667406,2.009993671,-1.412269469,1.412269469,-1.560667406,-1.170500555,1,1,0
6162,26,163,25,80,88,1,2543.025,100,1724.544,MORE,1428,1154,2582,3,2,8,0.749926769,8,-0.174607574,1.930073865,-0.72068371,168,80,88,0,0.15956022,0,0.312133481,0.118234922,1.374306201,1.374306201,0.312133481,0,1,0,1
6163,26,164,42,115,110,1,3110.467,30,1173.266,MORE,822,1172,1994,4,1,-5,-0.46870423,5,-0.698430296,-0.872453441,-0.415454771,225,115,110,1,1.296426786,1.36558398,1.170500555,1.064114296,0.806496902,0.806496902,1.170500555,1.36558398,0,1,1
6164,26,165,53,103,110,1,2827.555,80,1677.133,MORE,652,1108,1760,3,2,7,0.656185922,7,-0.349215148,1.129351778,-0.567634077,213,103,110,0,1.057086457,0.897383758,1.170500555,0.118234922,0.647210465,0.647210465,1.170500555,0.897383758,1,0,1
6165,26,166,26,90,80,1,2676.807,50,1081.702,MORE,550,984,1534,3,2,-10,-0.937408461,10,0.174607574,-0.071731354,-0.648721927,170,90,80,1,0.199450275,0.390166852,0,0.118234922,0.551638603,0.551638603,0,0.390166852,0,0,1
6166,26,167,35,80,72,0,4946.576,50,1235.623,MORE,-710,2628,1918,4,1,-8,-0.749926769,8,-0.174607574,-0.071731354,0.572194367,152,80,72,1,-0.15956022,0,-0.312133481,1.064114296,-0.62895499,0.62895499,-0.312133481,0,0,1,0
6167,26,168,28,93,80,0,3069.226,30,1173.518,MORE,-738,1932,1194,2,1,-13,-1.218630999,13,0.698430296,-0.872453441,-0.437638442,173,93,80,1,0.259285357,0.507216907,0,-0.827644453,-0.655190403,0.655190403,0,0.507216907,0,0,0
6168,26,169,26,80,90,1,2909.776,50,1725.444,MORE,350,1216,1566,3,2,10,0.937408461,10,0.174607574,-0.071731354,-0.523407127,170,80,90,0,0.199450275,0,0.390166852,0.118234922,0.364242794,0.364242794,0.390166852,0,0,0,1
6169,26,170,25,88,80,0,2467.004,80,806.591,MORE,-90,1450,1360,2,2,-8,-0.749926769,8,-0.174607574,1.129351778,-0.761575659,168,88,80,1,0.15956022,0.312133481,0,-0.827644453,-0.048027984,0.048027984,0,0.312133481,1,0,0
6170,26,171,36,80,70,0,2153.84,40,1258.874,MORE,-382,1226,844,2,1,-10,-0.937408461,10,0.174607574,-0.472092397,-0.930027616,150,80,70,1,-0.199450275,0,-0.390166852,-0.827644453,-0.321625864,0.321625864,-0.390166852,0,0,0,0
6171,26,172,28,80,93,1,2562.301,70,795.434,MORE,464,920,1384,3,2,13,1.218630999,13,0.698430296,0.728990734,-0.710315086,173,80,93,0,0.259285357,0,0.507216907,0.118234922,0.471058405,0.471058405,0.507216907,0,1,0,1
6172,26,173,21,82,80,0,2594.663,30,1106.685,MORE,-716,1694,978,2,1,-2,-0.187481692,2,-1.222253018,-0.872453441,-0.692907458,162,82,80,1,0.039890055,0.07803337,0,-0.827644453,-0.634576864,0.634576864,0,0.07803337,0,0,0
6173,26,174,19,50,41,0,4674.205,0,1720.573,MORE,-714,3132,2418,4,1,-9,-0.843667615,9,0,-2.073536573,0.425685101,91,50,41,1,-1.376206896,-1.170500555,-1.521650721,1.064114296,-0.632702906,0.632702906,-1.521650721,-1.170500555,0,1,0
6174,26,175,56,96,110,1,4044.829,20,1001.397,MORE,888,1580,2468,3,1,14,1.312371845,14,0.87303787,-1.272814485,0.087141657,206,96,110,0,0.917471264,0.624266962,1.170500555,0.118234922,0.868337519,0.868337519,1.170500555,0.624266962,0,0,1
6175,26,176,23,80,85,1,3204.199,60,1556.942,MORE,212,1466,1678,3,2,5,0.46870423,5,-0.698430296,0.32862969,-0.365036016,165,80,85,0,0.099725137,0,0.195083426,0.118234922,0.234939687,0.234939687,0.195083426,0,1,1,1
6176,26,177,10,60,50,1,3188.273,40,766.791,MORE,700,1120,1820,3,2,-10,-0.937408461,10,0.174607574,-0.472092397,-0.373602665,110,60,50,1,-0.997251374,-0.780333703,-1.170500555,0.118234922,0.692185459,0.692185459,-1.170500555,-0.780333703,0,0,1
6177,26,178,19,41,50,1,1857.293,60,1874.084,MORE,592,558,1150,1,2,9,0.843667615,9,0,0.32862969,-1.089541234,91,41,50,0,-1.376206896,-1.521650721,-1.170500555,-1.773523827,0.590991722,0.590991722,-1.170500555,-1.521650721,1,0,1
6178,26,179,56,110,96,0,2550.861,70,973.907,MORE,-22,1534,1512,3,2,-14,-1.312371845,14,0.87303787,0.728990734,-0.7164687,206,110,96,1,0.917471264,1.170500555,0.624266962,0.118234922,0.015686591,0.015686591,0.624266962,1.170500555,1,1,0
6179,26,180,35,72,80,1,3109.831,60,916.73,MORE,98,1382,1480,3,2,8,0.749926769,8,-0.174607574,0.32862969,-0.415796878,152,72,80,0,-0.15956022,-0.312133481,0,0.118234922,0.128124076,0.128124076,0,-0.312133481,1,1,0
6180,26,181,11,49,50,1,3238.687,90,1553.341,MORE,884,1416,2300,3,2,1,0.093740846,1,-1.396860592,1.529712821,-0.346484806,99,49,50,0,-1.216646676,-1.20951724,-1.170500555,0.118234922,0.864589603,0.864589603,-1.170500555,-1.20951724,1,1,1
6181,26,182,17,43,50,1,3525.751,10,2178.64,MORE,-1108,2878,1770,2,1,7,0.656185922,7,-0.349215148,-1.673175529,-0.192072126,93,43,50,0,-1.336316841,-1.443617351,-1.170500555,-0.827644453,-1.001872649,1.001872649,-1.170500555,-1.443617351,0,0,0
6182,26,183,1,51,50,1,3750.855,70,1593.43,MORE,446,1400,1846,3,2,-1,-0.093740846,1,-1.396860592,0.728990734,-0.070987936,101,51,50,1,-1.176756621,-1.131483869,-1.170500555,0.118234922,0.454192782,0.454192782,-1.170500555,-1.131483869,1,1,1
6183,26,184,41,112,110,1,3371.85,50,1061.327,MORE,1022,1044,2066,3,2,-2,-0.187481692,2,-1.222253018,-0.071731354,-0.274855986,222,112,110,1,1.236591704,1.248533925,1.170500555,0.118234922,0.99389271,0.99389271,1.170500555,1.248533925,0,1,1
6184,26,185,20,40,50,1,3067.544,70,1343.456,MORE,828,1222,2050,3,2,10,0.937408461,10,0.174607574,0.728990734,-0.438543195,90,40,50,0,-1.396151924,-1.560667406,-1.170500555,0.118234922,0.812118776,0.812118776,-1.170500555,-1.560667406,1,1,1
6185,26,186,1,50,51,1,4316.018,40,928.846,MORE,240,1766,2006,2,2,1,0.093740846,1,-1.396860592,-0.472092397,0.233015122,101,50,51,0,-1.176756621,-1.170500555,-1.131483869,-0.827644453,0.2611751,0.2611751,-1.131483869,-1.170500555,0,0,1
6186,26,187,23,85,80,1,5624.833,70,885.232,MORE,188,2492,2680,3,2,-5,-0.46870423,5,-0.698430296,0.728990734,0.937031064,165,85,80,1,0.099725137,0.195083426,0,0.118234922,0.21245219,0.21245219,0,0.195083426,1,0,0
6187,26,188,11,50,49,1,5768.844,50,2176.09,MORE,1238,1978,3216,3,2,-1,-0.093740846,1,-1.396860592,-0.071731354,1.01449506,99,50,49,1,-1.216646676,-1.170500555,-1.20951724,0.118234922,1.196280183,1.196280183,-1.20951724,-1.170500555,0,0,1
6188,26,189,17,50,43,0,4310.734,80,1535.699,MORE,296,2016,2312,4,2,-7,-0.656185922,7,-0.349215148,1.129351778,0.230172841,93,50,43,1,-1.336316841,-1.170500555,-1.443617351,1.064114296,0.313645926,0.313645926,-1.443617351,-1.170500555,1,1,1
6189,26,190,21,80,82,1,3845.923,30,2337.938,MORE,518,1482,2000,3,2,2,0.187481692,2,-1.222253018,-0.872453441,-0.019850542,162,80,82,0,0.039890055,0,0.07803337,0.118234922,0.521655273,0.521655273,0.07803337,0,0,0,1
6190,26,191,10,50,60,1,5282.875,40,1858.481,MORE,804,1972,2776,3,2,10,0.937408461,10,0.174607574,-0.472092397,0.753090718,110,50,60,0,-0.997251374,-1.170500555,-0.780333703,0.118234922,0.789631279,0.789631279,-0.780333703,-1.170500555,0,0,1
6191,26,192,3,53,50,1,3154.436,70,1708.768,MORE,716,1170,1886,3,2,-3,-0.281222538,3,-1.047645444,0.728990734,-0.3918037,103,53,50,1,-1.136866566,-1.053450499,-1.170500555,0.118234922,0.707177124,0.707177124,-1.170500555,-1.053450499,1,0,1
6192,26,193,45,122,110,0,3155.11,90,1492.862,MORE,702,1390,2092,2,2,-12,-1.124890153,12,0.523822722,1.529712821,-0.391441153,232,122,110,1,1.436041979,1.638700776,1.170500555,-0.827644453,0.694059417,0.694059417,1.170500555,1.638700776,1,0,1
6193,26,194,38,67,80,1,3158.929,70,1587.622,MORE,232,1224,1456,3,2,13,1.218630999,13,0.698430296,0.728990734,-0.3893869,147,67,80,0,-0.259285357,-0.507216907,0,0.118234922,0.253679267,0.253679267,0,-0.507216907,1,0,1
6194,26,195,38,80,67,1,3323.891,80,1643.736,MORE,3066,514,3580,1,2,-13,-1.218630999,13,0.698430296,1.129351778,-0.300653291,147,80,67,1,-0.259285357,0,-0.507216907,-1.773523827,2.909077872,2.909077872,-0.507216907,0,1,0,1
6195,26,196,36,70,80,1,4285.535,20,2299.906,MORE,254,1758,2012,3,1,10,0.937408461,10,0.174607574,-1.272814485,0.216618215,150,70,80,0,-0.199450275,-0.390166852,0,0.118234922,0.274292806,0.274292806,0,-0.390166852,0,0,1
6196,26,197,45,110,122,1,3362.234,70,2122.181,MORE,502,1114,1616,2,2,12,1.124890153,12,0.523822722,0.728990734,-0.280028464,232,110,122,0,1.436041979,1.170500555,1.638700776,-0.827644453,0.506663609,0.506663609,1.638700776,1.170500555,1,0,1
6197,26,198,42,110,115,1,5032.092,0,1153.975,MORE,20,2492,2512,5,1,5,0.46870423,5,-0.698430296,-2.073536573,0.618193708,225,110,115,0,1.296426786,1.170500555,1.36558398,2.009993671,0.055039711,0.055039711,1.36558398,1.170500555,0,1,0
6198,26,199,41,110,112,1,2523.751,80,1020.806,MORE,506,1158,1664,3,2,2,0.187481692,2,-1.222253018,1.129351778,-0.731051259,222,110,112,0,1.236591704,1.170500555,1.248533925,0.118234922,0.510411525,0.510411525,1.248533925,1.170500555,1,1,1
6199,26,200,53,110,103,1,5720.895,30,2292.981,MORE,1336,2040,3376,3,2,-7,-0.656185922,7,-0.349215148,-0.872453441,0.988703133,213,110,103,1,1.057086457,1.170500555,0.897383758,0.118234922,1.28810413,1.28810413,0.897383758,1.170500555,0,1,1
6200,26,201,3,50,53,0,2557.246,100,1683.946,LESS,10,1272,1282,2,2,3,0.281222538,3,-1.047645444,1.930073865,-0.713034187,103,50,53,1,-1.136866566,-1.170500555,-1.053450499,-0.827644453,0.04566992,0.04566992,-1.053450499,-1.170500555,1,0,1
6201,26,202,20,50,40,1,2706.55,10,1146.422,LESS,-702,2054,1352,3,1,-10,-0.937408461,10,0.174607574,-1.673175529,-0.632723069,90,50,40,0,-1.396151924,-1.170500555,-1.560667406,0.118234922,-0.621459158,0.621459158,-1.560667406,-1.170500555,0,1,0
6202,26,203,25,80,88,0,3796.593,40,1679.651,LESS,-424,1876,1452,4,1,8,0.749926769,8,-0.174607574,-0.472092397,-0.046385313,168,80,88,1,0.15956022,0,0.312133481,1.064114296,-0.360978984,0.360978984,0.312133481,0,0,1,0
6203,26,204,42,115,110,0,1872.349,80,982.285,LESS,-106,1194,1088,2,2,-5,-0.46870423,5,-0.698430296,1.129351778,-1.081442561,225,115,110,0,1.296426786,1.36558398,1.170500555,-0.827644453,-0.063019649,0.063019649,1.170500555,1.36558398,1,0,1
6204,26,205,53,103,110,0,2463.985,90,2416.573,LESS,422,1468,1890,4,2,7,0.656185922,7,-0.349215148,1.529712821,-0.763199589,213,103,110,1,1.057086457,0.897383758,1.170500555,1.064114296,0.431705285,0.431705285,1.170500555,0.897383758,1,1,1
6205,26,206,26,90,80,0,3838.883,50,1220.3,LESS,-882,1952,1070,4,1,-10,-0.937408461,10,0.174607574,-0.071731354,-0.023637382,170,90,80,0,0.199450275,0.390166852,0,1.064114296,-0.790115385,0.790115385,0,0.390166852,0,1,0
6206,26,207,35,80,72,0,2455.096,20,1935.301,LESS,-2188,2994,806,2,1,-8,-0.749926769,8,-0.174607574,-1.272814485,-0.767981012,152,80,72,0,-0.15956022,0,-0.312133481,-0.827644453,-2.013810014,2.013810014,-0.312133481,0,0,0,0
6207,26,208,28,93,80,1,5683.111,30,1007.413,LESS,36,2262,2298,5,2,-13,-1.218630999,13,0.698430296,-0.872453441,0.968378994,173,93,80,0,0.259285357,0.507216907,0,2.009993671,0.070031375,0.070031375,0,0.507216907,0,1,1
6208,26,209,26,80,90,0,3791.917,70,1432.655,LESS,336,1966,2302,4,2,10,0.937408461,10,0.174607574,0.728990734,-0.048900549,170,80,90,1,0.199450275,0,0.390166852,1.064114296,0.351125088,0.351125088,0.390166852,0,1,1,1
6209,26,210,25,88,80,0,3503.122,50,1589.485,LESS,-916,2034,1118,2,1,-8,-0.749926769,8,-0.174607574,-0.071731354,-0.20424434,168,88,80,0,0.15956022,0.312133481,0,-0.827644453,-0.821972673,0.821972673,0,0.312133481,0,0,0
6210,26,211,36,80,70,1,6476.696,0,1800.916,LESS,-728,3892,3164,6,1,-10,-0.937408461,10,0.174607574,-2.073536573,1.395251005,150,80,70,0,-0.199450275,0,-0.390166852,2.955873046,-0.645820613,0.645820613,-0.390166852,0,0,1,0
6211,26,212,28,80,93,0,3457.796,80,801.492,LESS,414,1544,1958,4,2,13,1.218630999,13,0.698430296,1.129351778,-0.228625347,173,80,93,1,0.259285357,0,0.507216907,1.064114296,0.424209453,0.424209453,0.507216907,0,1,1,1
6212,26,213,21,82,80,0,1964.479,40,1209.766,LESS,-812,1442,630,2,1,-2,-0.187481692,2,-1.222253018,-0.472092397,-1.031885528,162,82,80,0,0.039890055,0.07803337,0,-0.827644453,-0.724526852,0.724526852,0,0.07803337,0,0,0
6213,26,214,19,50,41,0,2053.255,60,1042.605,LESS,-634,1540,906,3,2,-9,-0.843667615,9,0,0.32862969,-0.984132622,91,50,41,0,-1.376206896,-1.170500555,-1.521650721,0.118234922,-0.557744583,0.557744583,-1.521650721,-1.170500555,1,1,0
6214,26,215,56,96,110,0,2527.177,50,1055.311,LESS,-420,1256,836,2,1,14,1.312371845,14,0.87303787,-0.071731354,-0.729208402,206,96,110,1,0.917471264,0.624266962,1.170500555,-0.827644453,-0.357231068,0.357231068,1.170500555,0.624266962,1,0,0
6215,26,216,23,80,85,0,4151.532,30,1098.588,LESS,-568,2108,1540,4,1,5,0.46870423,5,-0.698430296,-0.872453441,0.144537555,165,80,85,1,0.099725137,0,0.195083426,1.064114296,-0.495903966,0.495903966,0.195083426,0,0,1,0
6216,26,217,10,60,50,0,2804.157,50,1116.834,LESS,-772,1492,720,2,1,-10,-0.937408461,10,0.174607574,-0.071731354,-0.580219939,110,60,50,0,-0.997251374,-0.780333703,-1.170500555,-0.827644453,-0.687047691,0.687047691,-1.170500555,-0.780333703,1,0,0
6217,26,218,19,41,50,0,2186.171,40,836.06,LESS,-548,1236,688,2,1,9,0.843667615,9,0,-0.472092397,-0.912636664,91,41,50,1,-1.376206896,-1.521650721,-1.170500555,-0.827644453,-0.477164385,0.477164385,-1.170500555,-1.521650721,0,0,0
6218,26,219,56,110,96,0,4935.597,30,1013.063,LESS,-174,2448,2274,4,1,-14,-1.312371845,14,0.87303787,-0.872453441,0.566288727,206,110,96,0,0.917471264,1.170500555,0.624266962,1.064114296,-0.126734224,0.126734224,0.624266962,1.170500555,0,1,1
6219,26,220,35,72,80,0,2388.042,70,593.83,LESS,-948,1652,704,2,1,8,0.749926769,8,-0.174607574,0.728990734,-0.804049581,152,72,80,1,-0.15956022,-0.312133481,0,-0.827644453,-0.851956002,0.851956002,0,-0.312133481,1,0,0
6220,26,221,11,49,50,0,2323.647,50,946.096,LESS,-904,1642,738,2,1,1,0.093740846,1,-1.396860592,-0.071731354,-0.838687866,99,49,50,1,-1.216646676,-1.20951724,-1.170500555,-0.827644453,-0.810728924,0.810728924,-1.170500555,-1.20951724,1,0,0
6221,26,222,17,43,50,0,2301.232,60,1514.611,LESS,-814,1540,726,2,1,7,0.656185922,7,-0.349215148,0.32862969,-0.850744969,93,43,50,1,-1.336316841,-1.443617351,-1.170500555,-0.827644453,-0.72640081,0.72640081,-1.170500555,-1.443617351,1,0,0
6222,26,223,1,51,50,0,2179.766,50,1103.774,LESS,-412,1190,778,2,1,-1,-0.093740846,1,-1.396860592,-0.071731354,-0.916081935,101,51,50,0,-1.176756621,-1.131483869,-1.170500555,-0.827644453,-0.349735235,0.349735235,-1.170500555,-1.131483869,1,1,0
6223,26,224,41,112,110,0,2751.792,0,1812.319,LESS,-2346,3102,756,2,1,-2,-0.187481692,2,-1.222253018,-2.073536573,-0.608387247,222,112,110,0,1.236591704,1.248533925,1.170500555,-0.827644453,-2.161852702,2.161852702,1.170500555,1.248533925,0,0,0
6224,26,225,20,40,50,1,1819.369,100,1656.522,LESS,1678,506,2184,1,2,10,0.937408461,10,0.174607574,1.930073865,-1.10994068,90,40,50,1,-1.396151924,-1.560667406,-1.170500555,-1.773523827,1.608550962,1.608550962,-1.170500555,-1.560667406,1,0,1
6225,26,226,1,50,51,1,2228.339,50,1055.735,LESS,1018,448,1466,1,2,1,0.093740846,1,-1.396860592,-0.071731354,-0.889954356,101,50,51,1,-1.176756621,-1.170500555,-1.131483869,-1.773523827,0.990144794,0.990144794,-1.131483869,-1.170500555,1,0,1
6226,26,227,23,85,80,1,3792.063,80,1057.819,LESS,464,1584,2048,3,2,-5,-0.46870423,5,-0.698430296,1.129351778,-0.048822015,165,85,80,0,0.099725137,0.195083426,0,0.118234922,0.471058405,0.471058405,0,0.195083426,1,1,1
6227,26,228,11,50,49,1,1906.59,70,845.148,LESS,848,578,1426,1,2,-1,-0.093740846,1,-1.396860592,0.728990734,-1.063024214,99,50,49,0,-1.216646676,-1.170500555,-1.20951724,-1.773523827,0.830858357,0.830858357,-1.20951724,-1.170500555,1,0,1
6228,26,229,17,50,43,1,2741.057,50,875.753,LESS,154,1142,1296,3,2,-7,-0.656185922,7,-0.349215148,-0.071731354,-0.614161639,93,50,43,0,-1.336316841,-1.170500555,-1.443617351,0.118234922,0.180594902,0.180594902,-1.443617351,-1.170500555,1,1,1
6229,26,230,21,80,82,1,1906.411,30,1332.615,LESS,376,750,1126,1,2,2,0.187481692,2,-1.222253018,-0.872453441,-1.063120498,162,80,82,1,0.039890055,0,0.07803337,-1.773523827,0.388604249,0.388604249,0.07803337,0,0,0,1
6230,26,231,10,50,60,1,3047.259,70,788.507,LESS,570,1298,1868,3,2,10,0.937408461,10,0.174607574,0.728990734,-0.449454564,110,50,60,1,-0.997251374,-1.170500555,-0.780333703,0.118234922,0.570378184,0.570378184,-0.780333703,-1.170500555,1,1,1
6231,26,232,3,53,50,1,1978.091,50,842.543,LESS,984,550,1534,1,2,-3,-0.281222538,3,-1.047645444,-0.071731354,-1.024563588,103,53,50,0,-1.136866566,-1.053450499,-1.170500555,-1.773523827,0.958287507,0.958287507,-1.170500555,-1.053450499,1,0,1
6232,26,233,45,122,110,1,3814.17,60,914.123,LESS,868,1312,2180,3,2,-12,-1.124890153,12,0.523822722,0.32862969,-0.036930587,232,122,110,0,1.436041979,1.638700776,1.170500555,0.118234922,0.849597938,0.849597938,1.170500555,1.638700776,1,1,1
6233,26,234,38,67,80,1,3913.72,40,1470.682,LESS,-272,2186,1914,3,1,13,1.218630999,13,0.698430296,-0.472092397,0.01661769,147,67,80,1,-0.259285357,-0.507216907,0,0.118234922,-0.21855817,0.21855817,0,-0.507216907,0,1,0
6234,26,235,38,80,67,0,2412.024,70,1245.859,LESS,-430,1274,844,2,1,-13,-1.218630999,13,0.698430296,0.728990734,-0.791149584,147,80,67,0,-0.259285357,0,-0.507216907,-0.827644453,-0.366600858,0.366600858,-0.507216907,0,1,0,0
6235,26,236,36,70,80,0,2991.058,50,1590.604,LESS,-678,1488,810,2,1,10,0.937408461,10,0.174607574,-0.071731354,-0.479685269,150,70,80,1,-0.199450275,-0.390166852,0,-0.827644453,-0.598971661,0.598971661,0,-0.390166852,0,0,0
6236,26,237,45,110,122,0,2817.886,20,1207.511,LESS,-1380,2218,838,2,1,12,1.124890153,12,0.523822722,-1.272814485,-0.572835064,232,110,122,1,1.436041979,1.170500555,1.638700776,-0.827644453,-1.256730948,1.256730948,1.638700776,1.170500555,0,0,0
6237,26,238,42,110,115,0,5008.878,0,1998.855,LESS,-1860,3544,1684,3,1,5,0.46870423,5,-0.698430296,-2.073536573,0.60570682,225,110,115,1,1.296426786,1.170500555,1.36558398,0.118234922,-1.706480888,1.706480888,1.36558398,1.170500555,0,1,0
6238,26,239,41,110,112,0,4788.343,30,1218.571,LESS,-78,2184,2106,6,1,2,0.187481692,2,-1.222253018,-0.872453441,0.48708031,222,110,112,1,1.236591704,1.170500555,1.248533925,2.955873046,-0.036784236,0.036784236,1.248533925,1.170500555,0,1,1
6239,26,240,53,110,103,1,2959.277,50,1066.295,LESS,-86,1524,1438,3,2,-7,-0.656185922,7,-0.349215148,-0.071731354,-0.496780375,213,110,103,0,1.057086457,1.170500555,0.897383758,0.118234922,-0.044280068,0.044280068,0.897383758,1.170500555,0,1,1
6240,27,1,49,110,131,0,3950.737,84,1719.524,LESS,-1348,2482,1134,2,2,21,1.968557767,21,2.095290887,1.045455524,-0.38522881,241,110,131,1,1.615547226,1.170500555,1.989850943,-0.848847373,-1.266954566,1.266954566,1.989850943,1.170500555,1,0,0
6241,27,2,13,47,50,1,5835.02,54,1821.111,LESS,-134,2750,2616,3,1,3,0.281222538,3,-1.047645444,-0.539902474,0.722131623,97,47,50,1,-1.256536731,-1.28755061,-1.170500555,-0.024056403,0.135680486,0.135680486,-1.170500555,-1.28755061,0,0,1
6242,27,3,16,50,44,1,5352.883,84,2135.482,LESS,774,1868,2642,3,2,-6,-0.562445076,6,-0.523822722,1.045455524,0.438788072,94,50,44,0,-1.316371814,-1.170500555,-1.404600665,-0.024056403,1.184768317,1.184768317,-1.404600665,-1.170500555,1,0,1
6243,27,4,7,57,50,1,4507.477,74,1531.509,LESS,974,1926,2900,3,2,-7,-0.656185922,7,-0.349215148,0.517002858,-0.05804237,107,57,50,0,-1.057086457,-0.897383758,-1.170500555,-0.024056403,1.415844932,1.415844932,-1.170500555,-0.897383758,1,0,1
6244,27,5,18,42,50,0,6834.804,14,2287.815,LESS,-1988,4280,2292,4,1,8,0.749926769,8,-0.174607574,-2.653713138,1.309687337,92,42,50,1,-1.356261869,-1.482634036,-1.170500555,0.800734566,-2.006399734,2.006399734,-1.170500555,-1.482634036,0,1,0
6245,27,6,51,108,110,1,6077.44,74,1935.88,LESS,1112,2692,3804,3,2,2,0.187481692,2,-1.222253018,0.517002858,0.864597652,218,108,110,1,1.156811594,1.092467184,1.170500555,-0.024056403,1.575287796,1.575287796,1.170500555,1.092467184,1,0,1
6246,27,7,31,78,80,0,5213.457,64,2270.312,LESS,-1568,3342,1774,3,1,2,0.187481692,2,-1.222253018,-0.011449808,0.35684983,158,78,80,1,-0.039890055,-0.07803337,0,-0.024056403,-1.521138843,1.521138843,0,-0.07803337,1,0,0
6247,27,8,58,110,92,0,5328.029,34,2339.981,LESS,-1316,3592,2276,4,1,-18,-1.687335229,18,1.571468165,-1.596807806,0.424181807,202,110,92,0,0.837691154,1.170500555,0.468200222,0.800734566,-1.229982308,1.229982308,0.468200222,1.170500555,0,1,0
6248,27,9,12,50,48,1,9261.84,64,2103.168,LESS,2668,3176,5844,3,1,-2,-0.187481692,2,-1.222253018,-0.011449808,2.736014294,98,50,48,0,-1.236591704,-1.170500555,-1.248533925,-0.024056403,3.373063859,3.373063859,-1.248533925,-1.170500555,1,0,1
6249,27,10,54,110,101,1,6691.854,64,2101.861,LESS,210,2952,3162,1,2,-9,-0.843667615,9,0,-0.011449808,1.225678102,211,110,101,0,1.017196402,1.170500555,0.819350388,-1.673638342,0.533132263,0.533132263,0.819350388,1.170500555,1,0,1
6250,27,11,14,46,50,0,7757.531,64,2055.109,LESS,-1266,3942,2676,6,1,4,0.374963384,4,-0.87303787,-0.011449808,1.851957989,96,46,50,1,-1.276481759,-1.326567295,-1.170500555,2.450316505,-1.172213154,1.172213154,-1.170500555,-1.326567295,1,1,0
6251,27,12,22,80,83,0,4448.349,34,1787.298,LESS,-1272,2318,1046,1,1,3,0.281222538,3,-1.047645444,-1.596807806,-0.092790869,163,80,83,1,0.059835082,0,0.117050055,-1.673638342,-1.179145453,1.179145453,0.117050055,0,0,0,0
6252,27,13,6,50,56,0,7716.714,44,1692.193,LESS,-900,3922,3022,4,1,6,0.562445076,6,-0.523822722,-1.06835514,1.827970546,106,50,56,1,-1.077031484,-1.170500555,-0.936400444,0.800734566,-0.749342949,0.749342949,-0.936400444,-1.170500555,0,1,0
6253,27,14,13,50,47,1,4408.253,64,1899.319,LESS,-204,1974,1770,3,2,-3,-0.281222538,3,-1.047645444,-0.011449808,-0.116354593,97,50,47,0,-1.256536731,-1.170500555,-1.28755061,-0.024056403,0.05480367,0.05480367,-1.28755061,-1.170500555,1,0,0
6254,27,15,46,110,124,0,7122.705,74,1625.943,LESS,-1376,3492,2116,3,2,14,1.312371845,14,0.87303787,0.517002858,1.478881761,234,110,124,1,1.475932034,1.170500555,1.716734147,-0.024056403,-1.299305292,1.299305292,1.716734147,1.170500555,1,1,0
6255,27,16,27,91,80,1,5303.804,74,1836.715,LESS,6,2552,2558,4,2,-11,-1.031149307,11,0.349215148,0.517002858,0.409945195,171,91,80,0,0.219395302,0.429183537,0,0.800734566,0.297434116,0.297434116,0,0.429183537,1,1,1
6256,27,17,40,64,80,0,7383.269,54,1619.711,LESS,-1258,3900,2642,3,1,16,1.499853537,16,1.222253018,-0.539902474,1.632010704,144,64,80,1,-0.31912044,-0.624266962,0,-0.024056403,-1.16297009,1.16297009,0,-0.624266962,0,0,0
6257,27,18,22,83,80,1,5048.714,74,1596.452,LESS,1138,1914,3052,3,2,-3,-0.281222538,3,-1.047645444,0.517002858,0.260033227,163,83,80,0,0.059835082,0.117050055,0,-0.024056403,1.605327756,1.605327756,0,0.117050055,1,0,1
6258,27,19,54,101,110,0,6305.976,84,2144.483,LESS,-1016,3660,2644,4,2,9,0.843667615,9,0,1.045455524,0.998904295,211,101,110,1,1.017196402,0.819350388,1.170500555,0.800734566,-0.883367386,0.883367386,1.170500555,0.819350388,1,1,0
6259,27,20,6,56,50,1,4163.416,84,1758.405,LESS,958,1676,2634,3,2,-6,-0.562445076,6,-0.523822722,1.045455524,-0.260241051,106,56,50,0,-1.077031484,-0.936400444,-1.170500555,-0.024056403,1.397358803,1.397358803,-1.170500555,-0.936400444,1,1,1
6260,27,21,18,50,42,1,4185.19,100,1837.192,LESS,1124,1574,2698,3,2,-8,-0.749926769,8,-0.174607574,1.89097979,-0.247444849,92,50,42,0,-1.356261869,-1.170500555,-1.482634036,-0.024056403,1.589152393,1.589152393,-1.482634036,-1.170500555,1,1,1
6261,27,22,43,110,117,0,4748.806,24,2468.892,LESS,-1552,3056,1504,4,1,7,0.656185922,7,-0.349215148,-2.125260472,0.083782498,227,110,117,1,1.336316841,1.170500555,1.443617351,0.800734566,-1.502652713,1.502652713,1.443617351,1.170500555,0,1,0
6262,27,23,32,77,80,1,3863.596,64,1439.248,LESS,422,1140,1562,2,2,3,0.281222538,3,-1.047645444,-0.011449808,-0.436440064,157,77,80,1,-0.059835082,-0.117050055,0,-0.848847373,0.778073475,0.778073475,0,-0.117050055,1,0,1
6263,27,24,27,80,91,0,7102.542,54,2163.847,LESS,-2262,3090,828,2,1,11,1.031149307,11,0.349215148,-0.539902474,1.467032316,171,80,91,1,0.219395302,0,0.429183537,-0.848847373,-2.322974696,2.322974696,0.429183537,0,0,0,0
6264,27,25,16,44,50,1,4330.574,84,1904.944,LESS,1234,1464,2698,3,2,6,0.562445076,6,-0.523822722,1.045455524,-0.162005194,94,44,50,1,-1.316371814,-1.404600665,-1.170500555,-0.024056403,1.716244531,1.716244531,-1.170500555,-1.404600665,1,0,1
6265,27,26,7,50,57,1,8992.131,44,1794.748,LESS,-450,4174,3724,5,2,7,0.656185922,7,-0.349215148,-1.06835514,2.577510993,107,50,57,1,-1.057086457,-1.170500555,-0.897383758,1.625525535,-0.229420566,0.229420566,-0.897383758,-1.170500555,0,1,0
6266,27,27,14,50,46,1,3646.563,64,1347.323,LESS,636,1272,1908,3,2,-4,-0.374963384,4,-0.87303787,-0.011449808,-0.563986593,96,50,46,0,-1.276481759,-1.170500555,-1.326567295,-0.024056403,1.025325453,1.025325453,-1.326567295,-1.170500555,1,1,1
6267,27,28,51,110,108,1,5312.972,64,1492.578,LESS,2138,1662,3800,3,2,-2,-0.187481692,2,-1.222253018,-0.011449808,0.415333069,218,110,108,0,1.156811594,1.170500555,1.092467184,-0.024056403,2.76071083,2.76071083,1.092467184,1.170500555,1,1,1
6268,27,29,50,133,110,0,7022.679,24,2050.33,LESS,-1008,3710,2702,4,1,-23,-2.15603946,23,2.444506035,-2.125260472,1.420098216,243,133,110,0,1.655437281,2.067884313,1.170500555,0.800734566,-0.874124321,0.874124321,1.170500555,2.067884313,0,1,0
6269,27,30,49,131,110,0,5082.712,44,1685.647,LESS,-1654,3154,1500,4,1,-21,-1.968557767,21,2.095290887,-1.06835514,0.280013262,241,131,110,0,1.615547226,1.989850943,1.170500555,0.800734566,-1.620501787,1.620501787,1.170500555,1.989850943,0,1,0
6270,27,31,47,126,110,1,5260.004,54,4288.685,LESS,694,2242,2936,5,2,-16,-1.499853537,16,1.222253018,-0.539902474,0.384204695,236,126,110,0,1.515822089,1.794767517,1.170500555,1.625525535,1.092337671,1.092337671,1.170500555,1.794767517,0,1,1
6271,27,32,50,110,133,0,5862.397,34,2436.616,LESS,-1362,3778,2416,6,1,23,2.15603946,23,2.444506035,-1.596807806,0.738220611,243,110,133,1,1.655437281,1.170500555,2.067884313,2.450316505,-1.283129929,1.283129929,2.067884313,1.170500555,0,1,0
6272,27,33,47,110,126,1,4152.259,54,1592.024,LESS,718,1304,2022,3,2,16,1.499853537,16,1.222253018,-0.539902474,-0.266797826,236,110,126,1,1.515822089,1.170500555,1.794767517,-0.024056403,1.120066865,1.120066865,1.794767517,1.170500555,0,1,1
6273,27,34,12,48,50,1,3599.014,54,1636.954,LESS,808,1270,2078,3,2,2,0.187481692,2,-1.222253018,-0.539902474,-0.591930316,98,48,50,1,-1.236591704,-1.248533925,-1.170500555,-0.024056403,1.224051342,1.224051342,-1.170500555,-1.248533925,0,1,1
6274,27,35,32,80,77,1,8363.168,54,1844.959,LESS,450,3828,4278,7,2,-3,-0.281222538,3,-1.047645444,-0.539902474,2.207880348,157,80,77,0,-0.059835082,0,-0.117050055,3.275107474,0.810424201,0.810424201,-0.117050055,0,0,1,1
6275,27,36,43,117,110,1,3620.641,64,2020.563,LESS,726,1312,2038,3,2,-7,-0.656185922,7,-0.349215148,-0.011449808,-0.579220503,227,117,110,0,1.336316841,1.443617351,1.170500555,-0.024056403,1.129309929,1.129309929,1.170500555,1.443617351,1,1,1
6276,27,37,40,80,64,1,3040.126,44,2527.75,LESS,-168,1206,1038,3,2,-16,-1.499853537,16,1.222253018,-1.06835514,-0.920379099,144,80,64,0,-0.31912044,0,-0.624266962,-0.024056403,0.096397461,0.096397461,-0.624266962,0,0,1,1
6277,27,38,31,80,78,1,6458.051,44,2102.894,LESS,768,2390,3158,5,2,-2,-0.187481692,2,-1.222253018,-1.06835514,1.088276135,158,80,78,0,-0.039890055,0,-0.07803337,1.625525535,1.177836019,1.177836019,-0.07803337,0,0,1,1
6278,27,39,46,124,110,0,4473.641,84,2191.469,LESS,-718,2396,1678,4,2,-14,-1.312371845,14,0.87303787,1.045455524,-0.0779272,234,124,110,0,1.475932034,1.716734147,1.170500555,0.800734566,-0.53906323,0.53906323,1.170500555,1.716734147,1,1,0
6279,27,40,58,92,110,0,3180.253,84,1593.1,LESS,-1012,2340,1328,2,1,18,1.687335229,18,1.571468165,1.045455524,-0.838028892,202,92,110,1,0.837691154,0.468200222,1.170500555,-0.848847373,-0.878745853,0.878745853,1.170500555,0.468200222,1,0,0
6280,27,41,49,110,131,1,1634.272,84,1293.404,MORE,-144,660,516,1,2,21,1.968557767,21,2.095290887,1.045455524,-1.746575108,241,110,131,0,1.615547226,1.170500555,1.989850943,-1.673638342,0.124126655,0.124126655,1.989850943,1.170500555,1,0,1
6281,27,42,13,47,50,1,3381.251,64,1585.423,MORE,-200,1748,1548,3,1,3,0.281222538,3,-1.047645444,-0.011449808,-0.719905854,97,47,50,0,-1.256536731,-1.28755061,-1.170500555,-0.024056403,0.059425203,0.059425203,-1.170500555,-1.28755061,1,1,1
6282,27,43,16,50,44,0,5654.203,64,1741.015,MORE,-2090,2894,804,1,1,-6,-0.562445076,6,-0.523822722,-0.011449808,0.615868609,94,50,44,1,-1.316371814,-1.170500555,-1.404600665,-1.673638342,-2.124248807,2.124248807,-1.404600665,-1.170500555,1,0,0
6283,27,44,7,57,50,0,2911.667,94,1756.09,MORE,-988,2072,1084,2,2,-7,-0.656185922,7,-0.349215148,1.57390819,-0.995872225,107,57,50,1,-1.057086457,-0.897383758,-1.170500555,-0.848847373,-0.85101666,0.85101666,-1.170500555,-0.897383758,1,0,0
6284,27,45,18,42,50,0,5072.245,54,2288.561,MORE,-228,2726,2498,4,2,8,0.749926769,8,-0.174607574,-0.539902474,0.273861987,92,42,50,0,-1.356261869,-1.482634036,-1.170500555,0.800734566,0.027074477,0.027074477,-1.170500555,-1.482634036,0,1,1
6285,27,46,51,108,110,0,5156.361,24,1484.891,MORE,-1188,3080,1892,4,1,2,0.187481692,2,-1.222253018,-2.125260472,0.323295501,218,108,110,0,1.156811594,1.092467184,1.170500555,0.800734566,-1.082093274,1.082093274,1.170500555,1.092467184,0,1,0
6286,27,47,31,78,80,0,6440.121,64,1683.017,MORE,-814,3546,2732,4,1,2,0.187481692,2,-1.222253018,-0.011449808,1.077738985,158,78,80,0,-0.039890055,-0.07803337,0,0.800734566,-0.649980005,0.649980005,0,-0.07803337,0,1,0
6287,27,48,58,110,92,0,4220.881,64,1397.671,MORE,-44,1942,1898,4,1,-18,-1.687335229,18,1.571468165,-0.011449808,-0.226469867,202,110,92,1,0.837691154,1.170500555,0.468200222,0.800734566,0.239664962,0.239664962,0.468200222,1.170500555,1,1,1
6288,27,49,12,50,48,0,4035.792,54,1520.808,MORE,-298,2034,1736,4,1,-2,-0.187481692,2,-1.222253018,-0.539902474,-0.335243462,98,50,48,1,-1.236591704,-1.170500555,-1.248533925,0.800734566,-0.053802338,0.053802338,-1.248533925,-1.170500555,0,1,0
6289,27,50,54,110,101,0,3726.873,64,1725.974,MORE,-1032,2282,1250,2,1,-9,-0.843667615,9,0,-0.011449808,-0.5167898,211,110,101,1,1.017196402,1.170500555,0.819350388,-0.848847373,-0.901853515,0.901853515,0.819350388,1.170500555,0,0,0
6290,27,51,14,46,50,0,3927.085,74,2235.898,MORE,-438,2118,1680,4,1,4,0.374963384,4,-0.87303787,0.517002858,-0.39912868,96,46,50,0,-1.276481759,-1.326567295,-1.170500555,0.800734566,-0.215555969,0.215555969,-1.170500555,-1.326567295,1,1,0
6291,27,52,22,80,83,0,6430.405,44,2253.509,MORE,-1066,3766,2700,6,1,3,0.281222538,3,-1.047645444,-1.06835514,1.07202906,163,80,83,0,0.059835082,0,0.117050055,2.450316505,-0.941136539,0.941136539,0.117050055,0,0,1,0
6292,27,53,6,50,56,0,3712.042,94,1621.451,MORE,-1722,2702,980,2,2,6,0.562445076,6,-0.523822722,1.57390819,-0.525505721,106,50,56,0,-1.077031484,-1.170500555,-0.936400444,-0.848847373,-1.699067836,1.699067836,-0.936400444,-1.170500555,1,0,0
6293,27,54,13,50,47,1,7043.878,14,1298.954,MORE,-260,3762,3502,5,1,-3,-0.281222538,3,-1.047645444,-2.653713138,1.432556501,97,50,47,1,-1.256536731,-1.170500555,-1.28755061,1.625525535,-0.009897782,0.009897782,-1.28755061,-1.170500555,0,1,1
6294,27,55,46,110,124,1,3192.733,84,1806.809,MORE,710,1476,2186,1,2,14,1.312371845,14,0.87303787,1.045455524,-0.830694612,234,110,124,0,1.475932034,1.170500555,1.716734147,-1.673638342,1.1108238,1.1108238,1.716734147,1.170500555,1,0,1
6295,27,56,27,91,80,1,7772.035,4,1778.322,MORE,-2246,5078,2832,5,1,-11,-1.031149307,11,0.349215148,-3.182165804,1.860481738,171,91,80,1,0.219395302,0.429183537,0,1.625525535,-2.304488567,2.304488567,0,0.429183537,0,1,0
6296,27,57,40,64,80,1,4538.813,64,2028.574,MORE,8,2060,2068,2,2,16,1.499853537,16,1.222253018,-0.011449808,-0.039626746,144,64,80,0,-0.31912044,-0.624266962,0,-0.848847373,0.299744882,0.299744882,0,-0.624266962,0,0,1
6297,27,58,22,83,80,1,4973.142,64,2238.83,MORE,14,2362,2376,3,2,-3,-0.281222538,3,-1.047645444,-0.011449808,0.215620873,163,83,80,1,0.059835082,0.117050055,0,-0.024056403,0.306677181,0.306677181,0,0.117050055,0,0,1
6298,27,59,54,101,110,1,7627.573,74,2506.977,MORE,-92,3696,3604,5,1,9,0.843667615,9,0,0.517002858,1.775583927,211,101,110,0,1.017196402,0.819350388,1.170500555,1.625525535,0.184206575,0.184206575,1.170500555,0.819350388,1,1,1
6299,27,60,6,56,50,1,8058.478,54,1476.098,MORE,276,3566,3842,5,2,-6,-0.562445076,6,-0.523822722,-0.539902474,2.028819321,106,56,50,1,-1.077031484,-0.936400444,-1.170500555,1.625525535,0.609387546,0.609387546,-1.170500555,-0.936400444,0,1,1
6300,27,61,18,50,42,0,4196.297,44,2574.369,MORE,176,2048,2224,4,1,-8,-0.749926769,8,-0.174607574,-1.06835514,-0.240917458,92,50,42,1,-1.356261869,-1.170500555,-1.482634036,0.800734566,0.493849239,0.493849239,-1.482634036,-1.170500555,0,1,1
6301,27,62,43,110,117,1,8401.134,34,2081.757,MORE,322,3848,4170,7,2,7,0.656185922,7,-0.349215148,-1.596807806,2.230192308,227,110,117,0,1.336316841,1.170500555,1.443617351,3.275107474,0.662535167,0.662535167,1.443617351,1.170500555,0,1,1
6302,27,63,32,77,80,0,7273.249,54,1431.306,MORE,-1028,3710,2682,4,1,3,0.281222538,3,-1.047645444,-0.539902474,1.567353858,157,77,80,0,-0.059835082,-0.117050055,0,0.800734566,-0.897231983,0.897231983,0,-0.117050055,0,1,0
6303,27,64,27,80,91,1,5805.11,74,1301.04,MORE,-572,3082,2510,3,2,11,1.031149307,11,0.349215148,0.517002858,0.704554035,171,80,91,0,0.219395302,0,0.429183537,-0.024056403,-0.370377301,0.370377301,0.429183537,0,1,1,0
6304,27,65,16,44,50,1,6627.435,64,1785.149,MORE,918,2602,3520,5,1,6,0.562445076,6,-0.523822722,-0.011449808,1.187820173,94,44,50,0,-1.316371814,-1.404600665,-1.170500555,1.625525535,1.35114348,1.35114348,-1.170500555,-1.404600665,0,1,1
6305,27,66,7,50,57,0,5796.05,44,1672.248,MORE,-1182,3512,2330,4,1,7,0.656185922,7,-0.349215148,-1.06835514,0.69922963,107,50,57,0,-1.057086457,-1.170500555,-0.897383758,0.800734566,-1.075160976,1.075160976,-0.897383758,-1.170500555,0,1,0
6306,27,67,14,50,46,0,5306.809,74,1503.534,MORE,492,2502,2994,4,2,-4,-0.374963384,4,-0.87303787,0.517002858,0.411711181,96,50,46,1,-1.276481759,-1.170500555,-1.326567295,0.800734566,0.85895029,0.85895029,-1.326567295,-1.170500555,1,1,1
6307,27,68,51,110,108,0,6284.747,74,1810.549,MORE,180,2936,3116,4,2,-2,-0.187481692,2,-1.222253018,0.517002858,0.98642838,218,110,108,1,1.156811594,1.170500555,1.092467184,0.800734566,0.498470771,0.498470771,1.092467184,1.170500555,1,1,1
6308,27,69,50,133,110,1,5995.246,64,1624.388,MORE,1954,1756,3710,4,2,-23,-2.15603946,23,2.444506035,-0.011449808,0.816293664,243,133,110,1,1.655437281,2.067884313,1.170500555,0.800734566,2.548120344,2.548120344,1.170500555,2.067884313,0,1,1
6309,27,70,49,131,110,1,6570.651,54,1608.285,MORE,304,2718,3022,5,2,-21,-1.968557767,21,2.095290887,-0.539902474,1.154449201,241,131,110,1,1.615547226,1.989850943,1.170500555,1.625525535,0.641738272,0.641738272,1.170500555,1.989850943,0,1,1
6310,27,71,47,126,110,0,3542.327,54,2498.294,MORE,-482,1820,1338,2,1,-16,-1.499853537,16,1.222253018,-0.539902474,-0.625244283,236,126,110,1,1.515822089,1.794767517,1.170500555,-0.848847373,-0.266392824,0.266392824,1.170500555,1.794767517,0,0,0
6311,27,72,50,110,133,0,4593.874,54,1668.452,MORE,-1320,2844,1524,4,1,23,2.15603946,23,2.444506035,-0.539902474,-0.007268351,243,110,133,0,1.655437281,1.170500555,2.067884313,0.800734566,-1.23460384,1.23460384,2.067884313,1.170500555,0,1,0
6312,27,73,47,110,126,1,8201.263,74,1255.722,MORE,294,2820,3114,4,2,16,1.499853537,16,1.222253018,0.517002858,2.112731588,236,110,126,0,1.515822089,1.170500555,1.794767517,0.800734566,0.630184441,0.630184441,1.794767517,1.170500555,1,1,1
6313,27,74,12,48,50,1,2960.969,74,1227.455,MORE,378,1224,1602,3,2,2,0.187481692,2,-1.222253018,0.517002858,-0.966898295,98,48,50,0,-1.236591704,-1.248533925,-1.170500555,-0.024056403,0.72723662,0.72723662,-1.170500555,-1.248533925,1,1,1
6314,27,75,32,80,77,0,5422.187,54,1647.024,MORE,44,2446,2490,4,1,-3,-0.281222538,3,-1.047645444,-0.539902474,0.47951683,157,80,77,1,-0.059835082,0,-0.117050055,0.800734566,0.341338673,0.341338673,-0.117050055,0,0,1,1
6315,27,76,43,117,110,0,6118.182,44,1355.009,MORE,-312,2826,2514,4,1,-7,-0.656185922,7,-0.349215148,-1.06835514,0.888541019,227,117,110,1,1.336316841,1.443617351,1.170500555,0.800734566,-0.069977702,0.069977702,1.170500555,1.443617351,0,1,0
6316,27,77,40,80,64,1,4753.687,44,1644.473,MORE,-124,2118,1994,3,2,-16,-1.499853537,16,1.222253018,-1.06835514,0.086650977,144,80,64,1,-0.31912044,0,-0.624266962,-0.024056403,0.147234316,0.147234316,-0.624266962,0,0,1,1
6317,27,78,31,80,78,1,6103.596,74,1481.712,MORE,-20,2932,2912,5,2,-2,-0.187481692,2,-1.222253018,0.517002858,0.87996908,158,80,78,1,-0.039890055,0,-0.07803337,1.625525535,0.267394156,0.267394156,-0.07803337,0,1,1,1
6318,27,79,46,124,110,1,3166.2,94,1454.873,MORE,1118,1080,2198,3,2,-14,-1.312371845,14,0.87303787,1.57390819,-0.846287596,234,124,110,1,1.475932034,1.716734147,1.170500555,-0.024056403,1.582220094,1.582220094,1.170500555,1.716734147,1,1,1
6319,27,80,58,92,110,1,2077.775,94,2091.151,MORE,-8,1472,1464,1,2,18,1.687335229,18,1.571468165,1.57390819,-1.485936088,202,92,110,0,0.837691154,0.468200222,1.170500555,-1.673638342,0.281258753,0.281258753,1.170500555,0.468200222,1,0,1
6320,27,81,48,128,110,1,4239.498,54,2052.26,LESS,762,1612,2374,2,2,-18,-1.687335229,18,1.571468165,-0.539902474,-0.215528979,238,128,110,0,1.555712144,1.872800887,1.170500555,-0.848847373,1.17090372,1.17090372,1.170500555,1.872800887,0,0,1
6321,27,82,8,50,58,0,4625.924,94,1012.787,LESS,-956,2732,1776,4,2,8,0.749926769,8,-0.174607574,1.57390819,0.011566878,108,50,58,1,-1.037141429,-1.170500555,-0.858367073,0.800734566,-0.814044401,0.814044401,-0.858367073,-1.170500555,1,1,0
6322,27,83,4,54,50,1,4072.04,84,1615.845,LESS,408,1736,2144,2,1,-4,-0.374963384,4,-0.87303787,1.045455524,-0.313941141,104,54,50,0,-1.116921539,-1.014433814,-1.170500555,-0.848847373,0.761898112,0.761898112,-1.170500555,-1.014433814,1,0,1
6323,27,84,37,80,69,1,4906.705,64,1320.877,LESS,714,2036,2750,3,2,-11,-1.031149307,11,0.349215148,-0.011449808,0.176577001,149,80,69,0,-0.219395302,0,-0.429183537,-0.024056403,1.115445333,1.115445333,-0.429183537,0,1,0,1
6324,27,85,52,105,110,0,4292.288,84,1665.252,LESS,-364,2264,1900,4,2,5,0.46870423,5,-0.698430296,1.045455524,-0.184505212,215,105,110,1,1.096976512,0.975417129,1.170500555,0.800734566,-0.130057621,0.130057621,1.170500555,0.975417129,1,1,0
6325,27,86,5,55,50,0,5769.833,44,1489.222,LESS,-1172,3468,2296,4,1,-5,-0.46870423,5,-0.698430296,-1.06835514,0.683822354,105,55,50,0,-1.096976512,-0.975417129,-1.170500555,0.800734566,-1.063607145,1.063607145,-1.170500555,-0.975417129,0,1,0
6326,27,87,30,96,80,0,4733.591,64,1325.629,LESS,-1672,3030,1358,4,1,-16,-1.499853537,16,1.222253018,-0.011449808,0.074840906,176,96,80,0,0.31912044,0.624266962,0,0.800734566,-1.641298682,1.641298682,0,0.624266962,1,1,0
6327,27,88,33,80,75,0,6157.984,54,1498.239,LESS,-1516,3832,2316,4,1,-5,-0.46870423,5,-0.698430296,-0.539902474,0.911931964,155,80,75,0,-0.099725137,0,-0.195083426,0.800734566,-1.461058923,1.461058923,-0.195083426,0,0,1,0
6328,27,89,48,110,128,0,4234.539,54,1286.187,LESS,-1446,2822,1376,2,1,18,1.687335229,18,1.571468165,-0.539902474,-0.218443298,238,110,128,1,1.555712144,1.170500555,1.872800887,-0.848847373,-1.380182108,1.380182108,1.872800887,1.170500555,0,0,0
6329,27,90,9,59,50,1,3630.714,84,1340.663,LESS,1066,1034,2100,3,1,-9,-0.843667615,9,0,1.045455524,-0.573300776,109,59,50,0,-1.017196402,-0.819350388,-1.170500555,-0.024056403,1.522140175,1.522140175,-1.170500555,-0.819350388,1,1,1
6330,27,91,44,110,119,1,6557.871,74,1608.854,LESS,808,2730,3538,3,2,9,0.843667615,9,0,0.517002858,1.146938617,229,110,119,1,1.376206896,1.170500555,1.521650721,-0.024056403,1.224051342,1.224051342,1.521650721,1.170500555,1,1,1
6331,27,92,2,52,50,0,5309.828,74,1915.119,LESS,-846,3046,2200,4,1,-2,-0.187481692,2,-1.222253018,0.517002858,0.413485395,102,52,50,0,-1.156811594,-1.092467184,-1.170500555,0.800734566,-0.686952263,0.686952263,-1.170500555,-1.092467184,1,1,0
6332,27,93,8,58,50,1,4604.851,44,1799.499,LESS,-984,2866,1882,3,1,-8,-0.749926769,8,-0.174607574,-1.06835514,-0.000817359,108,58,50,0,-1.037141429,-0.858367073,-1.170500555,-0.024056403,-0.846395127,0.846395127,-1.170500555,-0.858367073,0,1,0
6333,27,94,44,119,110,1,5040.161,54,1553.737,LESS,1172,2022,3194,3,2,-9,-0.843667615,9,0,-0.539902474,0.255006777,229,119,110,0,1.376206896,1.521650721,1.170500555,-0.024056403,1.64461078,1.64461078,1.170500555,1.521650721,0,1,1
6334,27,95,34,74,80,0,5441.323,54,1414.341,LESS,-478,2820,2342,4,1,6,0.562445076,6,-0.523822722,-0.539902474,0.490762726,154,74,80,1,-0.119670165,-0.234100111,0,0.800734566,-0.261771292,0.261771292,0,-0.234100111,0,1,0
6335,27,96,24,86,80,1,5291.478,44,1132.285,LESS,-186,2460,2274,3,2,-6,-0.562445076,6,-0.523822722,-1.06835514,0.402701419,166,86,80,0,0.119670165,0.234100111,0,-0.024056403,0.075600566,0.075600566,0,0.234100111,0,1,1
6336,27,97,39,66,80,0,4339.131,54,1691.366,LESS,-42,2304,2262,4,2,14,1.312371845,14,0.87303787,-0.539902474,-0.156976394,146,66,80,1,-0.279230385,-0.546233592,0,0.800734566,0.241975728,0.241975728,0,-0.546233592,0,1,1
6337,27,98,9,50,59,0,3678.944,54,1990.919,LESS,-1588,2822,1234,2,1,9,0.843667615,9,0,-0.539902474,-0.544956841,109,50,59,1,-1.017196402,-1.170500555,-0.819350388,-0.848847373,-1.544246504,1.544246504,-0.819350388,-1.170500555,0,0,0
6338,27,99,57,94,110,0,5376.17,24,1683.113,LESS,-1414,3248,1834,4,1,16,1.499853537,16,1.222253018,-2.125260472,0.452473438,204,94,110,1,0.877581209,0.546233592,1.170500555,0.800734566,-1.343209849,1.343209849,1.170500555,0.546233592,0,1,0
6339,27,100,60,110,87,1,2604.992,94,1726.885,LESS,412,1248,1660,1,2,-23,-2.15603946,23,2.444506035,1.57390819,-1.176099803,197,110,87,0,0.737966017,1.170500555,0.273116796,-1.673638342,0.766519644,0.766519644,0.273116796,1.170500555,1,0,1
6340,27,101,33,75,80,1,5154.389,64,1505.261,LESS,832,1648,2480,2,1,5,0.46870423,5,-0.698430296,-0.011449808,0.322136591,155,75,80,1,-0.099725137,-0.195083426,0,-0.848847373,1.251780535,1.251780535,0,-0.195083426,1,0,1
6341,27,102,15,50,45,1,5868.849,94,2308.107,LESS,-40,3116,3076,4,2,-5,-0.46870423,5,-0.698430296,1.57390819,0.74201234,95,50,45,0,-1.296426786,-1.170500555,-1.36558398,0.800734566,0.244286495,0.244286495,-1.36558398,-1.170500555,1,1,1
6342,27,103,59,89,110,0,5130.935,54,1365.625,LESS,-1220,2902,1682,2,1,21,1.968557767,21,2.095290887,-0.539902474,0.308353082,199,89,110,1,0.777856072,0.351150166,1.170500555,-0.848847373,-1.119065533,1.119065533,1.170500555,0.351150166,0,0,0
6343,27,104,29,80,94,0,5026.089,74,1470.591,LESS,-340,2536,2196,1,1,14,1.312371845,14,0.87303787,0.517002858,0.246736907,174,80,94,1,0.279230385,0,0.546233592,-1.673638342,-0.102328428,0.102328428,0.546233592,0,1,0,0
6344,27,105,55,110,98,0,6148.575,64,2120.34,LESS,272,3130,3402,5,2,-12,-1.124890153,12,0.523822722,-0.011449808,0.906402458,208,110,98,0,0.957361319,1.170500555,0.702300333,1.625525535,0.604766014,0.604766014,0.702300333,1.170500555,0,1,1
6345,27,106,29,94,80,1,5467.923,44,2086.919,LESS,-310,2716,2406,3,1,-14,-1.312371845,14,0.87303787,-1.06835514,0.506395084,174,94,80,0,0.279230385,0.546233592,0,-0.024056403,-0.067666935,0.067666935,0,0.546233592,0,0,0
6346,27,107,57,110,94,1,4826.534,94,1436.001,LESS,860,2228,3088,3,2,-16,-1.499853537,16,1.222253018,1.57390819,0.129461895,204,110,94,0,0.877581209,1.170500555,0.546233592,-0.024056403,1.284131261,1.284131261,0.546233592,1.170500555,1,0,1
6347,27,108,39,80,66,1,5872.719,84,1256.41,LESS,-234,3308,3074,3,2,-14,-1.312371845,14,0.87303787,1.045455524,0.744286672,146,80,66,0,-0.279230385,0,-0.546233592,-0.024056403,0.020142178,0.020142178,-0.546233592,0,1,0,0
6348,27,109,4,50,54,0,6741.633,74,1637.813,LESS,-1292,3706,2414,4,1,4,0.374963384,4,-0.87303787,0.517002858,1.254932357,104,50,54,1,-1.116921539,-1.170500555,-1.014433814,0.800734566,-1.202253114,1.202253114,-1.014433814,-1.170500555,1,1,0
6349,27,110,55,98,110,0,7723.039,64,2769.731,LESS,-738,4364,3626,4,2,12,1.124890153,12,0.523822722,-0.011449808,1.831687639,208,98,110,1,0.957361319,0.702300333,1.170500555,0.800734566,-0.562170891,0.562170891,1.170500555,0.702300333,0,1,0
6350,27,111,2,50,52,1,6462.609,64,1545.205,LESS,-516,3194,2678,5,2,2,0.187481692,2,-1.222253018,-0.011449808,1.090954792,102,50,52,1,-1.156811594,-1.170500555,-1.092467184,1.625525535,-0.305675849,0.305675849,-1.092467184,-1.170500555,0,1,0
6351,27,112,59,110,89,0,3577.235,84,1395.313,LESS,-438,1840,1402,2,2,-21,-1.968557767,21,2.095290887,1.045455524,-0.604729457,199,110,89,0,0.777856072,1.170500555,0.351150166,-0.848847373,-0.215555969,0.215555969,0.351150166,1.170500555,1,0,0
6352,27,113,60,87,110,1,8134.953,54,1298.109,LESS,232,3568,3800,4,1,23,2.15603946,23,2.444506035,-0.539902474,2.073762352,197,87,110,1,0.737966017,0.273116796,1.170500555,0.800734566,0.558550691,0.558550691,1.170500555,0.273116796,0,1,1
6353,27,114,52,110,105,0,8271.287,24,1833.789,LESS,-190,2770,2580,4,1,-5,-0.46870423,5,-0.698430296,-2.125260472,2.153883479,215,110,105,0,1.096976512,1.170500555,0.975417129,0.800734566,0.070979034,0.070979034,0.975417129,1.170500555,0,1,0
6354,27,115,30,80,96,0,5890.257,74,1544.888,LESS,0,2734,2734,6,1,16,1.499853537,16,1.222253018,0.517002858,0.75459345,176,80,96,1,0.31912044,0,0.624266962,2.450316505,0.290501818,0.290501818,0.624266962,0,1,1,1
6355,27,116,24,80,86,1,6681.145,44,2163.726,LESS,-756,3836,3080,6,1,6,0.562445076,6,-0.523822722,-1.06835514,1.219384609,166,80,86,1,0.119670165,0,0.234100111,2.450316505,-0.582967786,0.582967786,0.234100111,0,0,1,0
6356,27,117,5,50,55,1,3931.176,24,1339.532,LESS,-352,2050,1698,3,1,5,0.46870423,5,-0.698430296,-2.125260472,-0.39672447,105,50,55,1,-1.096976512,-1.170500555,-0.975417129,-0.024056403,-0.116193024,0.116193024,-0.975417129,-1.170500555,0,0,0
6357,27,118,34,80,74,1,5814.201,74,2043.1,LESS,376,2410,2786,3,2,-6,-0.562445076,6,-0.523822722,0.517002858,0.709896658,154,80,74,0,-0.119670165,0,-0.234100111,-0.024056403,0.724925853,0.724925853,-0.234100111,0,1,0,1
6358,27,119,15,45,50,1,3750.232,84,1947.713,LESS,876,1476,2352,3,2,5,0.46870423,5,-0.698430296,1.045455524,-0.50306212,95,45,50,1,-1.296426786,-1.36558398,-1.170500555,-0.024056403,1.302617391,1.302617391,-1.170500555,-1.36558398,1,0,1
6359,27,120,37,69,80,0,6426.749,54,1638.576,LESS,-876,3446,2570,4,1,11,1.031149307,11,0.349215148,-0.539902474,1.069880492,149,69,80,1,-0.219395302,-0.429183537,0,0.800734566,-0.721613755,0.721613755,0,-0.429183537,0,1,0
6360,27,121,48,128,110,0,2793.149,84,1264.338,MORE,-610,1462,852,2,1,-18,-1.687335229,18,1.571468165,1.045455524,-1.065523198,238,128,110,1,1.555712144,1.872800887,1.170500555,-0.848847373,-0.414281858,0.414281858,1.170500555,1.872800887,1,0,0
6361,27,122,8,50,58,1,1761.971,94,878.846,MORE,598,816,1414,1,2,8,0.749926769,8,-0.174607574,1.57390819,-1.671528621,108,50,58,0,-1.037141429,-1.170500555,-0.858367073,-1.673638342,0.981420896,0.981420896,-0.858367073,-1.170500555,1,0,1
6362,27,123,4,54,50,0,2598.195,74,1378.242,MORE,-738,1690,952,2,1,-4,-0.374963384,4,-0.87303787,0.517002858,-1.180094282,104,54,50,1,-1.116921539,-1.014433814,-1.170500555,-0.848847373,-0.562170891,0.562170891,-1.170500555,-1.014433814,1,0,0
6363,27,124,37,80,69,1,1883.892,84,1800.104,MORE,-300,1286,986,2,1,-11,-1.031149307,11,0.349215148,1.045455524,-1.599877764,149,80,69,1,-0.219395302,0,-0.429183537,-0.848847373,-0.056113105,0.056113105,-0.429183537,0,1,0,0
6364,27,125,52,105,110,1,3591.919,94,1535,MORE,238,1712,1950,3,2,5,0.46870423,5,-0.698430296,1.57390819,-0.596099924,215,105,110,0,1.096976512,0.975417129,1.170500555,-0.024056403,0.565482989,0.565482989,1.170500555,0.975417129,1,0,1
6365,27,126,5,55,50,0,2259.483,84,1258.268,MORE,-382,1302,920,2,1,-5,-0.46870423,5,-0.698430296,1.045455524,-1.379149449,105,55,50,1,-1.096976512,-0.975417129,-1.170500555,-0.848847373,-0.150854517,0.150854517,-1.170500555,-0.975417129,1,0,0
6366,27,127,30,96,80,0,1895.624,84,1524.148,MORE,-392,1218,826,2,2,-16,-1.499853537,16,1.222253018,1.045455524,-1.592983071,176,96,80,1,0.31912044,0.624266962,0,-0.848847373,-0.162408347,0.162408347,0,0.624266962,1,0,0
6367,27,128,33,80,75,0,2325.33,74,1205.666,MORE,-556,1430,874,2,1,-5,-0.46870423,5,-0.698430296,0.517002858,-1.340452309,155,80,75,1,-0.099725137,0,-0.195083426,-0.848847373,-0.351891172,0.351891172,-0.195083426,0,1,0,0
6368,27,129,48,110,128,1,1899.811,84,1436.09,MORE,152,792,944,1,2,18,1.687335229,18,1.571468165,1.045455524,-1.590522444,238,110,128,0,1.555712144,1.170500555,1.872800887,-1.673638342,0.466120045,0.466120045,1.872800887,1.170500555,1,0,1
6369,27,130,9,59,50,0,2326.667,64,1837.218,MORE,-1612,2222,610,2,1,-9,-0.843667615,9,0,-0.011449808,-1.339666577,109,59,50,1,-1.017196402,-0.819350388,-1.170500555,-0.848847373,-1.571975698,1.571975698,-1.170500555,-0.819350388,0,0,0
6370,27,131,44,110,119,1,1969.001,54,1610.737,MORE,430,784,1214,1,1,9,0.843667615,9,0,-0.539902474,-1.549860681,229,110,119,0,1.376206896,1.170500555,1.521650721,-1.673638342,0.787316539,0.787316539,1.521650721,1.170500555,0,0,1
6371,27,132,2,52,50,0,2065.614,64,1332.374,MORE,-740,1388,648,2,1,-2,-0.187481692,2,-1.222253018,-0.011449808,-1.493082897,102,52,50,1,-1.156811594,-1.092467184,-1.170500555,-0.848847373,-0.564481657,0.564481657,-1.170500555,-1.092467184,0,0,0
6372,27,133,8,58,50,0,2554.223,44,1364.482,MORE,-648,1550,902,1,1,-8,-0.749926769,8,-0.174607574,-1.06835514,-1.205935863,108,58,50,1,-1.037141429,-0.858367073,-1.170500555,-1.673638342,-0.458186414,0.458186414,-1.170500555,-0.858367073,0,0,0
6373,27,134,44,119,110,0,2516.719,54,1229.33,MORE,-1194,1876,682,2,1,-9,-0.843667615,9,0,-0.539902474,-1.227976313,229,119,110,1,1.376206896,1.521650721,1.170500555,-0.848847373,-1.089025573,1.089025573,1.170500555,1.521650721,0,0,0
6374,27,135,34,74,80,1,1687.995,64,2107.613,MORE,-590,1306,716,1,1,6,0.562445076,6,-0.523822722,-0.011449808,-1.715003033,154,74,80,0,-0.119670165,-0.234100111,0,-1.673638342,-0.391174196,0.391174196,0,-0.234100111,0,0,0
6375,27,136,24,86,80,0,4735.542,64,1709.612,MORE,-1306,3046,1740,4,1,-6,-0.562445076,6,-0.523822722,-0.011449808,0.075987475,166,86,80,1,0.119670165,0.234100111,0,0.800734566,-1.218428477,1.218428477,0,0.234100111,0,1,0
6376,27,137,39,66,80,0,1879.412,84,1041.983,MORE,-428,1388,960,2,1,14,1.312371845,14,0.87303787,1.045455524,-1.602510582,146,66,80,0,-0.279230385,-0.546233592,0,-0.848847373,-0.204002138,0.204002138,0,-0.546233592,1,0,0
6377,27,138,9,50,59,1,1839.355,74,1426.639,MORE,4,808,812,1,1,9,0.843667615,9,0,0.517002858,-1.626051386,109,50,59,0,-1.017196402,-1.170500555,-0.819350388,-1.673638342,0.29512335,0.29512335,-0.819350388,-1.170500555,1,0,1
6378,27,139,57,94,110,1,1714.704,94,933.895,MORE,108,780,888,1,2,16,1.499853537,16,1.222253018,1.57390819,-1.699306617,204,94,110,0,0.877581209,0.546233592,1.170500555,-1.673638342,0.41528319,0.41528319,1.170500555,0.546233592,1,0,1
6379,27,140,60,110,87,0,2315.388,84,1485.057,MORE,-554,1694,1140,2,2,-23,-2.15603946,23,2.444506035,1.045455524,-1.34629505,197,110,87,1,0.737966017,1.170500555,0.273116796,-0.848847373,-0.349580405,0.349580405,0.273116796,1.170500555,1,0,0
6380,27,141,33,75,80,1,3015.833,74,1162.931,MORE,34,1446,1480,3,2,5,0.46870423,5,-0.698430296,0.517002858,-0.934655674,155,75,80,0,-0.099725137,-0.195083426,0,-0.024056403,0.329784842,0.329784842,0,-0.195083426,1,1,1
6381,27,142,15,50,45,0,2288.812,84,1820.057,MORE,-684,1658,974,2,1,-5,-0.46870423,5,-0.698430296,1.045455524,-1.361913304,95,50,45,1,-1.296426786,-1.170500555,-1.36558398,-0.848847373,-0.499780205,0.499780205,-1.36558398,-1.170500555,1,0,0
6382,27,143,59,89,110,1,1425.488,64,1285.658,MORE,408,648,1056,2,1,21,1.968557767,21,2.095290887,-0.011449808,-1.869273843,199,89,110,0,0.777856072,0.351150166,1.170500555,-0.848847373,0.761898112,0.761898112,1.170500555,0.351150166,0,0,1
6383,27,144,29,80,94,1,3827.167,84,1420.756,MORE,-198,1888,1690,3,2,14,1.312371845,14,0.87303787,1.045455524,-0.457848756,174,80,94,0,0.279230385,0,0.546233592,-0.024056403,0.061735969,0.061735969,0.546233592,0,1,1,1
6384,27,145,55,110,98,0,3103.408,100,1741.057,MORE,-54,1822,1768,2,2,-12,-1.124890153,12,0.523822722,1.89097979,-0.883189365,208,110,98,1,0.957361319,1.170500555,0.702300333,-0.848847373,0.228111132,0.228111132,0.702300333,1.170500555,1,0,1
6385,27,146,29,94,80,0,3757.802,74,1467.173,MORE,-1486,2560,1074,1,1,-14,-1.312371845,14,0.87303787,0.517002858,-0.498613363,174,94,80,1,0.279230385,0.546233592,0,-1.673638342,-1.426397431,1.426397431,0,0.546233592,1,0,0
6386,27,147,57,110,94,1,4216.771,94,1462.345,MORE,158,2144,2302,3,2,-16,-1.499853537,16,1.222253018,1.57390819,-0.228885243,204,110,94,1,0.877581209,1.170500555,0.546233592,-0.024056403,0.473052343,0.473052343,0.546233592,1.170500555,1,1,1
6387,27,148,39,80,66,0,2605.559,44,1840.543,MORE,-688,1648,960,2,1,-14,-1.312371845,14,0.87303787,-1.06835514,-1.175766587,146,80,66,1,-0.279230385,0,-0.546233592,-0.848847373,-0.504401737,0.504401737,-0.546233592,0,0,0,0
6388,27,149,4,50,54,0,3330.238,74,1758.255,MORE,-1122,2232,1110,3,1,4,0.374963384,4,-0.87303787,0.517002858,-0.749885309,104,50,54,0,-1.116921539,-1.170500555,-1.014433814,-0.024056403,-1.005837992,1.005837992,-1.014433814,-1.170500555,1,1,0
6389,27,150,55,98,110,1,3604.612,84,1623.022,MORE,306,1518,1824,3,2,12,1.124890153,12,0.523822722,1.045455524,-0.588640468,208,98,110,0,0.957361319,0.702300333,1.170500555,-0.024056403,0.644049038,0.644049038,1.170500555,0.702300333,1,1,1
6390,27,151,2,50,52,1,4480.564,84,1763.924,MORE,574,2010,2584,3,2,2,0.187481692,2,-1.222253018,1.045455524,-0.073858673,102,50,52,0,-1.156811594,-1.170500555,-1.092467184,-0.024056403,0.953691702,0.953691702,-1.092467184,-1.170500555,1,1,1
6391,27,152,59,110,89,0,2731.316,54,2472.92,MORE,-1426,2134,708,2,1,-21,-1.968557767,21,2.095290887,-0.539902474,-1.101861379,199,110,89,1,0.777856072,1.170500555,0.351150166,-0.848847373,-1.357074446,1.357074446,0.351150166,1.170500555,0,0,0
6392,27,153,60,87,110,1,3602.432,44,1239.614,MORE,904,1206,2110,3,2,23,2.15603946,23,2.444506035,-1.06835514,-0.589921617,197,87,110,0,0.737966017,0.273116796,1.170500555,-0.024056403,1.334968117,1.334968117,1.170500555,0.273116796,0,1,1
6393,27,154,52,110,105,1,3767.766,74,1670.378,MORE,-342,2150,1808,3,1,-5,-0.46870423,5,-0.698430296,0.517002858,-0.492757693,215,110,105,1,1.096976512,1.170500555,0.975417129,-0.024056403,-0.104639194,0.104639194,0.975417129,1.170500555,1,1,0
6394,27,155,30,80,96,1,5021.591,64,1690.826,MORE,-64,2510,2446,3,2,16,1.499853537,16,1.222253018,-0.011449808,0.24409351,176,80,96,0,0.31912044,0,0.624266962,-0.024056403,0.216557301,0.216557301,0.624266962,0,0,1,1
6395,27,156,24,80,86,1,5970.427,74,2131.628,MORE,532,2536,3068,3,1,6,0.562445076,6,-0.523822722,0.517002858,0.801707968,166,80,86,0,0.119670165,0,0.234100111,-0.024056403,0.905165613,0.905165613,0.234100111,0,1,1,1
6396,27,157,5,50,55,1,3998.942,44,1739.099,MORE,-458,2328,1870,3,1,5,0.46870423,5,-0.698430296,-1.06835514,-0.356899568,105,50,55,0,-1.096976512,-1.170500555,-0.975417129,-0.024056403,-0.23866363,0.23866363,-0.975417129,-1.170500555,0,0,0
6397,27,158,34,80,74,0,4672.95,54,2318.937,MORE,-1448,3324,1876,4,1,-6,-0.562445076,6,-0.523822722,-0.539902474,0.039203242,154,80,74,1,-0.119670165,0,-0.234100111,0.800734566,-1.382492874,1.382492874,-0.234100111,0,0,1,0
6398,27,159,15,45,50,1,4111.842,100,1781.536,MORE,1174,1738,2912,3,2,5,0.46870423,5,-0.698430296,1.89097979,-0.290550196,95,45,50,0,-1.296426786,-1.36558398,-1.170500555,-0.024056403,1.646921547,1.646921547,-1.170500555,-1.36558398,1,0,1
6399,27,160,37,69,80,1,3268.259,84,3051.212,MORE,886,1802,2688,3,2,11,1.031149307,11,0.349215148,1.045455524,-0.786309292,149,69,80,0,-0.219395302,-0.429183537,0,-0.024056403,1.314171221,1.314171221,0,-0.429183537,1,0,1
6400,27,161,3,50,53,1,5299.463,64,1571.952,LESS,952,1856,2808,3,1,3,0.281222538,3,-1.047645444,-0.011449808,0.407394064,103,50,53,1,-1.136866566,-1.170500555,-1.053450499,-0.024056403,1.390426504,1.390426504,-1.053450499,-1.170500555,0,0,1
6401,27,162,20,50,40,1,7262.565,44,1410.611,LESS,-182,3246,3064,1,1,-10,-0.937408461,10,0.174607574,-1.06835514,1.561075057,90,50,40,0,-1.396151924,-1.170500555,-1.560667406,-1.673638342,0.080222098,0.080222098,-1.560667406,-1.170500555,0,0,1
6402,27,163,25,80,88,0,2547.739,94,1203.915,LESS,-370,1806,1436,2,2,8,0.749926769,8,-0.174607574,1.57390819,-1.209746398,168,80,88,1,0.15956022,0,0.312133481,-0.848847373,-0.13698992,0.13698992,0.312133481,0,1,0,0
6403,27,164,42,115,110,1,4122.298,54,1856.781,LESS,752,1444,2196,3,2,-5,-0.46870423,5,-0.698430296,-0.539902474,-0.284405386,225,115,110,0,1.296426786,1.36558398,1.170500555,-0.024056403,1.159349889,1.159349889,1.170500555,1.36558398,0,0,1
6404,27,165,53,103,110,0,6899.056,64,1555.791,LESS,-2288,4550,2262,4,2,7,0.656185922,7,-0.349215148,-0.011449808,1.347447123,213,103,110,1,1.057086457,0.897383758,1.170500555,0.800734566,-2.353014656,2.353014656,1.170500555,0.897383758,0,1,0
6405,27,166,26,90,80,1,3600.464,44,1773.586,LESS,-1104,2268,1164,3,1,-10,-0.937408461,10,0.174607574,-1.06835514,-0.591078176,170,90,80,0,0.199450275,0.390166852,0,-0.024056403,-0.985041096,0.985041096,0,0.390166852,0,0,0
6406,27,167,35,80,72,1,4702.821,74,1679.779,LESS,1456,1634,3090,2,2,-8,-0.749926769,8,-0.174607574,0.517002858,0.056757911,152,80,72,0,-0.15956022,0,-0.312133481,-0.848847373,1.972739574,1.972739574,-0.312133481,0,1,0,1
6407,27,168,28,93,80,0,3088.199,64,1768.839,LESS,-1270,2148,878,2,1,-13,-1.218630999,13,0.698430296,-0.011449808,-0.892127431,173,93,80,0,0.259285357,0.507216907,0,-0.848847373,-1.176834687,1.176834687,0,0.507216907,0,0,0
6408,27,169,26,80,90,0,7539.236,74,2026.978,LESS,-1266,4090,2824,4,1,10,0.937408461,10,0.174607574,0.517002858,1.723669804,170,80,90,1,0.199450275,0,0.390166852,0.800734566,-1.172213154,1.172213154,0.390166852,0,1,1,0
6409,27,170,25,88,80,1,4671.322,44,1454.112,LESS,824,1696,2520,3,2,-8,-0.749926769,8,-0.174607574,-1.06835514,0.038246495,168,88,80,0,0.15956022,0.312133481,0,-0.024056403,1.242537471,1.242537471,0,0.312133481,0,0,1
6410,27,171,36,80,70,1,5220.196,74,2876.902,LESS,1046,1864,2910,3,2,-10,-0.937408461,10,0.174607574,0.517002858,0.360810224,150,80,70,0,-0.199450275,0,-0.390166852,-0.024056403,1.499032513,1.499032513,-0.390166852,0,1,0,1
6411,27,172,28,80,93,0,6322.466,44,1834.326,LESS,-1238,3840,2602,4,1,13,1.218630999,13,0.698430296,-1.06835514,1.008595182,173,80,93,1,0.259285357,0,0.507216907,0.800734566,-1.139862428,1.139862428,0.507216907,0,0,1,0
6412,27,173,21,82,80,1,5002.961,84,1441.11,LESS,-280,2312,2032,3,2,-2,-0.187481692,2,-1.222253018,1.045455524,0.233144982,162,82,80,0,0.039890055,0.07803337,0,-0.024056403,-0.033005443,0.033005443,0,0.07803337,1,0,0
6413,27,174,19,50,41,1,4142.707,94,1301.212,LESS,352,1798,2150,3,2,-9,-0.843667615,9,0,1.57390819,-0.272411371,91,50,41,0,-1.376206896,-1.170500555,-1.521650721,-0.024056403,0.69719666,0.69719666,-1.521650721,-1.170500555,1,0,1
6414,27,175,56,96,110,0,3767.635,74,1460.72,LESS,-288,2010,1722,2,1,14,1.312371845,14,0.87303787,0.517002858,-0.492834679,206,96,110,1,0.917471264,0.624266962,1.170500555,-0.848847373,-0.042248508,0.042248508,1.170500555,0.624266962,1,0,0
6415,27,176,23,80,85,1,6446.426,64,2015.498,LESS,-778,3552,2774,3,1,5,0.46870423,5,-0.698430296,-0.011449808,1.081444324,165,80,85,1,0.099725137,0,0.195083426,-0.024056403,-0.608386214,0.608386214,0.195083426,0,1,0,0
6416,27,177,10,60,50,1,2007.432,64,1888.864,LESS,220,1226,1446,2,1,-10,-0.937408461,10,0.174607574,-0.011449808,-1.527275449,110,60,50,0,-0.997251374,-0.780333703,-1.170500555,-0.848847373,0.544686094,0.544686094,-1.170500555,-0.780333703,1,0,1
6417,27,178,19,41,50,0,6654.523,54,1472.441,LESS,-802,3482,2680,4,1,9,0.843667615,9,0,-0.539902474,1.203739321,91,41,50,1,-1.376206896,-1.521650721,-1.170500555,0.800734566,-0.636115408,0.636115408,-1.170500555,-1.521650721,0,1,0
6418,27,179,56,110,96,1,3623.594,54,1366.471,LESS,50,1614,1664,3,2,-14,-1.312371845,14,0.87303787,-0.539902474,-0.577485076,206,110,96,0,0.917471264,1.170500555,0.624266962,-0.024056403,0.348270971,0.348270971,0.624266962,1.170500555,0,0,1
6419,27,180,35,72,80,0,5884.854,44,2467.675,LESS,586,2460,3046,2,1,8,0.749926769,8,-0.174607574,-1.06835514,0.751418201,152,72,80,1,-0.15956022,-0.312133481,0,-0.848847373,0.967556299,0.967556299,0,-0.312133481,0,0,1
6420,27,181,11,49,50,1,3695.386,44,1322.527,LESS,408,1480,1888,3,2,1,0.093740846,1,-1.396860592,-1.06835514,-0.535294163,99,49,50,1,-1.216646676,-1.20951724,-1.170500555,-0.024056403,0.761898112,0.761898112,-1.170500555,-1.20951724,0,0,1
6421,27,182,17,43,50,0,5105.959,64,3563.943,LESS,-1206,2926,1720,3,1,7,0.656185922,7,-0.349215148,-0.011449808,0.29367512,93,43,50,1,-1.336316841,-1.443617351,-1.170500555,-0.024056403,-1.10289017,1.10289017,-1.170500555,-1.443617351,0,0,0
6422,27,183,1,51,50,0,3536.975,54,2194.422,LESS,-1348,2540,1192,2,1,-1,-0.093740846,1,-1.396860592,-0.539902474,-0.62838956,101,51,50,0,-1.176756621,-1.131483869,-1.170500555,-0.848847373,-1.266954566,1.266954566,-1.170500555,-1.131483869,0,0,0
6423,27,184,41,112,110,1,2521.818,54,1891.971,LESS,204,1002,1206,1,2,-2,-0.187481692,2,-1.222253018,-0.539902474,-1.22497972,222,112,110,0,1.236591704,1.248533925,1.170500555,-1.673638342,0.526199965,0.526199965,1.170500555,1.248533925,0,0,1
6424,27,185,20,40,50,0,5945.755,74,1577.929,LESS,-544,3048,2504,4,2,10,0.937408461,10,0.174607574,0.517002858,0.787208662,90,40,50,1,-1.396151924,-1.560667406,-1.170500555,0.800734566,-0.338026575,0.338026575,-1.170500555,-1.560667406,1,1,0
6425,27,186,1,50,51,1,8233.828,14,2159.725,LESS,2,3830,3832,5,2,1,0.093740846,1,-1.396860592,-2.653713138,2.131869474,101,50,51,1,-1.176756621,-1.170500555,-1.131483869,1.625525535,0.292812584,0.292812584,-1.131483869,-1.170500555,0,1,1
6426,27,187,23,85,80,1,3162.231,74,1772.765,LESS,-94,1776,1682,4,1,-5,-0.46870423,5,-0.698430296,0.517002858,-0.848620108,165,85,80,0,0.099725137,0.195083426,0,0.800734566,0.181895809,0.181895809,0,0.195083426,1,1,1
6427,27,188,11,50,49,1,4366.012,84,1288.055,LESS,50,2056,2106,3,2,-1,-0.093740846,1,-1.396860592,1.045455524,-0.141178896,99,50,49,0,-1.216646676,-1.170500555,-1.20951724,-0.024056403,0.348270971,0.348270971,-1.20951724,-1.170500555,1,0,1
6428,27,189,17,50,43,1,8532.418,44,1569.104,LESS,-750,3632,2882,3,1,-7,-0.656185922,7,-0.349215148,-1.06835514,2.307345638,93,50,43,0,-1.336316841,-1.170500555,-1.443617351,-0.024056403,-0.576035488,0.576035488,-1.443617351,-1.170500555,0,0,0
6429,27,190,21,80,82,1,4736.506,54,1536.672,LESS,334,1960,2294,3,2,2,0.187481692,2,-1.222253018,-0.539902474,0.076554001,162,80,82,1,0.039890055,0,0.07803337,-0.024056403,0.676399764,0.676399764,0.07803337,0,0,0,1
6430,27,191,10,50,60,0,6030.07,84,1492.113,LESS,32,2970,3002,4,2,10,0.937408461,10,0.174607574,1.045455524,0.836759125,110,50,60,1,-0.997251374,-1.170500555,-0.780333703,0.800734566,0.327474076,0.327474076,-0.780333703,-1.170500555,1,1,1
6431,27,192,3,53,50,0,3036.054,90,1343.63,LESS,-136,2012,1876,2,2,-3,-0.281222538,3,-1.047645444,1.362527124,-0.922772143,103,53,50,0,-1.136866566,-1.053450499,-1.170500555,-0.848847373,0.13336972,0.13336972,-1.170500555,-1.053450499,1,0,1
6432,27,193,45,122,110,0,3162.565,64,1405.39,LESS,-832,2078,1246,2,1,-12,-1.124890153,12,0.523822722,-0.011449808,-0.848423822,232,122,110,0,1.436041979,1.638700776,1.170500555,-0.848847373,-0.6707769,0.6707769,1.170500555,1.638700776,1,0,0
6433,27,194,38,67,80,1,4667.88,44,1399.372,LESS,1148,1596,2744,3,2,13,1.218630999,13,0.698430296,-1.06835514,0.036223691,147,67,80,1,-0.259285357,-0.507216907,0,-0.024056403,1.616881587,1.616881587,0,-0.507216907,0,0,1
6434,27,195,38,80,67,1,4011.585,84,1362.865,LESS,748,1562,2310,3,2,-13,-1.218630999,13,0.698430296,1.045455524,-0.349469496,147,80,67,0,-0.259285357,0,-0.507216907,-0.024056403,1.154728357,1.154728357,-0.507216907,0,1,0,1
6435,27,196,36,70,80,0,4987.245,64,1596.557,LESS,-1502,3064,1562,4,1,10,0.937408461,10,0.174607574,-0.011449808,0.223908962,150,70,80,1,-0.199450275,-0.390166852,0,0.800734566,-1.44488356,1.44488356,0,-0.390166852,1,1,0
6436,27,197,45,110,122,1,4882.907,44,1597.28,LESS,352,1912,2264,4,1,12,1.124890153,12,0.523822722,-1.06835514,0.162591329,232,110,122,1,1.436041979,1.170500555,1.638700776,0.800734566,0.69719666,0.69719666,1.638700776,1.170500555,0,1,1
6437,27,198,42,110,115,1,5823.348,34,1919.383,LESS,-306,2864,2558,5,2,5,0.46870423,5,-0.698430296,-1.596807806,0.715272191,225,110,115,1,1.296426786,1.170500555,1.36558398,1.625525535,-0.063045403,0.063045403,1.36558398,1.170500555,0,1,0
6438,27,199,41,110,112,0,5319.627,84,1746.177,LESS,-414,2946,2532,4,2,2,0.187481692,2,-1.222253018,1.045455524,0.419244098,222,110,112,1,1.236591704,1.170500555,1.248533925,0.800734566,-0.187826775,0.187826775,1.248533925,1.170500555,1,1,0
6439,27,200,53,110,103,1,4829.936,74,1272.654,LESS,1500,1908,3408,2,1,-7,-0.656185922,7,-0.349215148,0.517002858,0.131461191,213,110,103,0,1.057086457,1.170500555,0.897383758,-0.848847373,2.023576429,2.023576429,0.897383758,1.170500555,1,0,1
6440,27,201,3,50,53,1,2048.961,84,1541.725,MORE,412,852,1264,1,2,3,0.281222538,3,-1.047645444,1.045455524,-1.502869576,103,50,53,0,-1.136866566,-1.170500555,-1.053450499,-1.673638342,0.766519644,0.766519644,-1.053450499,-1.170500555,1,0,1
6441,27,202,20,50,40,0,2841.402,74,1506.488,MORE,-682,1838,1156,2,2,-10,-0.937408461,10,0.174607574,0.517002858,-1.037165746,90,50,40,1,-1.396151924,-1.170500555,-1.560667406,-0.848847373,-0.497469439,0.497469439,-1.560667406,-1.170500555,1,0,0
6442,27,203,25,80,88,1,4139.177,94,963.586,MORE,8,2024,2032,3,2,8,0.749926769,8,-0.174607574,1.57390819,-0.274485891,168,80,88,0,0.15956022,0,0.312133481,-0.024056403,0.299744882,0.299744882,0.312133481,0,1,1,1
6443,27,204,42,115,110,0,4477.379,64,1438.899,MORE,-50,2184,2134,4,1,-5,-0.46870423,5,-0.698430296,-0.011449808,-0.075730442,225,115,110,1,1.296426786,1.36558398,1.170500555,0.800734566,0.232732664,0.232732664,1.170500555,1.36558398,0,1,1
6444,27,205,53,103,110,0,2071.375,44,1413.176,MORE,-672,1436,764,2,1,7,0.656185922,7,-0.349215148,-1.06835514,-1.489697257,213,103,110,0,1.057086457,0.897383758,1.170500555,-0.848847373,-0.485915608,0.485915608,1.170500555,0.897383758,0,0,0
6445,27,206,26,90,80,0,4195.264,64,1537.033,MORE,-1238,2738,1500,2,1,-10,-0.937408461,10,0.174607574,-0.011449808,-0.241524534,170,90,80,1,0.199450275,0.390166852,0,-0.848847373,-1.139862428,1.139862428,0,0.390166852,0,0,0
6446,27,207,35,80,72,0,2468.563,74,1763.799,MORE,-952,1740,788,2,1,-8,-0.749926769,8,-0.174607574,0.517002858,-1.256276759,152,80,72,1,-0.15956022,0,-0.312133481,-0.848847373,-0.809422869,0.809422869,-0.312133481,0,1,0,0
6447,27,208,28,93,80,0,2853.293,64,1607.899,MORE,-622,1724,1102,1,1,-13,-1.218630999,13,0.698430296,-0.011449808,-1.030177612,173,93,80,1,0.259285357,0.507216907,0,-1.673638342,-0.428146455,0.428146455,0,0.507216907,0,0,0
6448,27,209,26,80,90,1,3875.861,54,1584.639,MORE,342,2002,2344,3,2,10,0.937408461,10,0.174607574,-0.539902474,-0.429232136,170,80,90,0,0.199450275,0,0.390166852,-0.024056403,0.685642829,0.685642829,0.390166852,0,0,0,1
6449,27,210,25,88,80,0,3800.704,64,1475.823,MORE,-374,2072,1698,2,1,-8,-0.749926769,8,-0.174607574,-0.011449808,-0.473400602,168,88,80,1,0.15956022,0.312133481,0,-0.848847373,-0.141611452,0.141611452,0,0.312133481,0,0,0
6450,27,211,36,80,70,0,2758.2,64,1482.283,MORE,-314,1608,1294,2,1,-10,-0.937408461,10,0.174607574,-0.011449808,-1.086062119,150,80,70,1,-0.199450275,0,-0.390166852,-0.848847373,-0.072288468,0.072288468,-0.390166852,0,0,0,0
6451,27,212,28,80,93,1,4489.419,100,893.11,MORE,318,2298,2616,3,2,13,1.218630999,13,0.698430296,1.89097979,-0.068654743,173,80,93,0,0.259285357,0,0.507216907,-0.024056403,0.657913635,0.657913635,0.507216907,0,1,1,1
6452,27,213,21,82,80,0,4576.46,74,602.053,MORE,-1282,2852,1570,4,1,-2,-0.187481692,2,-1.222253018,0.517002858,-0.017502257,162,82,80,1,0.039890055,0.07803337,0,0.800734566,-1.190699283,1.190699283,0,0.07803337,1,1,0
6453,27,214,19,50,41,0,2232.776,64,2354.958,MORE,-920,1590,670,2,1,-9,-0.843667615,9,0,-0.011449808,-1.394844689,91,50,41,1,-1.376206896,-1.170500555,-1.521650721,-0.848847373,-0.772450611,0.772450611,-1.521650721,-1.170500555,0,0,0
6454,27,215,56,96,110,1,3329.848,64,1623.18,MORE,1024,1146,2170,3,2,14,1.312371845,14,0.87303787,-0.011449808,-0.750114505,206,96,110,0,0.917471264,0.624266962,1.170500555,-0.024056403,1.473614086,1.473614086,1.170500555,0.624266962,0,1,1
6455,27,216,23,80,85,1,4914.487,54,1555.282,MORE,-586,2434,1848,4,1,5,0.46870423,5,-0.698430296,-0.539902474,0.181150347,165,80,85,0,0.099725137,0,0.195083426,0.800734566,-0.386552664,0.386552664,0.195083426,0,0,1,0
6456,27,217,10,60,50,1,4604.038,54,1182.902,MORE,444,2078,2522,4,1,-10,-0.937408461,10,0.174607574,-0.539902474,-0.001295145,110,60,50,1,-0.997251374,-0.780333703,-1.170500555,0.800734566,0.803491903,0.803491903,-1.170500555,-0.780333703,0,1,1
6457,27,218,19,41,50,0,2672.665,74,1892.01,MORE,854,1566,2420,3,2,9,0.843667615,9,0,0.517002858,-1.136329554,91,41,50,0,-1.376206896,-1.521650721,-1.170500555,-0.024056403,1.277198963,1.277198963,-1.170500555,-1.521650721,1,1,1
6458,27,219,56,110,96,1,4926.926,74,1311.464,MORE,-48,2374,2326,3,2,-14,-1.312371845,14,0.87303787,0.517002858,0.188460532,206,110,96,1,0.917471264,1.170500555,0.624266962,-0.024056403,0.23504343,0.23504343,0.624266962,1.170500555,1,1,1
6459,27,220,35,72,80,1,4475.167,54,1509.4,MORE,554,1918,2472,3,2,8,0.749926769,8,-0.174607574,-0.539902474,-0.077030396,152,72,80,0,-0.15956022,-0.312133481,0,-0.024056403,0.930584041,0.930584041,0,-0.312133481,0,1,1
6460,27,221,11,49,50,0,3143.668,54,1819.824,MORE,-188,1896,1708,2,2,1,0.093740846,1,-1.396860592,-0.539902474,-0.859529262,99,49,50,0,-1.216646676,-1.20951724,-1.170500555,-0.848847373,0.0732898,0.0732898,-1.170500555,-1.20951724,0,0,1
6461,27,222,17,43,50,0,6849.225,14,1618.56,MORE,-362,3386,3024,4,1,7,0.656185922,7,-0.349215148,-2.653713138,1.318162309,93,43,50,0,-1.336316841,-1.443617351,-1.170500555,0.800734566,-0.127746855,0.127746855,-1.170500555,-1.443617351,0,1,0
6462,27,223,1,51,50,0,2395.993,74,1776.495,MORE,-1084,1912,828,2,1,-1,-0.093740846,1,-1.396860592,0.517002858,-1.29892489,101,51,50,1,-1.176756621,-1.131483869,-1.170500555,-0.848847373,-0.961933435,0.961933435,-1.170500555,-1.131483869,1,0,0
6463,27,224,41,112,110,0,3890.698,84,1454.292,MORE,-1656,2684,1028,2,1,-2,-0.187481692,2,-1.222253018,1.045455524,-0.420512689,222,112,110,1,1.236591704,1.248533925,1.170500555,-0.848847373,-1.622812553,1.622812553,1.170500555,1.248533925,1,0,0
6464,27,225,20,40,50,1,5010.068,54,1325.915,MORE,250,2056,2306,3,2,10,0.937408461,10,0.174607574,-0.539902474,0.237321643,90,40,50,0,-1.396151924,-1.560667406,-1.170500555,-0.024056403,0.579347586,0.579347586,-1.170500555,-1.560667406,0,1,1
6465,27,226,1,50,51,0,3374.686,54,1268.14,MORE,-618,1990,1372,2,1,1,0.093740846,1,-1.396860592,-0.539902474,-0.72376399,101,50,51,0,-1.176756621,-1.170500555,-1.131483869,-0.848847373,-0.423524922,0.423524922,-1.131483869,-1.170500555,0,0,0
6466,27,227,23,85,80,0,2589.66,64,1695.562,MORE,-812,1774,962,2,1,-5,-0.46870423,5,-0.698430296,-0.011449808,-1.185110153,165,85,80,1,0.099725137,0.195083426,0,-0.848847373,-0.647669239,0.647669239,0,0.195083426,1,0,0
6467,27,228,11,50,49,0,3277.458,44,2245.816,MORE,-1328,2638,1310,2,1,-1,-0.093740846,1,-1.396860592,-1.06835514,-0.780903199,99,50,49,1,-1.216646676,-1.170500555,-1.20951724,-0.848847373,-1.243846905,1.243846905,-1.20951724,-1.170500555,0,0,0
6468,27,229,17,50,43,1,4888.513,44,1682.594,MORE,-394,2580,2186,3,2,-7,-0.656185922,7,-0.349215148,-1.06835514,0.165885878,93,50,43,1,-1.336316841,-1.170500555,-1.443617351,-0.024056403,-0.164719114,0.164719114,-1.443617351,-1.170500555,0,1,0
6469,27,230,21,80,82,1,3538.174,74,1719.415,MORE,480,1410,1890,3,2,2,0.187481692,2,-1.222253018,0.517002858,-0.627684929,162,80,82,0,0.039890055,0,0.07803337,-0.024056403,0.845085693,0.845085693,0.07803337,0,1,1,1
6470,27,231,10,50,60,1,2017.232,100,1666.083,MORE,142,1178,1320,1,2,10,0.937408461,10,0.174607574,1.89097979,-1.521516159,110,50,60,0,-0.997251374,-1.170500555,-0.780333703,-1.673638342,0.454566214,0.454566214,-0.780333703,-1.170500555,1,0,1
6471,27,232,3,53,50,0,7481.734,54,1546.868,MORE,-520,3798,3278,6,1,-3,-0.281222538,3,-1.047645444,-0.539902474,1.689876876,103,53,50,1,-1.136866566,-1.053450499,-1.170500555,2.450316505,-0.310297381,0.310297381,-1.170500555,-1.053450499,0,1,0
6472,27,233,45,122,110,0,3836.637,74,1825.508,MORE,-1430,2610,1180,2,1,-12,-1.124890153,12,0.523822722,0.517002858,-0.452283401,232,122,110,1,1.436041979,1.638700776,1.170500555,-0.848847373,-1.361695978,1.361695978,1.170500555,1.638700776,1,0,0
6473,27,234,38,67,80,1,2667.166,100,982.713,MORE,-536,1784,1248,1,2,13,1.218630999,13,0.698430296,1.89097979,-1.139561221,147,67,80,0,-0.259285357,-0.507216907,0,-1.673638342,-0.32878351,0.32878351,0,-0.507216907,1,0,0
6474,27,235,38,80,67,0,4229.895,44,1618.259,MORE,-1866,3120,1254,2,1,-13,-1.218630999,13,0.698430296,-1.06835514,-0.221172496,147,80,67,1,-0.259285357,0,-0.507216907,-0.848847373,-1.865442999,1.865442999,-0.507216907,0,0,0,0
6475,27,236,36,70,80,1,4699.266,54,1236.732,MORE,660,1902,2562,3,2,10,0.937408461,10,0.174607574,-0.539902474,0.054668699,150,70,80,0,-0.199450275,-0.390166852,0,-0.024056403,1.053054647,1.053054647,0,-0.390166852,0,1,1
6476,27,237,45,110,122,1,1650.606,44,1155.923,MORE,214,732,946,1,2,12,1.124890153,12,0.523822722,-1.06835514,-1.7369759,232,110,122,0,1.436041979,1.170500555,1.638700776,-1.673638342,0.537753795,0.537753795,1.638700776,1.170500555,0,0,1
6477,27,238,42,110,115,1,3467.038,44,1248.775,MORE,-238,1792,1554,3,2,5,0.46870423,5,-0.698430296,-1.06835514,-0.669490322,225,110,115,0,1.296426786,1.170500555,1.36558398,-0.024056403,0.015520646,0.015520646,1.36558398,1.170500555,0,1,1
6478,27,239,41,110,112,1,2262.936,84,1596.346,MORE,-30,1256,1226,1,2,2,0.187481692,2,-1.222253018,1.045455524,-1.37712018,222,110,112,0,1.236591704,1.170500555,1.248533925,-1.673638342,0.255840325,0.255840325,1.248533925,1.170500555,1,0,1
6479,27,240,53,110,103,0,6140.96,74,1756.757,MORE,-1588,3722,2134,4,1,-7,-0.656185922,7,-0.349215148,0.517002858,0.901927254,213,110,103,1,1.057086457,1.170500555,0.897383758,0.800734566,-1.544246504,1.544246504,0.897383758,1.170500555,1,1,0
6480,28,1,49,110,131,1,2420.685,40,1677.281,MORE,64,1098,1162,3,1,21,1.968557767,21,2.095290887,-0.319587709,0.085710555,241,110,131,0,1.615547226,1.170500555,1.989850943,-0.209081373,0.631584763,0.631584763,1.989850943,1.170500555,0,0,1
6481,28,2,13,47,50,1,3499.168,10,783.562,MORE,-476,1810,1334,5,2,3,0.281222538,3,-1.047645444,-2.553598878,1.13804533,97,47,50,0,-1.256536731,-1.28755061,-1.170500555,1.266787141,-0.532958051,0.532958051,-1.170500555,-1.28755061,0,1,0
6482,28,3,16,50,44,0,2986.17,30,1317.757,MORE,-222,1234,1012,3,1,-6,-0.562445076,6,-0.523822722,-1.064258099,0.637485159,94,50,44,1,-1.316371814,-1.170500555,-1.404600665,-0.209081373,0.014808384,0.014808384,-1.404600665,-1.170500555,0,1,0
6483,28,4,7,57,50,0,5100.094,40,1793.034,MORE,112,1952,2064,6,2,-7,-0.656185922,7,-0.349215148,-0.319587709,2.70015628,107,57,50,1,-1.057086457,-0.897383758,-1.170500555,2.004721397,0.73509968,0.73509968,-1.170500555,-0.897383758,0,1,1
6484,28,5,18,42,50,1,1725.954,60,841.822,MORE,-36,712,676,5,2,8,0.749926769,8,-0.174607574,1.16975307,-0.592176432,92,42,50,0,-1.356261869,-1.482634036,-1.170500555,1.266787141,0.415928687,0.415928687,-1.170500555,-1.482634036,1,1,1
6485,28,6,51,108,110,1,2108.725,50,1323.233,MORE,154,760,914,1,2,2,0.187481692,2,-1.222253018,0.425082681,-0.218685858,218,108,110,0,1.156811594,1.092467184,1.170500555,-1.684949886,0.825675232,0.825675232,1.170500555,1.092467184,1,0,1
6486,28,7,31,78,80,1,1724.844,60,1933.509,MORE,100,766,866,4,1,2,0.187481692,2,-1.222253018,1.16975307,-0.59325952,158,78,80,0,-0.039890055,-0.07803337,0,0.528852884,0.709220951,0.709220951,0,-0.07803337,1,1,1
6487,28,8,58,110,92,0,2432.793,50,1621.242,MORE,-254,1244,990,5,1,-18,-1.687335229,18,1.571468165,0.425082681,0.097524992,202,110,92,1,0.837691154,1.170500555,0.468200222,1.266787141,-0.054201561,0.054201561,0.468200222,1.170500555,1,1,0
6488,28,9,12,50,48,1,1830.792,50,1088.873,MORE,142,710,852,3,2,-2,-0.187481692,2,-1.222253018,0.425082681,-0.489880269,98,50,48,1,-1.236591704,-1.170500555,-1.248533925,-0.209081373,0.799796503,0.799796503,-1.248533925,-1.170500555,1,1,1
6489,28,10,54,110,101,0,1901.438,60,1736.784,MORE,-636,1070,434,2,1,-9,-0.843667615,9,0,1.16975307,-0.420947107,211,110,101,1,1.017196402,1.170500555,0.819350388,-0.947015629,-0.878007774,0.878007774,0.819350388,1.170500555,1,0,0
6490,28,11,14,46,50,1,1768.948,60,945.168,MORE,188,656,844,3,2,4,0.374963384,4,-0.87303787,1.16975307,-0.550224838,96,46,50,0,-1.276481759,-1.326567295,-1.170500555,-0.209081373,0.898998298,0.898998298,-1.170500555,-1.326567295,1,1,1
6491,28,12,22,80,83,0,1780.24,60,1202.345,MORE,-684,1066,382,2,1,3,0.281222538,3,-1.047645444,1.16975307,-0.539206616,163,80,83,0,0.059835082,0,0.117050055,-0.947015629,-0.98152269,0.98152269,0.117050055,0,1,0,0
6492,28,13,6,50,56,0,1923.951,60,1375.357,MORE,-368,952,584,1,2,6,0.562445076,6,-0.523822722,1.16975307,-0.398979943,106,50,56,0,-1.077031484,-1.170500555,-0.936400444,-1.684949886,-0.300049488,0.300049488,-0.936400444,-1.170500555,1,0,0
6493,28,14,13,50,47,0,1376.212,60,1399.081,MORE,-366,758,392,1,1,-3,-0.281222538,3,-1.047645444,1.16975307,-0.933438806,97,50,47,1,-1.256536731,-1.170500555,-1.28755061,-1.684949886,-0.295736367,0.295736367,-1.28755061,-1.170500555,1,0,0
6494,28,15,46,110,124,1,1570.343,60,2276.711,MORE,-234,1032,798,3,1,14,1.312371845,14,0.87303787,1.16975307,-0.744014585,234,110,124,0,1.475932034,1.170500555,1.716734147,-0.209081373,-0.011070345,0.011070345,1.716734147,1.170500555,1,1,0
6495,28,16,27,91,80,1,1976.101,60,1040.594,MORE,20,800,820,3,2,-11,-1.031149307,11,0.349215148,1.16975307,-0.34809434,171,91,80,1,0.219395302,0.429183537,0,-0.209081373,0.53669609,0.53669609,0,0.429183537,1,1,1
6496,28,17,40,64,80,1,2043.473,50,1883.045,MORE,-30,1258,1228,6,1,16,1.499853537,16,1.222253018,0.425082681,-0.282355799,144,64,80,0,-0.31912044,-0.624266962,0,2.004721397,0.428868051,0.428868051,0,-0.624266962,1,1,1
6497,28,18,22,83,80,1,2049.897,60,852.252,MORE,226,730,956,3,2,-3,-0.281222538,3,-1.047645444,1.16975307,-0.276087551,163,83,80,1,0.059835082,0.117050055,0,-0.209081373,0.980947608,0.980947608,0,0.117050055,1,1,1
6498,28,19,54,101,110,1,1996.728,50,1264.687,MORE,174,728,902,3,2,9,0.843667615,9,0,0.425082681,-0.327967449,211,101,110,0,1.017196402,0.819350388,1.170500555,-0.209081373,0.868806448,0.868806448,1.170500555,0.819350388,0,1,1
6499,28,20,6,56,50,1,2073.991,30,703.327,MORE,434,560,994,2,2,-6,-0.562445076,6,-0.523822722,-1.064258099,-0.252577719,106,56,50,1,-1.077031484,-0.936400444,-1.170500555,-0.947015629,1.429512247,1.429512247,-1.170500555,-0.936400444,0,0,1
6500,28,21,18,50,42,1,2177.599,40,1363.973,MORE,284,758,1042,3,2,-8,-0.749926769,8,-0.174607574,-0.319587709,-0.151481734,92,50,42,1,-1.356261869,-1.170500555,-1.482634036,-0.209081373,1.106028132,1.106028132,-1.482634036,-1.170500555,0,1,1
6501,28,22,43,110,117,0,1628.771,30,1370.227,MORE,-1056,1458,402,2,1,7,0.656185922,7,-0.349215148,-1.064258099,-0.687003194,227,110,117,0,1.336316841,1.170500555,1.443617351,-0.947015629,-1.783763296,1.783763296,1.443617351,1.170500555,0,0,0
6502,28,23,32,77,80,1,1985.741,40,1965.911,MORE,-192,1114,922,3,2,3,0.281222538,3,-1.047645444,-0.319587709,-0.338688065,157,77,80,0,-0.059835082,-0.117050055,0,-0.209081373,0.079505207,0.079505207,0,-0.117050055,0,1,0
6503,28,24,27,80,91,1,2123.308,60,1953.278,MORE,408,672,1080,2,1,11,1.031149307,11,0.349215148,1.16975307,-0.204456429,171,80,91,0,0.219395302,0,0.429183537,-0.947015629,1.373441667,1.373441667,0.429183537,0,1,0,1
6504,28,25,16,44,50,1,1968.519,10,637.836,MORE,-394,1160,766,3,1,6,0.562445076,6,-0.523822722,-2.553598878,-0.355492511,94,44,50,0,-1.316371814,-1.404600665,-1.170500555,-0.209081373,-0.356120068,0.356120068,-1.170500555,-1.404600665,0,1,0
6505,28,26,7,50,57,1,2070.932,30,1414.395,MORE,-70,876,806,3,1,7,0.656185922,7,-0.349215148,-1.064258099,-0.255562553,107,50,57,0,-1.057086457,-1.170500555,-0.897383758,-0.209081373,0.342605621,0.342605621,-0.897383758,-1.170500555,0,1,1
6506,28,27,14,50,46,0,2660.077,30,1523.839,MORE,-414,1388,974,4,1,-4,-0.374963384,4,-0.87303787,-1.064258099,0.319298406,96,50,46,1,-1.276481759,-1.170500555,-1.326567295,0.528852884,-0.399251283,0.399251283,-1.326567295,-1.170500555,0,1,0
6507,28,28,51,110,108,0,2584.98,30,1254.477,MORE,-534,1496,962,4,1,-2,-0.187481692,2,-1.222253018,-1.064258099,0.246022161,218,110,108,1,1.156811594,1.170500555,1.092467184,0.528852884,-0.658038575,0.658038575,1.092467184,1.170500555,0,1,0
6508,28,29,50,133,110,0,2274.049,40,1640.901,MORE,-290,1114,824,4,1,-23,-2.15603946,23,2.444506035,-0.319587709,-0.057370201,243,133,110,1,1.655437281,2.067884313,1.170500555,0.528852884,-0.131837748,0.131837748,1.170500555,2.067884313,0,1,0
6509,28,30,49,131,110,0,1861.168,40,1384.749,MORE,-458,918,460,2,1,-21,-1.968557767,21,2.095290887,-0.319587709,-0.460240746,241,131,110,1,1.615547226,1.989850943,1.170500555,-0.947015629,-0.494139957,0.494139957,1.170500555,1.989850943,0,0,0
6510,28,31,47,126,110,0,2473.36,40,1233.672,MORE,-402,1190,788,3,2,-16,-1.499853537,16,1.222253018,-0.319587709,0.13710843,236,126,110,1,1.515822089,1.794767517,1.170500555,-0.209081373,-0.373372554,0.373372554,1.170500555,1.794767517,0,1,0
6511,28,32,50,110,133,1,1736.281,60,1265.43,MORE,40,810,850,3,2,23,2.15603946,23,2.444506035,1.16975307,-0.582099814,243,110,133,0,1.655437281,1.170500555,2.067884313,-0.209081373,0.579827305,0.579827305,2.067884313,1.170500555,1,1,1
6512,28,33,47,110,126,1,1742.155,50,1016.453,MORE,136,712,848,3,2,16,1.499853537,16,1.222253018,0.425082681,-0.576368231,236,110,126,0,1.515822089,1.170500555,1.794767517,-0.209081373,0.786857138,0.786857138,1.794767517,1.170500555,1,1,1
6513,28,34,12,48,50,0,2913.099,30,1187.129,MORE,-792,1540,748,4,1,2,0.187481692,2,-1.222253018,-1.064258099,0.566185793,98,48,50,0,-1.236591704,-1.248533925,-1.170500555,0.528852884,-1.214431253,1.214431253,-1.170500555,-1.248533925,0,1,0
6514,28,35,32,80,77,0,2627.482,30,978.383,MORE,-164,1324,1160,4,1,-3,-0.281222538,3,-1.047645444,-1.064258099,0.287493684,157,80,77,1,-0.059835082,0,-0.117050055,0.528852884,0.139888908,0.139888908,-0.117050055,0,0,1,0
6515,28,36,43,117,110,0,1826.294,30,1147.378,MORE,-852,1302,450,2,1,-7,-0.656185922,7,-0.349215148,-1.064258099,-0.494269213,227,117,110,1,1.336316841,1.443617351,1.170500555,-0.947015629,-1.343824899,1.343824899,1.170500555,1.443617351,0,0,0
6516,28,37,40,80,64,0,1354.626,30,1180.308,MORE,-432,786,354,2,1,-16,-1.499853537,16,1.222253018,-1.064258099,-0.954501446,144,80,64,1,-0.31912044,0,-0.624266962,-0.947015629,-0.438069377,0.438069377,-0.624266962,0,0,0,0
6517,28,38,31,80,78,0,1646.504,40,1297.063,MORE,-710,1076,366,2,1,-2,-0.187481692,2,-1.222253018,-0.319587709,-0.669700137,158,80,78,1,-0.039890055,0,-0.07803337,-0.947015629,-1.03759327,1.03759327,-0.07803337,0,0,0,0
6518,28,39,46,124,110,0,2885.32,50,1107.384,MORE,-186,1148,962,4,1,-14,-1.312371845,14,0.87303787,0.425082681,0.539080305,234,124,110,1,1.475932034,1.716734147,1.170500555,0.528852884,0.092444572,0.092444572,1.170500555,1.716734147,1,1,0
6519,28,40,58,92,110,1,1566.876,60,2047.593,MORE,14,826,840,3,1,18,1.687335229,18,1.571468165,1.16975307,-0.747397526,202,92,110,0,0.837691154,0.468200222,1.170500555,-0.209081373,0.523756725,0.523756725,1.170500555,0.468200222,1,1,1
6520,28,41,49,110,131,0,2516.803,40,2001.615,LESS,-696,1474,778,5,1,21,1.968557767,21,2.095290887,-0.319587709,0.179498138,241,110,131,1,1.615547226,1.170500555,1.989850943,1.266787141,-1.00740142,1.00740142,1.989850943,1.170500555,1,1,0
6521,28,42,13,47,50,0,4611.667,30,1559.172,LESS,-158,2094,1936,6,1,3,0.281222538,3,-1.047645444,-1.064258099,2.223571375,97,47,50,1,-1.256536731,-1.28755061,-1.170500555,2.004721397,0.152828273,0.152828273,-1.170500555,-1.28755061,0,1,1
6522,28,43,16,50,44,0,3162.954,40,2198.769,LESS,-124,1738,1614,4,1,-6,-0.562445076,6,-0.523822722,-0.319587709,0.809982965,94,50,44,0,-1.316371814,-1.170500555,-1.404600665,0.528852884,0.226151339,0.226151339,-1.404600665,-1.170500555,1,1,1
6523,28,44,7,57,50,1,4274.44,30,948.37,LESS,480,1534,2014,5,2,-7,-0.656185922,7,-0.349215148,-1.064258099,1.89452057,107,57,50,0,-1.057086457,-0.897383758,-1.170500555,1.266787141,1.528714042,1.528714042,-1.170500555,-0.897383758,0,1,1
6524,28,45,18,42,50,0,1320.343,30,1164.784,LESS,-220,696,476,2,1,8,0.749926769,8,-0.174607574,-1.064258099,-0.987953241,92,42,50,1,-1.356261869,-1.482634036,-1.170500555,-0.947015629,0.019121505,0.019121505,-1.170500555,-1.482634036,0,0,1
6525,28,46,51,108,110,0,3516.693,60,492.315,LESS,-540,1828,1288,6,1,2,0.187481692,2,-1.222253018,1.16975307,1.15514543,218,108,110,1,1.156811594,1.092467184,1.170500555,2.004721397,-0.67097794,0.67097794,1.170500555,1.092467184,1,1,0
6526,28,47,31,78,80,0,4181.559,20,1380.206,LESS,-302,1872,1570,4,1,2,0.187481692,2,-1.222253018,-1.808928488,1.803891505,158,78,80,1,-0.039890055,-0.07803337,0,0.528852884,-0.157716477,0.157716477,0,-0.07803337,0,1,0
6527,28,48,58,110,92,1,3230.012,40,1248.421,LESS,594,1034,1628,3,1,-18,-1.687335229,18,1.571468165,-0.319587709,0.875415118,202,110,92,0,0.837691154,1.170500555,0.468200222,-0.209081373,1.77456197,1.77456197,0.468200222,1.170500555,1,0,1
6528,28,49,12,50,48,1,3748.777,40,2038.68,LESS,-196,1592,1396,4,1,-2,-0.187481692,2,-1.222253018,-0.319587709,1.381602467,98,50,48,0,-1.236591704,-1.170500555,-1.248533925,0.528852884,0.070878964,0.070878964,-1.248533925,-1.170500555,1,1,1
6529,28,50,54,110,101,0,4056.129,30,1276.353,LESS,-176,1794,1618,6,1,-9,-0.843667615,9,0,-1.064258099,1.681502602,211,110,101,0,1.017196402,1.170500555,0.819350388,2.004721397,0.114010179,0.114010179,0.819350388,1.170500555,0,1,1
6530,28,51,14,46,50,0,1765.118,30,1223.774,LESS,-782,1210,428,2,1,4,0.374963384,4,-0.87303787,-1.064258099,-0.553961978,96,46,50,1,-1.276481759,-1.326567295,-1.170500555,-0.947015629,-1.192865646,1.192865646,-1.170500555,-1.326567295,0,0,0
6531,28,52,22,80,83,1,2491.894,30,1369.306,LESS,378,1010,1388,3,1,3,0.281222538,3,-1.047645444,-1.064258099,0.155193066,163,80,83,1,0.059835082,0,0.117050055,-0.209081373,1.308744844,1.308744844,0.117050055,0,0,0,1
6532,28,53,6,50,56,0,2776.723,50,1943.611,LESS,84,1304,1388,5,2,6,0.562445076,6,-0.523822722,0.425082681,0.43311628,106,50,56,1,-1.077031484,-1.170500555,-0.936400444,1.266787141,0.674715979,0.674715979,-0.936400444,-1.170500555,1,1,1
6533,28,54,13,50,47,1,2389.414,40,1090.051,LESS,78,1046,1124,3,2,-3,-0.281222538,3,-1.047645444,-0.319587709,0.055197732,97,50,47,0,-1.256536731,-1.170500555,-1.28755061,-0.209081373,0.661776614,0.661776614,-1.28755061,-1.170500555,1,1,1
6534,28,55,46,110,124,0,3909.992,50,1890.126,LESS,-1184,2326,1142,5,2,14,1.312371845,14,0.87303787,0.425082681,1.538908749,234,110,124,1,1.475932034,1.170500555,1.716734147,1.266787141,-2.059803074,2.059803074,1.716734147,1.170500555,1,1,0
6535,28,56,27,91,80,1,5017.354,50,2152.942,LESS,842,1724,2566,8,2,-11,-1.031149307,11,0.349215148,0.425082681,2.619422342,171,91,80,0,0.219395302,0.429183537,0,3.480589911,2.30938904,2.30938904,0,0.429183537,1,1,1
6536,28,57,40,64,80,0,1897.163,60,621.935,LESS,-454,1046,592,4,1,16,1.499853537,16,1.222253018,1.16975307,-0.425118458,144,64,80,1,-0.31912044,-0.624266962,0,0.528852884,-0.485513714,0.485513714,0,-0.624266962,1,1,0
6537,28,58,22,83,80,1,4054.092,50,2917.179,LESS,162,1596,1758,6,1,-3,-0.281222538,3,-1.047645444,0.425082681,1.67951499,163,83,80,0,0.059835082,0.117050055,0,2.004721397,0.842927718,0.842927718,0,0.117050055,1,1,1
6538,28,59,54,101,110,0,2561.493,20,2223.618,LESS,-1762,2570,808,4,1,9,0.843667615,9,0,-1.808928488,0.223104612,211,101,110,1,1.017196402,0.819350388,1.170500555,0.528852884,-3.306295197,3.306295197,1.170500555,0.819350388,0,1,0
6539,28,60,6,56,50,0,2424.959,30,1206.742,LESS,-550,1474,924,4,1,-6,-0.562445076,6,-0.523822722,-1.064258099,0.08988093,106,56,50,0,-1.077031484,-0.936400444,-1.170500555,0.528852884,-0.692543548,0.692543548,-1.170500555,-0.936400444,0,1,0
6540,28,61,18,50,42,1,2090.37,40,1109.921,LESS,254,762,1016,2,1,-8,-0.749926769,8,-0.174607574,-0.319587709,-0.236595834,92,50,42,0,-1.356261869,-1.170500555,-1.482634036,-0.947015629,1.041331309,1.041331309,-1.482634036,-1.170500555,1,0,1
6541,28,62,43,110,117,1,2656.322,50,1626.08,LESS,52,1002,1054,5,1,7,0.656185922,7,-0.349215148,0.425082681,0.315634447,227,110,117,1,1.336316841,1.170500555,1.443617351,1.266787141,0.605706034,0.605706034,1.443617351,1.170500555,1,1,1
6542,28,63,32,77,80,0,2934.752,60,1831.22,LESS,190,1116,1306,5,1,3,0.281222538,3,-1.047645444,1.16975307,0.587313808,157,77,80,1,-0.059835082,-0.117050055,0,1.266787141,0.90331142,0.90331142,0,-0.117050055,1,1,1
6543,28,64,27,80,91,0,2613.508,50,1158.817,LESS,-282,1060,778,3,2,11,1.031149307,11,0.349215148,0.425082681,0.273858489,171,80,91,1,0.219395302,0,0.429183537,-0.209081373,-0.114585262,0.114585262,0.429183537,0,1,1,0
6544,28,65,16,44,50,0,1588.852,50,846.128,LESS,-408,892,484,2,1,6,0.562445076,6,-0.523822722,0.425082681,-0.725954343,94,44,50,1,-1.316371814,-1.404600665,-1.170500555,-0.947015629,-0.386311919,0.386311919,-1.170500555,-1.404600665,1,0,0
6545,28,66,7,50,57,0,1666.338,60,2739.336,LESS,-1216,1586,370,2,1,7,0.656185922,7,-0.349215148,1.16975307,-0.65034702,107,50,57,1,-1.057086457,-1.170500555,-0.897383758,-0.947015629,-2.128813018,2.128813018,-0.897383758,-1.170500555,1,0,0
6546,28,67,14,50,46,0,1429.186,50,1511.894,LESS,-428,796,368,2,1,-4,-0.374963384,4,-0.87303787,0.425082681,-0.881749181,96,50,46,0,-1.276481759,-1.170500555,-1.326567295,-0.947015629,-0.429443134,0.429443134,-1.326567295,-1.170500555,1,0,0
6547,28,68,51,110,108,0,2283.973,50,1379.041,LESS,-464,1308,844,4,1,-2,-0.187481692,2,-1.222253018,0.425082681,-0.047686812,218,110,108,0,1.156811594,1.170500555,1.092467184,0.528852884,-0.507079322,0.507079322,1.092467184,1.170500555,1,1,0
6548,28,69,50,133,110,1,5978.587,30,1642.651,LESS,160,2682,2842,5,1,-23,-2.15603946,23,2.444506035,-1.064258099,3.557349888,243,133,110,0,1.655437281,2.067884313,1.170500555,1.266787141,0.838614597,0.838614597,1.170500555,2.067884313,0,1,1
6549,28,70,49,131,110,0,3715.779,70,594.028,LESS,-918,1790,872,4,1,-21,-1.968557767,21,2.095290887,1.91442346,1.349404516,241,131,110,0,1.615547226,1.989850943,1.170500555,0.528852884,-1.48615791,1.48615791,1.170500555,1.989850943,1,1,0
6550,28,71,47,126,110,1,3857.005,40,1147.344,LESS,-312,1630,1318,4,1,-16,-1.499853537,16,1.222253018,-0.319587709,1.487206438,236,126,110,0,1.515822089,1.794767517,1.170500555,0.528852884,-0.179282085,0.179282085,1.170500555,1.794767517,1,1,0
6551,28,72,50,110,133,0,2976.104,30,1153.847,LESS,-414,1356,942,3,1,23,2.15603946,23,2.444506035,-1.064258099,0.627663213,243,110,133,1,1.655437281,1.170500555,2.067884313,-0.209081373,-0.399251283,0.399251283,2.067884313,1.170500555,0,0,0
6552,28,73,47,110,126,0,5246.761,40,782.893,LESS,104,1900,2004,3,1,16,1.499853537,16,1.222253018,-0.319587709,2.843267283,236,110,126,1,1.515822089,1.170500555,1.794767517,-0.209081373,0.717847194,0.717847194,1.794767517,1.170500555,1,0,1
6553,28,74,12,48,50,1,2561.83,50,1397.421,LESS,-12,994,982,4,2,2,0.187481692,2,-1.222253018,0.425082681,0.223433441,98,48,50,1,-1.236591704,-1.248533925,-1.170500555,0.528852884,0.467686145,0.467686145,-1.170500555,-1.248533925,1,1,1
6554,28,75,32,80,77,0,3181.643,30,1375.626,LESS,-330,1356,1026,4,1,-3,-0.281222538,3,-1.047645444,-1.064258099,0.828218843,157,80,77,0,-0.059835082,0,-0.117050055,0.528852884,-0.218100179,0.218100179,-0.117050055,0,0,1,0
6555,28,76,43,117,110,1,2615.883,40,2247.793,LESS,148,906,1054,3,2,-7,-0.656185922,7,-0.349215148,-0.319587709,0.276175906,227,117,110,0,1.336316841,1.443617351,1.170500555,-0.209081373,0.812735868,0.812735868,1.170500555,1.443617351,1,1,1
6556,28,77,40,80,64,1,1252.518,30,1787.536,LESS,80,794,874,1,1,-16,-1.499853537,16,1.222253018,-1.064258099,-1.054133799,144,80,64,0,-0.31912044,0,-0.624266962,-1.684949886,0.666089736,0.666089736,-0.624266962,0,0,0,1
6557,28,78,31,80,78,1,6176.735,50,1776.283,LESS,-244,2548,2304,4,1,-2,-0.187481692,2,-1.222253018,0.425082681,3.750693716,158,80,78,0,-0.039890055,0,-0.07803337,0.528852884,-0.032635953,0.032635953,-0.07803337,0,1,1,1
6558,28,79,46,124,110,1,1861.325,50,1541.19,LESS,150,774,924,3,1,-14,-1.312371845,14,0.87303787,0.425082681,-0.460087553,234,124,110,0,1.475932034,1.716734147,1.170500555,-0.209081373,0.817048989,0.817048989,1.170500555,1.716734147,1,1,1
6559,28,80,58,92,110,0,2567.343,30,1064.982,LESS,-154,1080,926,4,1,18,1.687335229,18,1.571468165,-1.064258099,0.228812776,202,92,110,1,0.837691154,0.468200222,1.170500555,0.528852884,0.161454516,0.161454516,1.170500555,0.468200222,0,1,1
6560,28,81,48,128,110,0,4468.678,40,1873.734,MORE,-702,2244,1542,5,1,-18,-1.687335229,18,1.571468165,-0.319587709,2.084049197,238,128,110,1,1.555712144,1.872800887,1.170500555,1.266787141,-1.020340784,1.020340784,1.170500555,1.872800887,0,1,0
6561,28,82,8,50,58,0,1771.238,30,1766.246,MORE,-1346,1802,456,2,1,8,0.749926769,8,-0.174607574,-1.064258099,-0.54799036,108,50,58,0,-1.037141429,-1.170500555,-0.858367073,-0.947015629,-2.409165918,2.409165918,-0.858367073,-1.170500555,0,0,0
6562,28,83,4,54,50,1,2045.798,30,1932.952,MORE,36,976,1012,3,1,-4,-0.374963384,4,-0.87303787,-1.064258099,-0.28008717,104,54,50,1,-1.116921539,-1.014433814,-1.170500555,-0.209081373,0.571201062,0.571201062,-1.170500555,-1.014433814,0,1,1
6563,28,84,37,80,69,1,2012.281,40,1675.895,MORE,-68,912,844,3,1,-11,-1.031149307,11,0.349215148,-0.319587709,-0.312791537,149,80,69,1,-0.219395302,0,-0.429183537,-0.209081373,0.346918742,0.346918742,-0.429183537,0,0,1,1
6564,28,85,52,105,110,1,5198.2,40,2001.564,MORE,-100,2236,2136,8,1,5,0.46870423,5,-0.698430296,-0.319587709,2.795883663,215,105,110,0,1.096976512,0.975417129,1.170500555,3.480589911,0.277908797,0.277908797,1.170500555,0.975417129,0,1,1
6565,28,86,5,55,50,0,4256.217,40,1773.704,MORE,62,1470,1532,4,1,-5,-0.46870423,5,-0.698430296,-0.319587709,1.876739394,105,55,50,1,-1.096976512,-0.975417129,-1.170500555,0.528852884,0.627271642,0.627271642,-1.170500555,-0.975417129,0,1,1
6566,28,87,30,96,80,1,1661.093,40,995.649,MORE,322,540,862,3,2,-16,-1.499853537,16,1.222253018,-0.319587709,-0.655464853,176,96,80,1,0.31912044,0.624266962,0,-0.209081373,1.187977441,1.187977441,0,0.624266962,0,1,1
6567,28,88,33,80,75,1,2058.237,40,1796.838,MORE,630,650,1280,3,2,-5,-0.46870423,5,-0.698430296,-0.319587709,-0.267949758,155,80,75,1,-0.099725137,0,-0.195083426,-0.209081373,1.852198157,1.852198157,-0.195083426,0,0,1,1
6568,28,89,48,110,128,0,2207.346,20,2575.88,MORE,-1316,2296,980,5,1,18,1.687335229,18,1.571468165,-1.808928488,-0.122455961,238,110,128,0,1.555712144,1.170500555,1.872800887,1.266787141,-2.344469095,2.344469095,1.872800887,1.170500555,0,1,0
6569,28,90,9,59,50,0,2443.773,60,1301.724,MORE,-356,1184,828,4,1,-9,-0.843667615,9,0,1.16975307,0.108238777,109,59,50,1,-1.017196402,-0.819350388,-1.170500555,0.528852884,-0.274170759,0.274170759,-1.170500555,-0.819350388,1,1,0
6570,28,91,44,110,119,1,4032.071,60,1654.177,MORE,122,1690,1812,6,2,9,0.843667615,9,0,1.16975307,1.658027898,229,110,119,0,1.376206896,1.170500555,1.521650721,2.004721397,0.756665288,0.756665288,1.521650721,1.170500555,1,1,1
6571,28,92,2,52,50,0,5208.341,30,2054.608,MORE,-344,2176,1832,7,1,-2,-0.187481692,2,-1.222253018,-1.064258099,2.805778791,102,52,50,1,-1.156811594,-1.092467184,-1.170500555,2.742655654,-0.24829203,0.24829203,-1.170500555,-1.092467184,0,1,0
6572,28,93,8,58,50,0,5404.922,60,2644.857,MORE,774,1640,2414,3,1,-8,-0.749926769,8,-0.174607574,1.16975307,2.997593611,108,58,50,1,-1.037141429,-0.858367073,-1.170500555,-0.209081373,2.162742908,2.162742908,-1.170500555,-0.858367073,1,1,1
6573,28,94,44,119,110,0,2616.782,60,2361.83,MORE,-374,1314,940,3,1,-9,-0.843667615,9,0,1.16975307,0.277053109,229,119,110,1,1.376206896,1.521650721,1.170500555,-0.209081373,-0.312988853,0.312988853,1.170500555,1.521650721,1,1,0
6574,28,95,34,74,80,1,3760.149,30,1409.537,MORE,-100,1740,1640,5,2,6,0.562445076,6,-0.523822722,-1.064258099,1.392698748,154,74,80,0,-0.119670165,-0.234100111,0,1.266787141,0.277908797,0.277908797,0,-0.234100111,0,1,1
6575,28,96,24,86,80,1,3205.041,60,868.504,MORE,-102,1290,1188,5,2,-6,-0.562445076,6,-0.523822722,1.16975307,0.85104955,166,86,80,1,0.119670165,0.234100111,0,1.266787141,0.273595676,0.273595676,0,0.234100111,1,1,1
6576,28,97,39,66,80,1,4463.401,60,1270.583,MORE,212,1716,1928,7,2,14,1.312371845,14,0.87303787,1.16975307,2.07890014,146,66,80,0,-0.279230385,-0.546233592,0,2.742655654,0.950755757,0.950755757,0,-0.546233592,1,1,1
6577,28,98,9,50,59,1,1761.095,40,1461.78,MORE,-156,858,702,3,2,9,0.843667615,9,0,-0.319587709,-0.557887439,109,50,59,0,-1.017196402,-1.170500555,-0.819350388,-0.209081373,0.157141395,0.157141395,-0.819350388,-1.170500555,0,1,0
6578,28,99,57,94,110,1,2115.848,60,1828.437,MORE,100,836,936,3,2,16,1.499853537,16,1.222253018,1.16975307,-0.211735558,204,94,110,0,0.877581209,0.546233592,1.170500555,-0.209081373,0.709220951,0.709220951,1.170500555,0.546233592,1,1,1
6579,28,100,60,110,87,0,1370.259,60,1640.996,MORE,-390,864,474,2,1,-23,-2.15603946,23,2.444506035,1.16975307,-0.939247474,197,110,87,1,0.737966017,1.170500555,0.273116796,-0.947015629,-0.347493825,0.347493825,0.273116796,1.170500555,1,0,0
6580,28,101,33,75,80,1,1849.079,60,1582.665,MORE,264,686,950,3,2,5,0.46870423,5,-0.698430296,1.16975307,-0.472036644,155,75,80,0,-0.099725137,-0.195083426,0,-0.209081373,1.062896917,1.062896917,0,-0.195083426,1,0,1
6581,28,102,15,50,45,0,1562.185,60,1387.62,MORE,-786,1174,388,2,1,-5,-0.46870423,5,-0.698430296,1.16975307,-0.751974791,95,50,45,1,-1.296426786,-1.170500555,-1.36558398,-0.947015629,-1.201491889,1.201491889,-1.36558398,-1.170500555,1,0,0
6582,28,103,59,89,110,1,1564.402,60,997.968,MORE,82,732,814,3,2,21,1.968557767,21,2.095290887,1.16975307,-0.749811543,199,89,110,0,0.777856072,0.351150166,1.170500555,-0.209081373,0.670402857,0.670402857,1.170500555,0.351150166,1,0,1
6583,28,104,29,80,94,1,2548.512,60,1809.345,MORE,228,1040,1268,3,2,14,1.312371845,14,0.87303787,1.16975307,0.210438341,174,80,94,0,0.279230385,0,0.546233592,-0.209081373,0.985260729,0.985260729,0.546233592,0,1,0,1
6584,28,105,55,110,98,0,2215.732,40,1739.494,MORE,-386,1074,688,5,1,-12,-1.124890153,12,0.523822722,-0.319587709,-0.114273283,208,110,98,1,0.957361319,1.170500555,0.702300333,1.266787141,-0.338867582,0.338867582,0.702300333,1.170500555,0,1,0
6585,28,106,29,94,80,0,1978.714,60,1869.662,MORE,-926,1356,430,2,1,-14,-1.312371845,14,0.87303787,1.16975307,-0.345544693,174,94,80,1,0.279230385,0.546233592,0,-0.947015629,-1.503410396,1.503410396,0,0.546233592,1,0,0
6586,28,107,57,110,94,0,1413.678,60,2162.103,MORE,-740,1152,412,2,1,-16,-1.499853537,16,1.222253018,1.16975307,-0.896881183,204,110,94,1,0.877581209,1.170500555,0.546233592,-0.947015629,-1.102290093,1.102290093,0.546233592,1.170500555,1,0,0
6587,28,108,39,80,66,0,1406.06,60,1232.107,MORE,-448,822,374,2,1,-14,-1.312371845,14,0.87303787,1.16975307,-0.904314482,146,80,66,1,-0.279230385,0,-0.546233592,-0.947015629,-0.472574349,0.472574349,-0.546233592,0,1,0,0
6588,28,109,4,50,54,0,1984.556,60,1392.078,MORE,-272,1052,780,4,1,4,0.374963384,4,-0.87303787,1.16975307,-0.339844334,104,50,54,0,-1.116921539,-1.170500555,-1.014433814,0.528852884,-0.093019654,0.093019654,-1.014433814,-1.170500555,1,1,0
6589,28,110,55,98,110,0,1729.361,60,2657.47,MORE,-886,1326,440,2,1,12,1.124890153,12,0.523822722,1.16975307,-0.588852036,208,98,110,0,0.957361319,0.702300333,1.170500555,-0.947015629,-1.417147965,1.417147965,1.170500555,0.702300333,1,0,0
6590,28,111,2,50,52,1,1893.587,60,1515.056,MORE,208,800,1008,3,2,2,0.187481692,2,-1.222253018,1.16975307,-0.428607757,102,50,52,0,-1.156811594,-1.170500555,-1.092467184,-0.209081373,0.942129514,0.942129514,-1.092467184,-1.170500555,1,0,1
6591,28,112,59,110,89,0,1659.555,60,2153.562,MORE,-698,1112,414,2,1,-21,-1.968557767,21,2.095290887,1.16975307,-0.656965563,199,110,89,1,0.777856072,1.170500555,0.351150166,-0.947015629,-1.011714541,1.011714541,0.351150166,1.170500555,1,0,0
6592,28,113,60,87,110,1,1861.601,60,1702.036,MORE,214,780,994,3,2,23,2.15603946,23,2.444506035,1.16975307,-0.459818244,197,87,110,0,0.737966017,0.273116796,1.170500555,-0.209081373,0.955068878,0.955068878,1.170500555,0.273116796,1,0,1
6593,28,114,52,110,105,0,2189.725,60,1648.918,MORE,-762,1262,500,2,1,-5,-0.46870423,5,-0.698430296,1.16975307,-0.139649734,215,110,105,1,1.096976512,1.170500555,0.975417129,-0.947015629,-1.14973443,1.14973443,0.975417129,1.170500555,1,0,0
6594,28,115,30,80,96,1,1472.016,60,1619.519,MORE,236,904,1140,2,2,16,1.499853537,16,1.222253018,1.16975307,-0.83995761,176,80,96,0,0.31912044,0,0.624266962,-0.947015629,1.002513215,1.002513215,0.624266962,0,1,0,1
6595,28,116,24,80,86,0,2468.265,50,1859.87,MORE,-544,1252,708,1,1,6,0.562445076,6,-0.523822722,0.425082681,0.13213696,166,80,86,0,0.119670165,0,0.234100111,-1.684949886,-0.679604183,0.679604183,0.234100111,0,1,0,0
6596,28,117,5,50,55,1,1835.74,50,2334.708,MORE,-38,776,738,4,2,5,0.46870423,5,-0.698430296,0.425082681,-0.485052235,105,50,55,0,-1.096976512,-1.170500555,-0.975417129,0.528852884,0.411615565,0.411615565,-0.975417129,-1.170500555,1,1,1
6597,28,118,34,80,74,1,2070.189,50,1621.638,MORE,324,706,1030,3,2,-6,-0.562445076,6,-0.523822722,0.425082681,-0.256287539,154,80,74,1,-0.119670165,0,-0.234100111,-0.209081373,1.192290563,1.192290563,-0.234100111,0,0,0,1
6598,28,119,15,45,50,1,1764.396,30,2160.585,MORE,124,722,846,3,2,5,0.46870423,5,-0.698430296,-1.064258099,-0.554666473,95,45,50,0,-1.296426786,-1.36558398,-1.170500555,-0.209081373,0.760978409,0.760978409,-1.170500555,-1.36558398,0,0,1
6599,28,120,37,69,80,1,2566.94,40,2897.783,MORE,-590,1390,800,4,1,11,1.031149307,11,0.349215148,-0.319587709,0.228419547,149,69,80,0,-0.219395302,-0.429183537,0,0.528852884,-0.778805978,0.778805978,0,-0.429183537,0,1,0
6600,28,121,48,128,110,1,6297.532,40,1283.797,LESS,-256,1740,1484,9,2,-18,-1.687335229,18,1.571468165,-0.319587709,3.868561947,238,128,110,0,1.555712144,1.872800887,1.170500555,4.218524167,-0.058514682,0.058514682,1.170500555,1.872800887,1,1,1
6601,28,122,8,50,58,0,1401.089,40,1679.242,LESS,-672,1030,358,2,1,8,0.749926769,8,-0.174607574,-0.319587709,-0.909164958,108,50,58,1,-1.037141429,-1.170500555,-0.858367073,-0.947015629,-0.955643961,0.955643961,-0.858367073,-1.170500555,1,0,0
6602,28,123,4,54,50,1,2104.552,50,2421.526,LESS,34,890,924,3,1,-4,-0.374963384,4,-0.87303787,0.425082681,-0.222757682,104,54,50,0,-1.116921539,-1.014433814,-1.170500555,-0.209081373,0.56688794,0.56688794,-1.170500555,-1.014433814,1,1,1
6603,28,124,37,80,69,1,2359.182,30,1638.789,LESS,-420,1258,838,2,1,-11,-1.031149307,11,0.349215148,-1.064258099,0.025698718,149,80,69,0,-0.219395302,0,-0.429183537,-0.947015629,-0.412190648,0.412190648,-0.429183537,0,0,0,0
6604,28,125,52,105,110,1,3290.019,40,1502.123,LESS,162,1218,1380,4,2,5,0.46870423,5,-0.698430296,-0.319587709,0.933967226,215,105,110,1,1.096976512,0.975417129,1.170500555,0.528852884,0.842927718,0.842927718,1.170500555,0.975417129,1,1,1
6605,28,126,5,55,50,1,1893.093,20,936.468,LESS,-14,826,812,3,1,-5,-0.46870423,5,-0.698430296,-1.808928488,-0.42908978,105,55,50,0,-1.096976512,-0.975417129,-1.170500555,-0.209081373,0.463373023,0.463373023,-1.170500555,-0.975417129,0,1,1
6606,28,127,30,96,80,1,2076.873,30,1467.062,LESS,426,758,1184,3,2,-16,-1.499853537,16,1.222253018,-1.064258099,-0.249765595,176,96,80,0,0.31912044,0.624266962,0,-0.209081373,1.412259761,1.412259761,0,0.624266962,0,1,1
6607,28,128,33,80,75,1,1671.487,30,2222.445,LESS,46,916,962,3,1,-5,-0.46870423,5,-0.698430296,-1.064258099,-0.645322859,155,80,75,0,-0.099725137,0,-0.195083426,-0.209081373,0.592766669,0.592766669,-0.195083426,0,0,1,1
6608,28,129,48,110,128,0,1379.163,30,1290.153,LESS,-1140,1508,368,2,1,18,1.687335229,18,1.571468165,-1.064258099,-0.930559354,238,110,128,1,1.555712144,1.170500555,1.872800887,-0.947015629,-1.9649144,1.9649144,1.872800887,1.170500555,0,0,0
6609,28,130,9,59,50,0,1890.568,40,2576.768,LESS,-530,1176,646,2,2,-9,-0.843667615,9,0,-0.319587709,-0.43155356,109,59,50,0,-1.017196402,-0.819350388,-1.170500555,-0.947015629,-0.649412332,0.649412332,-1.170500555,-0.819350388,1,0,0
6610,28,131,44,110,119,1,1916.058,30,1317.807,LESS,388,722,1110,3,2,9,0.843667615,9,0,-1.064258099,-0.406681575,229,110,119,1,1.376206896,1.170500555,1.521650721,-0.209081373,1.330310452,1.330310452,1.521650721,1.170500555,0,0,1
6611,28,132,2,52,50,0,1265.762,40,1152.652,LESS,-440,846,406,2,1,-2,-0.187481692,2,-1.222253018,-0.319587709,-1.041210905,102,52,50,0,-1.156811594,-1.092467184,-1.170500555,-0.947015629,-0.455321863,0.455321863,-1.170500555,-1.092467184,1,0,0
6612,28,133,8,58,50,1,1345.468,30,1245.626,LESS,172,714,886,2,1,-8,-0.749926769,8,-0.174607574,-1.064258099,-0.963437406,108,58,50,0,-1.037141429,-0.858367073,-1.170500555,-0.947015629,0.864493326,0.864493326,-1.170500555,-0.858367073,0,0,1
6613,28,134,44,119,110,1,1792.846,40,1381.587,LESS,-136,892,756,3,1,-9,-0.843667615,9,0,-0.319587709,-0.526906254,229,119,110,0,1.376206896,1.521650721,1.170500555,-0.209081373,0.20027261,0.20027261,1.170500555,1.521650721,1,0,1
6614,28,135,34,74,80,0,4371.712,20,1366.908,LESS,-654,2152,1498,7,1,6,0.562445076,6,-0.523822722,-1.808928488,1.989434174,154,74,80,1,-0.119670165,-0.234100111,0,2.742655654,-0.916825867,0.916825867,0,-0.234100111,0,1,0
6615,28,136,24,86,80,1,1260.809,40,1700.477,LESS,344,354,698,1,2,-6,-0.562445076,6,-0.523822722,-0.319587709,-1.046043817,166,86,80,0,0.119670165,0.234100111,0,-1.684949886,1.235421778,1.235421778,0,0.234100111,1,0,1
6616,28,137,39,66,80,0,2755.008,40,1536.217,LESS,-324,1126,802,3,2,14,1.312371845,14,0.87303787,-0.319587709,0.411927768,146,66,80,1,-0.279230385,-0.546233592,0,-0.209081373,-0.205160814,0.205160814,0,-0.546233592,1,0,0
6617,28,138,9,50,59,0,1298.415,30,1763.397,LESS,-476,890,414,2,1,9,0.843667615,9,0,-1.064258099,-1.009349589,109,50,59,1,-1.017196402,-1.170500555,-0.819350388,-0.947015629,-0.532958051,0.532958051,-0.819350388,-1.170500555,0,0,0
6618,28,139,57,94,110,0,2360.726,30,826.483,LESS,-798,1548,750,4,1,16,1.499853537,16,1.222253018,-1.064258099,0.027205283,204,94,110,1,0.877581209,0.546233592,1.170500555,0.528852884,-1.227370618,1.227370618,1.170500555,0.546233592,0,1,0
6619,28,140,60,110,87,1,3837.262,40,913.723,LESS,318,1024,1342,2,2,-23,-2.15603946,23,2.444506035,-0.319587709,1.467942115,197,110,87,0,0.737966017,1.170500555,0.273116796,-0.947015629,1.179351198,1.179351198,0.273116796,1.170500555,1,0,1
6620,28,141,33,75,80,0,1772.353,30,1423.877,LESS,-746,1280,534,2,1,5,0.46870423,5,-0.698430296,-1.064258099,-0.546902393,155,75,80,1,-0.099725137,-0.195083426,0,-0.947015629,-1.115229458,1.115229458,0,-0.195083426,0,0,0
6621,28,142,15,50,45,1,2033.685,30,1662.506,LESS,214,834,1048,3,2,-5,-0.46870423,5,-0.698430296,-1.064258099,-0.291906485,95,50,45,0,-1.296426786,-1.170500555,-1.36558398,-0.209081373,0.955068878,0.955068878,-1.36558398,-1.170500555,0,0,1
6622,28,143,59,89,110,0,1944.72,60,1854.842,LESS,-684,1030,346,2,1,21,1.968557767,21,2.095290887,1.16975307,-0.378714496,199,89,110,1,0.777856072,0.351150166,1.170500555,-0.947015629,-0.98152269,0.98152269,1.170500555,0.351150166,1,0,0
6623,28,144,29,80,94,0,2595.402,60,1603.334,LESS,-472,1330,858,4,1,14,1.312371845,14,0.87303787,1.16975307,0.256191476,174,80,94,1,0.279230385,0,0.546233592,0.528852884,-0.524331808,0.524331808,0.546233592,0,1,1,0
6624,28,145,55,110,98,1,3124.884,70,1605.565,LESS,312,1338,1650,6,2,-12,-1.124890153,12,0.523822722,1.91442346,0.772835986,208,110,98,0,0.957361319,1.170500555,0.702300333,2.004721397,1.166411833,1.166411833,0.702300333,1.170500555,1,1,1
6625,28,146,29,94,80,1,1874.184,50,1716.922,LESS,184,824,1008,3,2,-14,-1.312371845,14,0.87303787,0.425082681,-0.447540324,174,94,80,0,0.279230385,0.546233592,0,-0.209081373,0.890372055,0.890372055,0,0.546233592,1,0,1
6626,28,147,57,110,94,1,1970.511,60,2105.297,LESS,114,732,846,3,2,-16,-1.499853537,16,1.222253018,1.16975307,-0.353548808,204,110,94,0,0.877581209,1.170500555,0.546233592,-0.209081373,0.739412802,0.739412802,0.546233592,1.170500555,1,0,1
6627,28,148,39,80,66,1,1708.575,50,1337.866,LESS,14,710,724,3,2,-14,-1.312371845,14,0.87303787,0.425082681,-0.609134072,146,80,66,0,-0.279230385,0,-0.546233592,-0.209081373,0.523756725,0.523756725,-0.546233592,0,1,0,1
6628,28,149,4,50,54,0,1147.188,60,1639.719,LESS,-418,810,392,2,1,4,0.374963384,4,-0.87303787,1.16975307,-1.156910034,104,50,54,1,-1.116921539,-1.170500555,-1.014433814,-0.947015629,-0.407877526,0.407877526,-1.014433814,-1.170500555,1,0,0
6629,28,150,55,98,110,0,1963.095,40,1374.175,LESS,-506,1192,686,4,1,12,1.124890153,12,0.523822722,-0.319587709,-0.360785004,208,98,110,1,0.957361319,0.702300333,1.170500555,0.528852884,-0.597654874,0.597654874,1.170500555,0.702300333,0,1,0
6630,28,151,2,50,52,0,1404.836,40,2258.436,LESS,-420,1060,640,2,1,2,0.187481692,2,-1.222253018,-0.319587709,-0.905508806,102,50,52,1,-1.156811594,-1.170500555,-1.092467184,-0.947015629,-0.412190648,0.412190648,-1.092467184,-1.170500555,0,0,0
6631,28,152,59,110,89,1,1831.547,60,1458.58,LESS,292,740,1032,3,2,-21,-1.968557767,21,2.095290887,1.16975307,-0.489143574,199,110,89,0,0.777856072,1.170500555,0.351150166,-0.209081373,1.123280618,1.123280618,0.351150166,1.170500555,1,0,1
6632,28,153,60,87,110,0,3129.259,30,1356.669,LESS,-874,1740,866,4,1,23,2.15603946,23,2.444506035,-1.064258099,0.777104913,197,87,110,1,0.737966017,0.273116796,1.170500555,0.528852884,-1.391269236,1.391269236,1.170500555,0.273116796,0,1,0
6633,28,154,52,110,105,1,5533.476,40,2265.879,LESS,716,1952,2668,6,2,-5,-0.46870423,5,-0.698430296,-0.319587709,3.123030771,215,110,105,0,1.096976512,1.170500555,0.975417129,2.004721397,2.037662383,2.037662383,0.975417129,1.170500555,0,1,1
6634,28,155,30,80,96,0,2495.93,80,418.32,LESS,-200,1298,1098,4,2,16,1.499853537,16,1.222253018,2.65909385,0.159131211,176,80,96,1,0.31912044,0,0.624266962,0.528852884,0.062252721,0.062252721,0.624266962,0,1,1,1
6635,28,156,24,80,86,0,1847.687,30,1585.25,LESS,-564,1042,478,2,1,6,0.562445076,6,-0.523822722,-1.064258099,-0.473394894,166,80,86,1,0.119670165,0,0.234100111,-0.947015629,-0.722735398,0.722735398,0.234100111,0,0,0,0
6636,28,157,5,50,55,0,1486.134,60,1948.906,LESS,238,564,802,2,2,5,0.46870423,5,-0.698430296,1.16975307,-0.826181906,105,50,55,1,-1.096976512,-1.170500555,-0.975417129,-0.947015629,1.006826337,1.006826337,-0.975417129,-1.170500555,1,0,1
6637,28,158,34,80,74,1,2800.127,60,1439.183,LESS,-126,830,704,4,1,-6,-0.562445076,6,-0.523822722,1.16975307,0.455952841,154,80,74,0,-0.119670165,0,-0.234100111,0.528852884,0.221838218,0.221838218,-0.234100111,0,1,1,1
6638,28,159,15,45,50,0,1148,40,1643.815,LESS,-742,1136,394,2,1,5,0.46870423,5,-0.698430296,-0.319587709,-1.156117721,95,45,50,1,-1.296426786,-1.36558398,-1.170500555,-0.947015629,-1.106603215,1.106603215,-1.170500555,-1.36558398,0,0,0
6639,28,160,37,69,80,0,1277.401,60,1393.118,LESS,-380,714,334,1,2,11,1.031149307,11,0.349215148,1.16975307,-1.029854097,149,69,80,1,-0.219395302,-0.429183537,0,-1.684949886,-0.325928217,0.325928217,0,-0.429183537,1,0,0
6640,28,161,3,50,53,0,2159.33,40,2155.921,MORE,72,1230,1302,5,2,3,0.281222538,3,-1.047645444,-0.319587709,-0.169307796,103,50,53,0,-1.136866566,-1.170500555,-1.053450499,1.266787141,0.648837249,0.648837249,-1.053450499,-1.170500555,0,1,1
6641,28,162,20,50,40,0,2488.713,40,1703.051,MORE,-344,1338,994,4,1,-10,-0.937408461,10,0.174607574,-0.319587709,0.15208919,90,50,40,1,-1.396151924,-1.170500555,-1.560667406,0.528852884,-0.24829203,0.24829203,-1.560667406,-1.170500555,0,1,0
6642,28,163,25,80,88,1,1611.472,70,1403.743,MORE,-76,730,654,4,2,8,0.749926769,8,-0.174607574,1.91442346,-0.703882773,168,80,88,0,0.15956022,0,0.312133481,0.528852884,0.329666256,0.329666256,0.312133481,0,1,1,1
6643,28,164,42,115,110,0,1414.435,70,669.216,MORE,-604,1004,400,2,1,-5,-0.46870423,5,-0.698430296,1.91442346,-0.896142537,225,115,110,1,1.296426786,1.36558398,1.170500555,-0.947015629,-0.808997829,0.808997829,1.170500555,1.36558398,1,0,0
6644,28,165,53,103,110,1,2200.57,60,1204.977,MORE,-14,998,984,4,2,7,0.656185922,7,-0.349215148,1.16975307,-0.129067675,213,103,110,0,1.057086457,0.897383758,1.170500555,0.528852884,0.463373023,0.463373023,1.170500555,0.897383758,1,1,1
6645,28,166,26,90,80,1,2157.932,40,2873.828,MORE,-614,1326,712,3,2,-10,-0.937408461,10,0.174607574,-0.319587709,-0.1706719,170,90,80,1,0.199450275,0.390166852,0,-0.209081373,-0.830563437,0.830563437,0,0.390166852,0,0,0
6646,28,167,35,80,72,1,1588.725,50,1130.891,MORE,22,744,766,3,2,-8,-0.749926769,8,-0.174607574,0.425082681,-0.726078264,152,80,72,1,-0.15956022,0,-0.312133481,-0.209081373,0.541009211,0.541009211,-0.312133481,0,0,0,1
6647,28,168,28,93,80,0,1140.825,60,1596.126,MORE,-508,842,334,2,1,-13,-1.218630999,13,0.698430296,1.16975307,-1.16311876,173,93,80,1,0.259285357,0.507216907,0,-0.947015629,-0.601967995,0.601967995,0,0.507216907,1,0,0
6648,28,169,26,80,90,1,1770.784,60,1735.015,MORE,-4,780,776,3,1,10,0.937408461,10,0.174607574,1.16975307,-0.548433352,170,80,90,0,0.199450275,0,0.390166852,-0.209081373,0.484938631,0.484938631,0.390166852,0,1,0,1
6649,28,170,25,88,80,0,1158.955,60,2544.991,MORE,-708,1074,366,2,1,-8,-0.749926769,8,-0.174607574,1.16975307,-1.145428329,168,88,80,1,0.15956022,0.312133481,0,-0.947015629,-1.033280149,1.033280149,0,0.312133481,1,0,0
6650,28,171,36,80,70,0,1323.297,60,2837.073,MORE,-970,1326,356,2,1,-10,-0.937408461,10,0.174607574,1.16975307,-0.985070862,150,80,70,1,-0.199450275,0,-0.390166852,-0.947015629,-1.59829907,1.59829907,-0.390166852,0,1,0,0
6651,28,172,28,80,93,1,1678.715,70,826.833,MORE,226,540,766,3,2,13,1.218630999,13,0.698430296,1.91442346,-0.638270105,173,80,93,0,0.259285357,0,0.507216907,-0.209081373,0.980947608,0.980947608,0.507216907,0,1,0,1
6652,28,173,21,82,80,0,2269.262,60,1723.568,MORE,-492,1210,718,4,1,-2,-0.187481692,2,-1.222253018,1.16975307,-0.062041138,162,82,80,1,0.039890055,0.07803337,0,0.528852884,-0.567463023,0.567463023,0,0.07803337,1,1,0
6653,28,174,19,50,41,0,2093.765,80,891.753,MORE,340,1080,1420,4,2,-9,-0.843667615,9,0,2.65909385,-0.233283148,91,50,41,1,-1.376206896,-1.170500555,-1.521650721,0.528852884,1.226795535,1.226795535,-1.521650721,-1.170500555,1,1,1
6654,28,175,56,96,110,1,2250.652,60,1254.562,MORE,196,912,1108,2,2,14,1.312371845,14,0.87303787,1.16975307,-0.080199932,206,96,110,0,0.917471264,0.624266962,1.170500555,-0.947015629,0.916250785,0.916250785,1.170500555,0.624266962,1,0,1
6655,28,176,23,80,85,1,2292.908,40,1555.524,MORE,158,908,1066,2,1,5,0.46870423,5,-0.698430296,-0.319587709,-0.038968444,165,80,85,0,0.099725137,0,0.195083426,-0.947015629,0.834301475,0.834301475,0.195083426,0,0,0,1
6656,28,177,10,60,50,1,2159.21,40,1757.269,MORE,448,862,1310,3,2,-10,-0.937408461,10,0.174607574,-0.319587709,-0.169424886,110,60,50,1,-0.997251374,-0.780333703,-1.170500555,-0.209081373,1.459704098,1.459704098,-1.170500555,-0.780333703,0,0,1
6657,28,178,19,41,50,1,1787.445,50,1745.374,MORE,288,706,994,3,2,9,0.843667615,9,0,0.425082681,-0.532176304,91,41,50,0,-1.376206896,-1.521650721,-1.170500555,-0.209081373,1.114654375,1.114654375,-1.170500555,-1.521650721,0,0,1
6658,28,179,56,110,96,0,1305.127,30,1923.41,MORE,-522,952,430,2,1,-14,-1.312371845,14,0.87303787,-1.064258099,-1.002800324,206,110,96,1,0.917471264,1.170500555,0.624266962,-0.947015629,-0.632159846,0.632159846,0.624266962,1.170500555,0,0,0
6659,28,180,35,72,80,1,1742.888,40,1559.204,MORE,-4,886,882,3,1,8,0.749926769,8,-0.174607574,-0.319587709,-0.575653003,152,72,80,0,-0.15956022,-0.312133481,0,-0.209081373,0.484938631,0.484938631,0,-0.312133481,0,0,1
6660,28,181,11,49,50,1,1798.86,50,1605.643,MORE,-58,756,698,3,2,1,0.093740846,1,-1.396860592,0.425082681,-0.521038065,99,49,50,0,-1.216646676,-1.20951724,-1.170500555,-0.209081373,0.36848435,0.36848435,-1.170500555,-1.20951724,1,0,1
6661,28,182,17,43,50,1,1404.867,50,1521.212,MORE,120,624,744,3,2,7,0.656185922,7,-0.349215148,0.425082681,-0.905478557,93,43,50,0,-1.336316841,-1.443617351,-1.170500555,-0.209081373,0.752352166,0.752352166,-1.170500555,-1.443617351,0,0,1
6662,28,183,1,51,50,1,3310.125,50,2198.408,MORE,-252,1564,1312,4,1,-1,-0.093740846,1,-1.396860592,0.425082681,0.953585749,101,51,50,1,-1.176756621,-1.131483869,-1.170500555,0.528852884,-0.049888439,0.049888439,-1.170500555,-1.131483869,1,1,0
6663,28,184,41,112,110,0,2951.529,40,2708.357,MORE,-350,1724,1374,4,2,-2,-0.187481692,2,-1.222253018,-0.319587709,0.603684043,222,112,110,1,1.236591704,1.248533925,1.170500555,0.528852884,-0.261231394,0.261231394,1.170500555,1.248533925,0,1,0
6664,28,185,20,40,50,1,2557.18,40,1716.949,MORE,722,800,1522,3,2,10,0.937408461,10,0.174607574,-0.319587709,0.218896182,90,40,50,0,-1.396151924,-1.560667406,-1.170500555,-0.209081373,2.050601748,2.050601748,-1.170500555,-1.560667406,0,0,1
6665,28,186,1,50,51,1,1978.016,50,2263.453,MORE,16,914,930,2,2,1,0.093740846,1,-1.396860592,0.425082681,-0.34622577,101,50,51,0,-1.176756621,-1.170500555,-1.131483869,-0.947015629,0.528069846,0.528069846,-1.131483869,-1.170500555,0,0,1
6666,28,187,23,85,80,1,2645.023,50,1639.353,MORE,-158,1070,912,3,1,-5,-0.46870423,5,-0.698430296,0.425082681,0.304609396,165,85,80,1,0.099725137,0.195083426,0,-0.209081373,0.152828273,0.152828273,0,0.195083426,0,0,0
6667,28,188,11,50,49,1,1501.464,40,1491.174,MORE,174,610,784,3,2,-1,-0.093740846,1,-1.396860592,-0.319587709,-0.811223588,99,50,49,1,-1.216646676,-1.170500555,-1.20951724,-0.209081373,0.868806448,0.868806448,-1.20951724,-1.170500555,0,0,1
6668,28,189,17,50,43,0,1488.466,40,1823.809,MORE,-1228,1614,386,2,1,-7,-0.656185922,7,-0.349215148,-0.319587709,-0.823906447,93,50,43,1,-1.336316841,-1.170500555,-1.443617351,-0.947015629,-2.154691748,2.154691748,-1.443617351,-1.170500555,0,0,0
6669,28,190,21,80,82,1,1986.598,30,1299.484,MORE,180,1012,1192,3,2,2,0.187481692,2,-1.222253018,-1.064258099,-0.337851843,162,80,82,0,0.039890055,0,0.07803337,-0.209081373,0.881745812,0.881745812,0.07803337,0,0,0,1
6670,28,191,10,50,60,1,1781.49,50,2017.903,MORE,-320,1158,838,4,1,10,0.937408461,10,0.174607574,0.425082681,-0.537986923,110,50,60,0,-0.997251374,-1.170500555,-0.780333703,0.528852884,-0.196534571,0.196534571,-0.780333703,-1.170500555,1,1,0
6671,28,192,3,53,50,0,2184.128,40,1755.743,MORE,-788,1382,594,3,1,-3,-0.281222538,3,-1.047645444,-0.319587709,-0.145111032,103,53,50,1,-1.136866566,-1.053450499,-1.170500555,-0.209081373,-1.20580501,1.20580501,-1.170500555,-1.053450499,0,0,0
6672,28,193,45,122,110,0,1408.63,60,1616.333,MORE,-358,786,428,2,1,-12,-1.124890153,12,0.523822722,1.16975307,-0.901806793,232,122,110,1,1.436041979,1.638700776,1.170500555,-0.947015629,-0.27848388,0.27848388,1.170500555,1.638700776,1,0,0
6673,28,194,38,67,80,1,1646.805,30,2512.201,MORE,-564,1470,906,3,1,13,1.218630999,13,0.698430296,-1.064258099,-0.669406435,147,67,80,0,-0.259285357,-0.507216907,0,-0.209081373,-0.722735398,0.722735398,0,-0.507216907,0,0,0
6674,28,195,38,80,67,0,2586.648,50,1762.299,MORE,-1110,1880,770,4,1,-13,-1.218630999,13,0.698430296,0.425082681,0.24764972,147,80,67,1,-0.259285357,0,-0.507216907,0.528852884,-1.900217577,1.900217577,-0.507216907,0,1,1,0
6675,28,196,36,70,80,1,2204.263,60,2261.313,MORE,216,874,1090,2,1,10,0.937408461,10,0.174607574,1.16975307,-0.125464213,150,70,80,0,-0.199450275,-0.390166852,0,-0.947015629,0.959382,0.959382,0,-0.390166852,1,0,1
6676,28,197,45,110,122,0,2057.507,40,1822.36,MORE,-908,1608,700,1,1,12,1.124890153,12,0.523822722,-0.319587709,-0.268662059,232,110,122,0,1.436041979,1.170500555,1.638700776,-1.684949886,-1.464592302,1.464592302,1.638700776,1.170500555,0,0,0
6677,28,198,42,110,115,1,1726.428,40,1205.561,MORE,298,706,1004,3,2,5,0.46870423,5,-0.698430296,-0.319587709,-0.591713924,225,110,115,0,1.296426786,1.170500555,1.36558398,-0.209081373,1.136219983,1.136219983,1.36558398,1.170500555,0,0,1
6678,28,199,41,110,112,1,1897.421,50,1855.817,MORE,236,772,1008,3,2,2,0.187481692,2,-1.222253018,0.425082681,-0.424866714,222,110,112,0,1.236591704,1.170500555,1.248533925,-0.209081373,1.002513215,1.002513215,1.248533925,1.170500555,0,0,1
6679,28,200,53,110,103,0,2529.854,30,1644.753,MORE,-364,1368,1004,4,1,-7,-0.656185922,7,-0.349215148,-1.064258099,0.192232711,213,110,103,1,1.057086457,1.170500555,0.897383758,0.528852884,-0.291423245,0.291423245,0.897383758,1.170500555,0,1,0
6680,28,201,3,50,53,0,2797.915,30,1379.286,LESS,-886,1600,714,4,1,3,0.281222538,3,-1.047645444,-1.064258099,0.453794472,103,50,53,1,-1.136866566,-1.170500555,-1.053450499,0.528852884,-1.417147965,1.417147965,-1.053450499,-1.170500555,0,1,0
6681,28,202,20,50,40,1,1747.437,50,1348.484,LESS,176,806,982,3,1,-10,-0.937408461,10,0.174607574,0.425082681,-0.571214295,90,50,40,0,-1.396151924,-1.170500555,-1.560667406,-0.209081373,0.873119569,0.873119569,-1.560667406,-1.170500555,1,0,1
6682,28,203,25,80,88,0,1347.686,50,1237.307,LESS,-354,892,538,3,2,8,0.749926769,8,-0.174607574,0.425082681,-0.961273183,168,80,88,1,0.15956022,0,0.312133481,-0.209081373,-0.269857637,0.269857637,0.312133481,0,1,0,0
6683,28,204,42,115,110,0,1417.795,40,1503.591,LESS,-746,1090,344,2,1,-5,-0.46870423,5,-0.698430296,-0.319587709,-0.892864002,225,115,110,0,1.296426786,1.36558398,1.170500555,-0.947015629,-1.115229458,1.115229458,1.170500555,1.36558398,0,0,0
6684,28,205,53,103,110,0,2121.816,40,1433.671,LESS,-434,1184,750,4,1,7,0.656185922,7,-0.349215148,-0.319587709,-0.205912255,213,103,110,1,1.057086457,0.897383758,1.170500555,0.528852884,-0.442382499,0.442382499,1.170500555,0.897383758,0,1,0
6685,28,206,26,90,80,1,2185.408,60,1791.182,LESS,262,834,1096,3,2,-10,-0.937408461,10,0.174607574,1.16975307,-0.143862066,170,90,80,0,0.199450275,0.390166852,0,-0.209081373,1.058583795,1.058583795,0,0.390166852,1,0,1
6686,28,207,35,80,72,1,5207.333,60,1724.733,LESS,-12,2408,2396,6,2,-8,-0.749926769,8,-0.174607574,1.16975307,2.80479523,152,80,72,0,-0.15956022,0,-0.312133481,2.004721397,0.467686145,0.467686145,-0.312133481,0,1,1,1
6687,28,208,28,93,80,1,2165.593,20,1982.195,LESS,-280,1458,1178,3,1,-13,-1.218630999,13,0.698430296,-1.808928488,-0.163196644,173,93,80,0,0.259285357,0.507216907,0,-0.209081373,-0.110272141,0.110272141,0,0.507216907,0,0,0
6688,28,209,26,80,90,0,2110.669,20,755.43,LESS,-692,1386,694,4,1,10,0.937408461,10,0.174607574,-1.808928488,-0.216788991,170,80,90,1,0.199450275,0,0.390166852,0.528852884,-0.998775177,0.998775177,0.390166852,0,0,1,0
6689,28,210,25,88,80,1,2865.854,60,1260.194,LESS,328,1176,1504,5,2,-8,-0.749926769,8,-0.174607574,1.16975307,0.520086265,168,88,80,0,0.15956022,0.312133481,0,1.266787141,1.200916806,1.200916806,0,0.312133481,1,1,1
6690,28,211,36,80,70,1,1830.256,30,1822.569,LESS,-82,1210,1128,3,1,-10,-0.937408461,10,0.174607574,-1.064258099,-0.490403273,150,80,70,0,-0.199450275,0,-0.390166852,-0.209081373,0.316726891,0.316726891,-0.390166852,0,0,0,1
6691,28,212,28,80,93,0,2949.485,50,1736.475,LESS,-1066,2048,982,4,1,13,1.218630999,13,0.698430296,0.425082681,0.601689601,173,80,93,1,0.259285357,0,0.507216907,0.528852884,-1.805328903,1.805328903,0.507216907,0,1,1,0
6692,28,213,21,82,80,0,2504.76,40,1510.099,LESS,-482,1414,932,4,1,-2,-0.187481692,2,-1.222253018,-0.319587709,0.167747125,162,82,80,0,0.039890055,0.07803337,0,0.528852884,-0.545897415,0.545897415,0,0.07803337,0,1,0
6693,28,214,19,50,41,1,1805.355,50,1207.854,LESS,194,782,976,3,2,-9,-0.843667615,9,0,0.425082681,-0.514700539,91,50,41,0,-1.376206896,-1.170500555,-1.521650721,-0.209081373,0.911937663,0.911937663,-1.521650721,-1.170500555,1,1,1
6694,28,215,56,96,110,0,2436.003,40,1314.629,LESS,-692,1702,1010,4,1,14,1.312371845,14,0.87303787,-0.319587709,0.100657164,206,96,110,1,0.917471264,0.624266962,1.170500555,0.528852884,-0.998775177,0.998775177,1.170500555,0.624266962,0,1,0
6695,28,216,23,80,85,0,1165.694,20,955.801,LESS,-424,780,356,2,1,5,0.46870423,5,-0.698430296,-1.808928488,-1.138852719,165,80,85,1,0.099725137,0,0.195083426,-0.947015629,-0.420816891,0.420816891,0.195083426,0,0,0,0
6696,28,217,10,60,50,1,1898.451,60,2335.686,LESS,484,698,1182,3,2,-10,-0.937408461,10,0.174607574,1.16975307,-0.423861686,110,60,50,0,-0.997251374,-0.780333703,-1.170500555,-0.209081373,1.537340285,1.537340285,-1.170500555,-0.780333703,1,0,1
6697,28,218,19,41,50,0,2716.545,40,1123.14,LESS,-150,1294,1144,3,1,9,0.843667615,9,0,-0.319587709,0.374397318,91,41,50,1,-1.376206896,-1.521650721,-1.170500555,-0.209081373,0.170080759,0.170080759,-1.170500555,-1.521650721,0,0,1
6698,28,219,56,110,96,0,5059.486,30,2467.723,LESS,574,1860,2434,7,1,-14,-1.312371845,14,0.87303787,-1.064258099,2.660532836,206,110,96,0,0.917471264,1.170500555,0.624266962,2.742655654,1.731430754,1.731430754,0.624266962,1.170500555,0,1,1
6699,28,220,35,72,80,0,1643.581,30,819.57,LESS,-864,1272,408,2,1,8,0.749926769,8,-0.174607574,-1.064258099,-0.672552268,152,72,80,1,-0.15956022,-0.312133481,0,-0.947015629,-1.369703628,1.369703628,0,-0.312133481,0,0,0
6700,28,221,11,49,50,1,2790.734,30,1182.255,LESS,404,1048,1452,3,1,1,0.093740846,1,-1.396860592,-1.064258099,0.446787578,99,49,50,1,-1.216646676,-1.20951724,-1.170500555,-0.209081373,1.364815424,1.364815424,-1.170500555,-1.20951724,0,0,1
6701,28,222,17,43,50,0,1351.956,40,1438.262,LESS,-554,964,410,2,1,7,0.656185922,7,-0.349215148,-0.319587709,-0.95710671,93,43,50,1,-1.336316841,-1.443617351,-1.170500555,-0.947015629,-0.701169791,0.701169791,-1.170500555,-1.443617351,0,0,0
6702,28,223,1,51,50,0,1314.693,20,1037.344,LESS,-1006,1392,386,2,1,-1,-0.093740846,1,-1.396860592,-1.808928488,-0.993466255,101,51,50,0,-1.176756621,-1.131483869,-1.170500555,-0.947015629,-1.675935257,1.675935257,-1.170500555,-1.131483869,0,0,0
6703,28,224,41,112,110,1,1949.92,50,1478.194,LESS,50,942,992,3,1,-2,-0.187481692,2,-1.222253018,0.425082681,-0.373640572,222,112,110,0,1.236591704,1.248533925,1.170500555,-0.209081373,0.601392913,0.601392913,1.170500555,1.248533925,1,0,1
6704,28,225,20,40,50,0,1411.48,40,2330.187,LESS,-1678,2094,416,2,1,10,0.937408461,10,0.174607574,-0.319587709,-0.899025892,90,40,50,1,-1.396151924,-1.560667406,-1.170500555,-0.947015629,-3.125144093,3.125144093,-1.170500555,-1.560667406,0,0,0
6705,28,226,1,50,51,1,1795.223,40,1985.472,LESS,-228,1080,852,3,1,1,0.093740846,1,-1.396860592,-0.319587709,-0.524586885,101,50,51,1,-1.176756621,-1.170500555,-1.131483869,-0.209081373,0.001869019,0.001869019,-1.131483869,-1.170500555,0,1,1
6706,28,227,23,85,80,1,1928.204,40,1436.605,LESS,84,930,1014,3,1,-5,-0.46870423,5,-0.698430296,-0.319587709,-0.394830059,165,85,80,0,0.099725137,0.195083426,0,-0.209081373,0.674715979,0.674715979,0,0.195083426,0,1,1
6707,28,228,11,50,49,0,1282.97,20,1649.184,LESS,-1324,1690,366,2,1,-1,-0.093740846,1,-1.396860592,-1.808928488,-1.024420119,99,50,49,0,-1.216646676,-1.170500555,-1.20951724,-0.947015629,-2.361721581,2.361721581,-1.20951724,-1.170500555,0,0,0
6708,28,229,17,50,43,0,1320.439,30,801.719,LESS,-548,930,382,2,1,-7,-0.656185922,7,-0.349215148,-1.064258099,-0.987859569,93,50,43,0,-1.336316841,-1.170500555,-1.443617351,-0.947015629,-0.688230426,0.688230426,-1.443617351,-1.170500555,0,0,0
6709,28,230,21,80,82,0,1425.702,10,545.45,LESS,-860,1202,342,2,1,2,0.187481692,2,-1.222253018,-2.553598878,-0.88514871,162,80,82,1,0.039890055,0,0.07803337,-0.947015629,-1.361077385,1.361077385,0.07803337,0,0,0,0
6710,28,231,10,50,60,0,1091.249,50,1380.885,LESS,-418,790,372,2,1,10,0.937408461,10,0.174607574,0.425082681,-1.211492772,110,50,60,1,-0.997251374,-1.170500555,-0.780333703,-0.947015629,-0.407877526,0.407877526,-0.780333703,-1.170500555,1,0,0
6711,28,232,3,53,50,0,1135.555,40,1462.204,LESS,-900,1260,360,2,1,-3,-0.281222538,3,-1.047645444,-0.319587709,-1.168260987,103,53,50,0,-1.136866566,-1.053450499,-1.170500555,-0.947015629,-1.447339816,1.447339816,-1.170500555,-1.053450499,0,0,0
6712,28,233,45,122,110,1,1952.816,40,2242.788,LESS,458,660,1118,2,2,-12,-1.124890153,12,0.523822722,-0.319587709,-0.370814786,232,122,110,0,1.436041979,1.638700776,1.170500555,-0.947015629,1.481269705,1.481269705,1.170500555,1.638700776,1,0,1
6713,28,234,38,67,80,0,1114.602,40,1539.823,LESS,-360,738,378,2,1,13,1.218630999,13,0.698430296,-0.319587709,-1.188705974,147,67,80,1,-0.259285357,-0.507216907,0,-0.947015629,-0.282797002,0.282797002,0,-0.507216907,1,0,0
6714,28,235,38,80,67,1,1701.323,40,1424.702,LESS,184,700,884,3,2,-13,-1.218630999,13,0.698430296,-0.319587709,-0.616210244,147,80,67,0,-0.259285357,0,-0.507216907,-0.209081373,0.890372055,0.890372055,-0.507216907,0,0,0,1
6715,28,236,36,70,80,0,1118.927,40,1194.378,LESS,-418,762,344,2,1,10,0.937408461,10,0.174607574,-0.319587709,-1.184485835,150,70,80,1,-0.199450275,-0.390166852,0,-0.947015629,-0.407877526,0.407877526,0,-0.390166852,0,0,0
6716,28,237,45,110,122,0,2236.474,40,1346.863,LESS,-216,1092,876,4,1,12,1.124890153,12,0.523822722,-0.319587709,-0.094034181,232,110,122,1,1.436041979,1.170500555,1.638700776,0.528852884,0.027747749,0.027747749,1.638700776,1.170500555,0,1,1
6717,28,238,42,110,115,0,2228.576,30,1535.247,LESS,-438,1304,866,4,1,5,0.46870423,5,-0.698430296,-1.064258099,-0.101740691,225,110,115,1,1.296426786,1.170500555,1.36558398,0.528852884,-0.451008742,0.451008742,1.36558398,1.170500555,0,1,0
6718,28,239,41,110,112,1,2740.866,30,1337.718,LESS,-402,1688,1286,5,1,2,0.187481692,2,-1.222253018,-1.064258099,0.398128646,222,110,112,1,1.236591704,1.170500555,1.248533925,1.266787141,-0.373372554,0.373372554,1.248533925,1.170500555,0,1,0
6719,28,240,53,110,103,0,2461.829,30,1602.804,LESS,-1170,2006,836,4,1,-7,-0.656185922,7,-0.349215148,-1.064258099,0.125857003,213,110,103,0,1.057086457,1.170500555,0.897383758,0.528852884,-2.029611223,2.029611223,0.897383758,1.170500555,0,1,0
6720,29,1,49,110,131,0,2307.362,4,2276.424,LESS,-1280,2322,1042,4,1,21,1.968557767,21,2.095290887,-1.594341988,0.879019701,241,110,131,1,1.615547226,1.170500555,1.989850943,1.539968035,-1.64285222,1.64285222,1.989850943,1.170500555,0,1,0
6721,29,2,13,47,50,0,3727.04,0,2195.545,LESS,-1982,3444,1462,4,1,3,0.281222538,3,-1.047645444,-1.713880282,3.647925588,97,47,50,1,-1.256536731,-1.28755061,-1.170500555,1.539968035,-2.503446399,2.503446399,-1.170500555,-1.28755061,0,1,0
6722,29,3,16,50,44,1,2097.398,74,1632.437,LESS,502,722,1224,3,2,-6,-0.562445076,6,-0.523822722,0.497578146,0.469510957,94,50,44,0,-1.316371814,-1.170500555,-1.404600665,0.423374898,0.541733002,0.541733002,-1.404600665,-1.170500555,1,1,1
6723,29,4,7,57,50,1,2346.408,84,1837.604,LESS,792,812,1604,3,2,-7,-0.656185922,7,-0.349215148,0.79642388,0.955174082,107,57,50,0,-1.057086457,-0.897383758,-1.170500555,0.423374898,0.897249116,0.897249116,-1.170500555,-0.897383758,1,1,1
6724,29,5,18,42,50,0,1552.626,100,928.061,LESS,20,1066,1086,3,2,8,0.749926769,8,-0.174607574,1.274577053,-0.592999273,92,42,50,1,-1.356261869,-1.482634036,-1.170500555,0.423374898,-0.049159297,0.049159297,-1.170500555,-1.482634036,1,1,1
6725,29,6,51,108,110,1,1965.545,14,1272.365,LESS,80,1112,1192,4,1,2,0.187481692,2,-1.222253018,-1.295496255,0.212348031,218,108,110,1,1.156811594,1.092467184,1.170500555,1.539968035,0.024395761,0.024395761,1.170500555,1.092467184,0,1,1
6726,29,7,31,78,80,0,2016.642,94,2010.782,LESS,776,1122,1898,2,2,2,0.187481692,2,-1.222253018,1.095269613,0.312006393,158,78,80,1,-0.039890055,-0.07803337,0,-0.693218239,0.877634434,0.877634434,0,-0.07803337,1,0,1
6727,29,8,58,110,92,1,1999.75,100,1055.109,LESS,1490,624,2114,3,2,-18,-1.687335229,18,1.571468165,1.274577053,0.279060642,202,110,92,0,0.837691154,1.170500555,0.468200222,0.423374898,1.752939624,1.752939624,0.468200222,1.170500555,1,1,1
6728,29,9,12,50,48,0,2637.325,54,1593.303,LESS,-426,1410,984,4,1,-2,-0.187481692,2,-1.222253018,-0.100113321,1.522571615,98,50,48,0,-1.236591704,-1.170500555,-1.248533925,1.539968035,-0.595918562,0.595918562,-1.248533925,-1.170500555,0,1,0
6729,29,10,54,110,101,1,2055.193,64,1058.53,LESS,248,750,998,3,2,-9,-0.843667615,9,0,0.198732413,0.387195338,211,110,101,0,1.017196402,1.170500555,0.819350388,0.423374898,0.230349923,0.230349923,0.819350388,1.170500555,0,1,1
6730,29,11,14,46,50,0,1455.74,100,1053.635,LESS,-162,1032,870,2,2,4,0.374963384,4,-0.87303787,1.274577053,-0.781963401,96,46,50,1,-1.276481759,-1.326567295,-1.170500555,-0.693218239,-0.272276306,0.272276306,-1.170500555,-1.326567295,1,0,0
6731,29,12,22,80,83,1,2133.939,54,1527.317,LESS,620,854,1474,3,2,3,0.281222538,3,-1.047645444,-0.100113321,0.540779646,163,80,83,1,0.059835082,0,0.117050055,0.423374898,0.686391283,0.686391283,0.117050055,0,0,1,1
6732,29,13,6,50,56,0,2207.377,14,2949.62,LESS,-1516,2194,678,2,1,6,0.562445076,6,-0.523822722,-1.295496255,0.684011358,106,50,56,1,-1.077031484,-1.170500555,-0.936400444,-0.693218239,-1.932168782,1.932168782,-0.936400444,-1.170500555,0,0,0
6733,29,14,13,50,47,0,1621.04,4,2207.535,LESS,-1834,2302,468,2,1,-3,-0.281222538,3,-1.047645444,-1.594341988,-0.45956625,97,50,47,0,-1.256536731,-1.170500555,-1.28755061,-0.693218239,-2.322010589,2.322010589,-1.28755061,-1.170500555,0,0,0
6734,29,15,46,110,124,0,1620.499,64,1800.042,LESS,-288,1032,744,2,2,14,1.312371845,14,0.87303787,0.198732413,-0.460621403,234,110,124,1,1.475932034,1.170500555,1.716734147,-0.693218239,-0.426741928,0.426741928,1.716734147,1.170500555,1,0,0
6735,29,16,27,91,80,1,2113.161,94,2258.088,LESS,2414,706,3120,3,2,-11,-1.031149307,11,0.349215148,1.095269613,0.500254733,171,91,80,0,0.219395302,0.429183537,0,0.423374898,2.885687517,2.885687517,0,0.429183537,1,1,1
6736,29,17,40,64,80,0,1347.364,100,1115.451,LESS,160,804,964,2,2,16,1.499853537,16,1.222253018,1.274577053,-0.993337349,144,64,80,1,-0.31912044,-0.624266962,0,-0.693218239,0.122469172,0.122469172,0,-0.624266962,1,0,1
6737,29,18,22,83,80,1,1945.038,64,2055.755,LESS,376,860,1236,3,1,-3,-0.281222538,3,-1.047645444,0.198732413,0.172351671,163,83,80,0,0.059835082,0.117050055,0,0.423374898,0.38726738,0.38726738,0,0.117050055,0,1,1
6738,29,19,54,101,110,0,1461.631,74,932.383,LESS,-492,916,424,2,1,9,0.843667615,9,0,0.497578146,-0.770473736,211,101,110,1,1.017196402,0.819350388,1.170500555,-0.693218239,-0.676829125,0.676829125,1.170500555,0.819350388,1,0,0
6739,29,20,6,56,50,0,1986.005,0,1446.98,LESS,-1628,2230,602,2,1,-6,-0.562445076,6,-0.523822722,-1.713880282,0.252252724,106,56,50,0,-1.077031484,-0.936400444,-1.170500555,-0.693218239,-2.069471557,2.069471557,-1.170500555,-0.936400444,0,0,0
6740,29,21,18,50,42,0,2873.722,0,2435.405,LESS,-1640,2794,1154,4,1,-8,-0.749926769,8,-0.174607574,-1.713880282,1.983634648,92,50,42,0,-1.356261869,-1.170500555,-1.482634036,1.539968035,-2.084182568,2.084182568,-1.482634036,-1.170500555,0,1,0
6741,29,22,43,110,117,1,3685.171,0,1071.685,LESS,-372,2220,1848,6,1,7,0.656185922,7,-0.349215148,-1.713880282,3.566265295,227,110,117,1,1.336316841,1.170500555,1.443617351,3.773154308,-0.529719009,0.529719009,1.443617351,1.170500555,0,1,0
6742,29,23,32,77,80,0,2989.911,4,1332.542,LESS,-1342,2514,1172,4,1,3,0.281222538,3,-1.047645444,-1.594341988,2.210246884,157,77,80,1,-0.059835082,-0.117050055,0,1.539968035,-1.718859114,1.718859114,0,-0.117050055,0,1,0
6743,29,24,27,80,91,0,1489.596,84,1442.203,LESS,-688,1126,438,2,2,11,1.031149307,11,0.349215148,0.79642388,-0.715931471,171,80,91,1,0.219395302,0,0.429183537,-0.693218239,-0.917108981,0.917108981,0.429183537,0,1,0,0
6744,29,25,16,44,50,0,1718.262,74,1447.272,LESS,-512,1078,566,2,2,6,0.562445076,6,-0.523822722,0.497578146,-0.269946795,94,44,50,1,-1.316371814,-1.404600665,-1.170500555,-0.693218239,-0.701347478,0.701347478,-1.170500555,-1.404600665,1,0,0
6745,29,26,7,50,57,0,1651.589,24,1990.177,LESS,-610,1110,500,2,1,7,0.656185922,7,-0.349215148,-0.996650521,-0.399984213,107,50,57,1,-1.057086457,-1.170500555,-0.897383758,-0.693218239,-0.821487406,0.821487406,-0.897383758,-1.170500555,0,0,0
6746,29,27,14,50,46,0,1406.508,100,2647.007,LESS,794,948,1742,2,2,-4,-0.374963384,4,-0.87303787,1.274577053,-0.877984312,96,50,46,0,-1.276481759,-1.170500555,-1.326567295,-0.693218239,0.899700951,0.899700951,-1.326567295,-1.170500555,1,0,1
6747,29,28,51,110,108,1,1894.46,74,1224.099,LESS,312,678,990,3,2,-2,-0.187481692,2,-1.222253018,0.497578146,0.073705554,218,110,108,0,1.156811594,1.170500555,1.092467184,0.423374898,0.308808652,0.308808652,1.092467184,1.170500555,1,1,1
6748,29,29,50,133,110,1,1955.987,64,1549.529,LESS,366,660,1026,3,2,-23,-2.15603946,23,2.444506035,0.198732413,0.193706337,243,133,110,0,1.655437281,2.067884313,1.170500555,0.423374898,0.375008204,0.375008204,1.170500555,2.067884313,0,1,1
6749,29,30,49,131,110,1,2029.414,74,1496.082,LESS,308,740,1048,3,2,-21,-1.968557767,21,2.095290887,0.497578146,0.336916595,241,131,110,0,1.615547226,1.989850943,1.170500555,0.423374898,0.303904981,0.303904981,1.170500555,1.989850943,1,1,1
6750,29,31,47,126,110,0,1618.197,0,1126.66,LESS,-1534,1986,452,2,1,-16,-1.499853537,16,1.222253018,-1.713880282,-0.465111169,236,126,110,0,1.515822089,1.794767517,1.170500555,-0.693218239,-1.954235299,1.954235299,1.170500555,1.794767517,0,0,0
6751,29,32,50,110,133,0,1427.059,100,652.335,LESS,-266,1112,846,3,2,23,2.15603946,23,2.444506035,1.274577053,-0.837902135,243,110,133,1,1.655437281,1.170500555,2.067884313,0.423374898,-0.39977174,0.39977174,2.067884313,1.170500555,1,1,0
6752,29,33,47,110,126,0,1549.827,0,2110.754,LESS,-1970,2414,444,2,1,16,1.499853537,16,1.222253018,-1.713880282,-0.598458375,236,110,126,1,1.515822089,1.170500555,1.794767517,-0.693218239,-2.488735387,2.488735387,1.794767517,1.170500555,0,0,0
6753,29,34,12,48,50,0,1447.861,100,1867.96,LESS,490,1142,1632,2,1,2,0.187481692,2,-1.222253018,1.274577053,-0.797330413,98,48,50,1,-1.236591704,-1.248533925,-1.170500555,-0.693218239,0.527021991,0.527021991,-1.170500555,-1.248533925,1,0,1
6754,29,35,32,80,77,1,2712.057,4,1340.009,LESS,-52,1530,1478,3,1,-3,-0.281222538,3,-1.047645444,-1.594341988,1.668327113,157,80,77,0,-0.059835082,0,-0.117050055,0.423374898,-0.137425367,0.137425367,-0.117050055,0,0,1,0
6755,29,36,43,117,110,1,1603.18,74,1581.554,LESS,1770,308,2078,1,2,-7,-0.656185922,7,-0.349215148,0.497578146,-0.494399965,227,117,110,0,1.336316841,1.443617351,1.170500555,-1.809811376,2.096196561,2.096196561,1.170500555,1.443617351,1,0,1
6756,29,37,40,80,64,1,1527.441,64,1724.094,LESS,368,458,826,1,2,-16,-1.499853537,16,1.222253018,0.198732413,-0.642119492,144,80,64,0,-0.31912044,0,-0.624266962,-1.809811376,0.377460039,0.377460039,-0.624266962,0,0,0,1
6757,29,38,31,80,78,1,2162.75,34,1573.917,LESS,78,950,1028,3,2,-2,-0.187481692,2,-1.222253018,-0.697804788,0.596971929,158,80,78,0,-0.039890055,0,-0.07803337,0.423374898,0.021943926,0.021943926,-0.07803337,0,0,1,1
6758,29,39,46,124,110,0,2738.155,4,1971.786,LESS,-1874,2860,986,4,1,-14,-1.312371845,14,0.87303787,-1.594341988,1.719228026,234,124,110,0,1.475932034,1.716734147,1.170500555,1.539968035,-2.371047295,2.371047295,1.170500555,1.716734147,0,1,0
6759,29,40,58,92,110,0,1592.157,94,1659.02,LESS,446,1298,1744,2,1,18,1.687335229,18,1.571468165,1.095269613,-0.515898959,202,92,110,1,0.837691154,0.468200222,1.170500555,-0.693218239,0.473081615,0.473081615,1.170500555,0.468200222,1,0,1
6760,29,41,49,110,131,1,2625.011,84,1788.54,MORE,1250,930,2180,3,2,21,1.968557767,21,2.095290887,0.79642388,1.498554685,241,110,131,0,1.615547226,1.170500555,1.989850943,0.423374898,1.458719392,1.458719392,1.989850943,1.170500555,1,1,1
6761,29,42,13,47,50,1,2022.252,74,1287.107,MORE,844,356,1200,1,2,3,0.281222538,3,-1.047645444,0.497578146,0.322948003,97,47,50,0,-1.256536731,-1.28755061,-1.170500555,-1.809811376,0.960996833,0.960996833,-1.170500555,-1.28755061,1,0,1
6762,29,43,16,50,44,0,1587.345,94,715.653,MORE,-118,1064,946,2,2,-6,-0.562445076,6,-0.523822722,1.095269613,-0.525284169,94,50,44,1,-1.316371814,-1.170500555,-1.404600665,-0.693218239,-0.21833593,0.21833593,-1.404600665,-1.170500555,1,0,0
6763,29,44,7,57,50,1,2544.321,4,1352.126,MORE,-490,1774,1284,3,1,-7,-0.656185922,7,-0.349215148,-1.594341988,1.341178846,107,57,50,1,-1.057086457,-0.897383758,-1.170500555,0.423374898,-0.67437729,0.67437729,-1.170500555,-0.897383758,0,1,0
6764,29,45,18,42,50,1,1134.701,100,1200.417,MORE,1318,368,1686,1,2,8,0.749926769,8,-0.174607574,1.274577053,-1.408110159,92,42,50,0,-1.356261869,-1.482634036,-1.170500555,-1.809811376,1.542081791,1.542081791,-1.170500555,-1.482634036,1,0,1
6765,29,46,51,108,110,1,2711.432,34,1047.216,MORE,-26,1160,1134,3,2,2,0.187481692,2,-1.222253018,-0.697804788,1.667108128,218,108,110,0,1.156811594,1.092467184,1.170500555,0.423374898,-0.105551508,0.105551508,1.170500555,1.092467184,0,1,0
6766,29,47,31,78,80,1,2270.95,4,2302.53,MORE,-1048,2138,1090,3,1,2,0.187481692,2,-1.222253018,-1.594341988,0.808002611,158,78,80,0,-0.039890055,-0.07803337,0,0.423374898,-1.358439329,1.358439329,0,-0.07803337,0,1,0
6767,29,48,58,110,92,0,1572.992,94,1498.209,MORE,774,872,1646,2,2,-18,-1.687335229,18,1.571468165,1.095269613,-0.553277915,202,110,92,1,0.837691154,1.170500555,0.468200222,-0.693218239,0.875182598,0.875182598,0.468200222,1.170500555,1,0,1
6768,29,49,12,50,48,1,1417.839,100,709.282,MORE,1176,340,1516,1,2,-2,-0.187481692,2,-1.222253018,1.274577053,-0.855884601,98,50,48,1,-1.236591704,-1.170500555,-1.248533925,-1.809811376,1.368001487,1.368001487,-1.248533925,-1.170500555,1,0,1
6769,29,50,54,110,101,0,1800.773,34,1718.085,MORE,-342,1038,696,2,2,-9,-0.843667615,9,0,-0.697804788,-0.109019322,211,110,101,1,1.017196402,1.170500555,0.819350388,-0.693218239,-0.49294148,0.49294148,0.819350388,1.170500555,0,0,0
6770,29,51,14,46,50,1,2680.177,74,924.195,MORE,608,876,1484,3,2,4,0.374963384,4,-0.87303787,0.497578146,1.606149126,96,46,50,0,-1.276481759,-1.326567295,-1.170500555,0.423374898,0.671680271,0.671680271,-1.170500555,-1.326567295,1,1,1
6771,29,52,22,80,83,1,1480.301,94,890.759,MORE,1210,356,1566,1,2,3,0.281222538,3,-1.047645444,1.095269613,-0.734060216,163,80,83,0,0.059835082,0,0.117050055,-1.809811376,1.409682687,1.409682687,0.117050055,0,1,0,1
6772,29,53,6,50,56,1,2127.983,100,2249.688,MORE,1300,888,2188,3,2,6,0.562445076,6,-0.523822722,1.274577053,0.529163206,106,50,56,0,-1.077031484,-1.170500555,-0.936400444,0.423374898,1.520015274,1.520015274,-0.936400444,-1.170500555,1,1,1
6773,29,54,13,50,47,1,1363.34,64,1535.394,MORE,388,330,718,1,2,-3,-0.281222538,3,-1.047645444,0.198732413,-0.962178143,97,50,47,1,-1.256536731,-1.170500555,-1.28755061,-1.809811376,0.401978392,0.401978392,-1.28755061,-1.170500555,1,0,1
6774,29,55,46,110,124,1,2241.911,100,638.739,MORE,580,880,1460,3,2,14,1.312371845,14,0.87303787,1.274577053,0.751365642,234,110,124,0,1.475932034,1.170500555,1.716734147,0.423374898,0.637354578,0.637354578,1.716734147,1.170500555,1,1,1
6775,29,56,27,91,80,0,1507.843,54,1290.633,MORE,-482,914,432,2,1,-11,-1.031149307,11,0.349215148,-0.100113321,-0.680342961,171,91,80,1,0.219395302,0.429183537,0,-0.693218239,-0.664569949,0.664569949,0,0.429183537,0,0,0
6776,29,57,40,64,80,1,1436.887,100,1949.376,MORE,1896,348,2244,1,2,16,1.499853537,16,1.222253018,1.274577053,-0.81873384,144,64,80,0,-0.31912044,-0.624266962,0,-1.809811376,2.250662183,2.250662183,0,-0.624266962,1,0,1
6777,29,58,22,83,80,1,2441.337,34,1770.541,MORE,338,884,1222,3,1,-3,-0.281222538,3,-1.047645444,-0.697804788,1.140321325,163,83,80,1,0.059835082,0.117050055,0,0.423374898,0.34068251,0.34068251,0,0.117050055,0,1,1
6778,29,59,54,101,110,1,2046.589,94,546.918,MORE,110,766,876,2,2,9,0.843667615,9,0,1.095269613,0.370414303,211,101,110,0,1.017196402,0.819350388,1.170500555,-0.693218239,0.06117329,0.06117329,1.170500555,0.819350388,1,0,0
6779,29,60,6,56,50,1,3059.759,4,1709.438,MORE,-282,1624,1342,3,1,-6,-0.562445076,6,-0.523822722,-1.594341988,2.346476746,106,56,50,1,-1.077031484,-0.936400444,-1.170500555,0.423374898,-0.419386422,0.419386422,-1.170500555,-0.936400444,0,1,0
6780,29,61,18,50,42,0,2743.615,24,1539.392,MORE,-444,1526,1082,4,1,-8,-0.749926769,8,-0.174607574,-0.996650521,1.729877079,92,50,42,1,-1.356261869,-1.170500555,-1.482634036,1.539968035,-0.617985079,0.617985079,-1.482634036,-1.170500555,0,1,0
6781,29,62,43,110,117,1,2354.465,54,1296.261,MORE,30,992,1022,3,2,7,0.656185922,7,-0.349215148,-0.100113321,0.970888262,227,110,117,0,1.336316841,1.170500555,1.443617351,0.423374898,-0.036900121,0.036900121,1.443617351,1.170500555,0,1,0
6782,29,63,32,77,80,0,1772.96,74,894.124,MORE,-28,1084,1056,2,2,3,0.281222538,3,-1.047645444,0.497578146,-0.163265129,157,77,80,0,-0.059835082,-0.117050055,0,-0.693218239,-0.108003343,0.108003343,0,-0.117050055,1,0,0
6783,29,64,27,80,91,1,1193.783,100,1659.519,MORE,1564,304,1868,1,2,11,1.031149307,11,0.349215148,1.274577053,-1.292878044,171,80,91,0,0.219395302,0,0.429183537,-1.809811376,1.843657529,1.843657529,0.429183537,0,1,0,1
6784,29,65,16,44,50,1,1566.408,44,1573.169,MORE,378,748,1126,2,2,6,0.562445076,6,-0.523822722,-0.398959054,-0.566119191,94,44,50,0,-1.316371814,-1.404600665,-1.170500555,-0.693218239,0.389719216,0.389719216,-1.170500555,-1.404600665,0,0,1
6785,29,66,7,50,57,0,2047.311,34,2038.618,MORE,-414,1308,894,2,2,7,0.656185922,7,-0.349215148,-0.697804788,0.371822474,107,50,57,0,-1.057086457,-1.170500555,-0.897383758,-0.693218239,-0.58120755,0.58120755,-0.897383758,-1.170500555,0,0,0
6786,29,67,14,50,46,0,3993.035,84,1357.763,MORE,-1772,2574,802,2,2,-4,-0.374963384,4,-0.87303787,0.79642388,4.166715849,96,50,46,1,-1.276481759,-1.170500555,-1.326567295,-0.693218239,-2.246003696,2.246003696,-1.326567295,-1.170500555,1,0,0
6787,29,68,51,110,108,0,3554.465,14,1500.506,MORE,-1124,2218,1094,4,1,-2,-0.187481692,2,-1.222253018,-1.295496255,3.311339451,218,110,108,1,1.156811594,1.170500555,1.092467184,1.539968035,-1.45160907,1.45160907,1.092467184,1.170500555,0,1,0
6788,29,69,50,133,110,0,1699.012,34,1143.171,MORE,-650,1062,412,2,1,-23,-2.15603946,23,2.444506035,-0.697804788,-0.307491533,243,133,110,1,1.655437281,2.067884313,1.170500555,-0.693218239,-0.870524111,0.870524111,1.170500555,2.067884313,0,0,0
6789,29,70,49,131,110,0,1700.664,74,1127.409,MORE,-234,1050,816,2,1,-21,-1.968557767,21,2.095290887,0.497578146,-0.304269512,241,131,110,1,1.615547226,1.989850943,1.170500555,-0.693218239,-0.360542376,0.360542376,1.170500555,1.989850943,1,0,0
6790,29,71,47,126,110,0,1732.599,64,941.417,MORE,-572,1044,472,2,1,-16,-1.499853537,16,1.222253018,0.198732413,-0.241984254,236,126,110,1,1.515822089,1.794767517,1.170500555,-0.693218239,-0.774902536,0.774902536,1.170500555,1.794767517,0,0,0
6791,29,72,50,110,133,1,1333.759,100,2169.929,MORE,1568,474,2042,1,2,23,2.15603946,23,2.444506035,1.274577053,-1.019872215,243,110,133,0,1.655437281,1.170500555,2.067884313,-1.809811376,1.848561199,1.848561199,2.067884313,1.170500555,1,0,1
6792,29,73,47,110,126,0,3034.337,0,1124.528,MORE,-986,2120,1134,4,1,16,1.499853537,16,1.222253018,-1.713880282,2.296894287,236,110,126,0,1.515822089,1.170500555,1.794767517,1.539968035,-1.282432436,1.282432436,1.794767517,1.170500555,0,1,0
6793,29,74,12,48,50,1,1806.022,44,1052.835,MORE,-42,736,694,3,2,2,0.187481692,2,-1.222253018,-0.398959054,-0.098781798,98,48,50,0,-1.236591704,-1.248533925,-1.170500555,0.423374898,-0.12516619,0.12516619,-1.170500555,-1.248533925,0,1,0
6794,29,75,32,80,77,1,2526.978,44,1668.378,MORE,468,1086,1554,3,2,-3,-0.281222538,3,-1.047645444,-0.398959054,1.307353475,157,80,77,1,-0.059835082,0,-0.117050055,0.423374898,0.500051803,0.500051803,-0.117050055,0,0,1,1
6795,29,76,43,117,110,0,1565.227,100,1630.676,MORE,660,974,1634,2,2,-7,-0.656185922,7,-0.349215148,1.274577053,-0.568422585,227,117,110,1,1.336316841,1.443617351,1.170500555,-0.693218239,0.735427988,0.735427988,1.170500555,1.443617351,1,0,1
6796,29,77,40,80,64,0,1795.685,34,1143.959,MORE,-826,1236,410,2,1,-16,-1.499853537,16,1.222253018,-0.697804788,-0.118942835,144,80,64,1,-0.31912044,0,-0.624266962,-0.693218239,-1.086285615,1.086285615,-0.624266962,0,0,0,0
6797,29,78,31,80,78,1,2020.008,44,883.861,MORE,410,870,1280,3,2,-2,-0.187481692,2,-1.222253018,-0.398959054,0.318571359,158,80,78,1,-0.039890055,0,-0.07803337,0.423374898,0.42894858,0.42894858,-0.07803337,0,0,1,1
6798,29,79,46,124,110,0,1867.222,34,1314.109,MORE,-686,1056,370,2,1,-14,-1.312371845,14,0.87303787,-0.697804788,0.020581213,234,124,110,1,1.475932034,1.716734147,1.170500555,-0.693218239,-0.914657146,0.914657146,1.170500555,1.716734147,0,0,0
6799,29,80,58,92,110,1,1173.69,94,2074.294,MORE,1460,836,2296,2,2,18,1.687335229,18,1.571468165,1.095269613,-1.332066949,202,92,110,0,0.837691154,0.468200222,1.170500555,-0.693218239,1.716162095,1.716162095,1.170500555,0.468200222,1,0,1
6800,29,81,48,128,110,1,2293.7,74,872.701,LESS,1260,694,1954,3,2,-18,-1.687335229,18,1.571468165,0.497578146,0.852373665,238,128,110,0,1.555712144,1.872800887,1.170500555,0.423374898,1.470978568,1.470978568,1.170500555,1.872800887,1,1,1
6801,29,82,8,50,58,0,1379.592,94,817.499,LESS,-62,960,898,2,2,8,0.749926769,8,-0.174607574,1.095269613,-0.930480632,108,50,58,1,-1.037141429,-1.170500555,-0.858367073,-0.693218239,-0.149684543,0.149684543,-0.858367073,-1.170500555,1,0,0
6802,29,83,4,54,50,1,1907.898,4,1193.037,LESS,-422,1394,972,3,1,-4,-0.374963384,4,-0.87303787,-1.594341988,0.099914706,104,54,50,0,-1.116921539,-1.014433814,-1.170500555,0.423374898,-0.591014891,0.591014891,-1.170500555,-1.014433814,0,1,0
6803,29,84,37,80,69,1,2088.514,0,1095.232,LESS,-330,1628,1298,4,1,-11,-1.031149307,11,0.349215148,-1.713880282,0.452183816,149,80,69,0,-0.219395302,0,-0.429183537,1.539968035,-0.478230469,0.478230469,-0.429183537,0,0,1,0
6804,29,85,52,105,110,0,1478.069,14,2048.935,LESS,-1168,1716,548,2,1,5,0.46870423,5,-0.698430296,-1.295496255,-0.738413455,215,105,110,1,1.096976512,0.975417129,1.170500555,-0.693218239,-1.505549445,1.505549445,1.170500555,0.975417129,0,0,0
6805,29,86,5,55,50,1,2214.443,74,1321.183,LESS,1348,718,2066,3,2,-5,-0.46870423,5,-0.698430296,0.497578146,0.697792715,105,55,50,0,-1.096976512,-0.975417129,-1.170500555,0.423374898,1.57885932,1.57885932,-1.170500555,-0.975417129,1,1,1
6806,29,87,30,96,80,1,2047.621,54,1813.428,LESS,702,680,1382,3,2,-16,-1.499853537,16,1.222253018,-0.100113321,0.372427091,176,96,80,0,0.31912044,0.624266962,0,0.423374898,0.786916529,0.786916529,0,0.624266962,0,1,1
6807,29,88,33,80,75,1,2330.495,0,1457.885,LESS,-342,1638,1296,3,1,-5,-0.46870423,5,-0.698430296,-1.713880282,0.924137749,155,80,75,0,-0.099725137,0,-0.195083426,0.423374898,-0.49294148,0.49294148,-0.195083426,0,0,1,0
6808,29,89,48,110,128,0,1695.688,74,1909.201,LESS,352,1174,1526,2,2,18,1.687335229,18,1.571468165,0.497578146,-0.313974583,238,110,128,1,1.555712144,1.170500555,1.872800887,-0.693218239,0.357845357,0.357845357,1.872800887,1.170500555,1,0,1
6809,29,90,9,59,50,1,2020.932,100,1810.546,LESS,1392,774,2166,3,2,-9,-0.843667615,9,0,1.274577053,0.320373506,109,59,50,0,-1.017196402,-0.819350388,-1.170500555,0.423374898,1.632799696,1.632799696,-1.170500555,-0.819350388,1,1,1
6810,29,91,44,110,119,0,1294.907,100,751.455,LESS,0,882,882,2,2,9,0.843667615,9,0,1.274577053,-1.095648223,229,110,119,1,1.376206896,1.170500555,1.521650721,-0.693218239,-0.07367765,0.07367765,1.521650721,1.170500555,1,0,1
6811,29,92,2,52,50,1,2457.139,14,1614.883,LESS,-38,1228,1190,3,1,-2,-0.187481692,2,-1.222253018,-1.295496255,1.171141166,102,52,50,0,-1.156811594,-1.092467184,-1.170500555,0.423374898,-0.12026252,0.12026252,-1.170500555,-1.092467184,0,1,1
6812,29,93,8,58,50,1,2134.499,0,2607.456,LESS,-514,1802,1288,3,1,-8,-0.749926769,8,-0.174607574,-1.713880282,0.541871856,108,58,50,0,-1.037141429,-0.858367073,-1.170500555,0.423374898,-0.703799313,0.703799313,-1.170500555,-0.858367073,0,1,0
6813,29,94,44,119,110,1,1841.079,24,757.461,LESS,378,620,998,3,2,-9,-0.843667615,9,0,-0.996650521,-0.030407467,229,119,110,0,1.376206896,1.521650721,1.170500555,0.423374898,0.389719216,0.389719216,1.170500555,1.521650721,0,1,1
6814,29,95,34,74,80,0,1418.898,74,1821.814,LESS,-406,926,520,2,2,6,0.562445076,6,-0.523822722,0.497578146,-0.853819153,154,74,80,1,-0.119670165,-0.234100111,0,-0.693218239,-0.571400209,0.571400209,0,-0.234100111,1,0,0
6815,29,96,24,86,80,1,1977.168,74,1193.61,LESS,664,774,1438,3,2,-6,-0.562445076,6,-0.523822722,0.497578146,0.235017251,166,86,80,0,0.119670165,0.234100111,0,0.423374898,0.740331659,0.740331659,0,0.234100111,1,1,1
6816,29,97,39,66,80,0,1711.474,84,867.096,LESS,-324,1352,1028,3,2,14,1.312371845,14,0.87303787,0.79642388,-0.283185947,146,66,80,1,-0.279230385,-0.546233592,0,0.423374898,-0.470874963,0.470874963,0,-0.546233592,1,1,0
6817,29,98,9,50,59,0,1456.35,84,1785.414,LESS,606,864,1470,2,2,9,0.843667615,9,0,0.79642388,-0.780773672,109,50,59,1,-1.017196402,-1.170500555,-0.819350388,-0.693218239,0.669228436,0.669228436,-0.819350388,-1.170500555,1,0,1
6818,29,99,57,94,110,0,1388.543,74,1124.576,LESS,-146,1050,904,2,2,16,1.499853537,16,1.222253018,0.497578146,-0.913022816,204,94,110,1,0.877581209,0.546233592,1.170500555,-0.693218239,-0.252661624,0.252661624,1.170500555,0.546233592,1,0,0
6819,29,100,60,110,87,1,2021.057,84,1524.151,LESS,1364,700,2064,3,2,-23,-2.15603946,23,2.444506035,0.79642388,0.320617303,197,110,87,0,0.737966017,1.170500555,0.273116796,0.423374898,1.598474002,1.598474002,0.273116796,1.170500555,1,1,1
6820,29,101,33,75,80,0,1696.056,24,1651.923,LESS,-740,1096,356,2,1,5,0.46870423,5,-0.698430296,-0.996650521,-0.313256844,155,75,80,1,-0.099725137,-0.195083426,0,-0.693218239,-0.980856698,0.980856698,0,-0.195083426,0,0,0
6821,29,102,15,50,45,1,2179.365,44,1784.562,LESS,138,852,990,3,2,-5,-0.46870423,5,-0.698430296,-0.398959054,0.629377426,95,50,45,0,-1.296426786,-1.170500555,-1.36558398,0.423374898,0.095498984,0.095498984,-1.36558398,-1.170500555,0,1,1
6822,29,103,59,89,110,0,1528.295,84,718.118,LESS,-138,998,860,2,2,21,1.968557767,21,2.095290887,0.79642388,-0.640453871,199,89,110,1,0.777856072,0.351150166,1.170500555,-0.693218239,-0.242854283,0.242854283,1.170500555,0.351150166,1,0,0
6823,29,104,29,80,94,0,1949.66,74,2079.34,LESS,-396,1410,1014,2,2,14,1.312371845,14,0.87303787,0.497578146,0.181366309,174,80,94,1,0.279230385,0,0.546233592,-0.693218239,-0.559141033,0.559141033,0.546233592,0,1,0,0
6824,29,105,55,110,98,1,1855.783,94,2188.679,LESS,1214,710,1924,3,2,-12,-1.124890153,12,0.523822722,1.095269613,-0.001729138,208,110,98,0,0.957361319,1.170500555,0.702300333,0.423374898,1.414586357,1.414586357,0.702300333,1.170500555,1,1,1
6825,29,106,29,94,80,1,1886.716,84,987.766,LESS,1318,760,2078,3,2,-14,-1.312371845,14,0.87303787,0.79642388,0.058601842,174,94,80,0,0.279230385,0.546233592,0,0.423374898,1.542081791,1.542081791,0,0.546233592,1,1,1
6826,29,107,57,110,94,1,1912.885,100,1745.35,LESS,1472,660,2132,3,2,-16,-1.499853537,16,1.222253018,1.274577053,0.109641232,204,110,94,0,0.877581209,1.170500555,0.546233592,0.423374898,1.730873107,1.730873107,0.546233592,1.170500555,1,1,1
6827,29,108,39,80,66,0,1505.002,94,1297.618,LESS,244,960,1204,2,2,-14,-1.312371845,14,0.87303787,1.095269613,-0.685883979,146,80,66,0,-0.279230385,0,-0.546233592,-0.693218239,0.225446253,0.225446253,-0.546233592,0,1,0,1
6828,29,109,4,50,54,0,1393.324,84,1502.117,LESS,322,658,980,2,2,4,0.374963384,4,-0.87303787,0.79642388,-0.903698069,104,50,54,1,-1.116921539,-1.170500555,-1.014433814,-0.693218239,0.321067828,0.321067828,-1.014433814,-1.170500555,1,0,1
6829,29,110,55,98,110,0,2635.146,34,1050.371,LESS,-472,1496,1024,5,2,12,1.124890153,12,0.523822722,-0.697804788,1.518321745,208,98,110,1,0.957361319,0.702300333,1.170500555,2.656561172,-0.652310773,0.652310773,1.170500555,0.702300333,0,1,0
6830,29,111,2,50,52,0,2665.32,74,975.885,LESS,374,1250,1624,4,2,2,0.187481692,2,-1.222253018,0.497578146,1.57717239,102,50,52,1,-1.156811594,-1.170500555,-1.092467184,1.539968035,0.384815545,0.384815545,-1.092467184,-1.170500555,1,1,1
6831,29,112,59,110,89,1,1820.593,84,775.063,LESS,646,710,1356,3,2,-21,-1.968557767,21,2.095290887,0.79642388,-0.070362869,199,110,89,0,0.777856072,1.170500555,0.351150166,0.423374898,0.718265141,0.718265141,0.351150166,1.170500555,1,1,1
6832,29,113,60,87,110,0,1431.295,100,1687.159,LESS,810,786,1596,2,2,23,2.15603946,23,2.444506035,1.274577053,-0.829640342,197,87,110,1,0.737966017,0.273116796,1.170500555,-0.693218239,0.919315633,0.919315633,1.170500555,0.273116796,1,0,1
6833,29,114,52,110,105,1,1868.039,0,974.44,LESS,-352,1284,932,3,1,-5,-0.46870423,5,-0.698430296,-1.713880282,0.02217467,215,110,105,0,1.096976512,1.170500555,0.975417129,0.423374898,-0.505200657,0.505200657,0.975417129,1.170500555,0,1,0
6834,29,115,30,80,96,0,1472.836,64,1032.859,LESS,100,882,982,2,2,16,1.499853537,16,1.222253018,0.198732413,-0.748619773,176,80,96,1,0.31912044,0,0.624266962,-0.693218239,0.048914114,0.048914114,0.624266962,0,0,0,1
6835,29,116,24,80,86,0,1436.216,64,1262.446,LESS,368,834,1202,2,2,6,0.562445076,6,-0.523822722,0.198732413,-0.820042542,166,80,86,1,0.119670165,0,0.234100111,-0.693218239,0.377460039,0.377460039,0.234100111,0,0,0,1
6836,29,117,5,50,55,0,1424.26,54,1165.056,LESS,-342,944,602,2,2,5,0.46870423,5,-0.698430296,-0.100113321,-0.843361237,105,50,55,1,-1.096976512,-1.170500555,-0.975417129,-0.693218239,-0.49294148,0.49294148,-0.975417129,-1.170500555,0,0,0
6837,29,118,34,80,74,0,1686.889,74,2812.979,LESS,-776,1536,760,2,2,-6,-0.562445076,6,-0.523822722,0.497578146,-0.331135941,154,80,74,0,-0.119670165,0,-0.234100111,-0.693218239,-1.024989733,1.024989733,-0.234100111,0,1,0,0
6838,29,119,15,45,50,0,1229.458,54,1497.772,LESS,-620,924,304,2,1,5,0.46870423,5,-0.698430296,-0.100113321,-1.223298381,95,45,50,1,-1.296426786,-1.36558398,-1.170500555,-0.693218239,-0.833746582,0.833746582,-1.170500555,-1.36558398,0,0,0
6839,29,120,37,69,80,0,1823.161,64,1393.158,LESS,56,1246,1302,2,2,11,1.031149307,11,0.349215148,0.198732413,-0.065354304,149,69,80,1,-0.219395302,-0.429183537,0,-0.693218239,-0.005026262,0.005026262,0,-0.429183537,0,0,1
6840,29,121,48,128,110,0,2785.523,64,966.374,MORE,-326,1516,1190,5,2,-18,-1.687335229,18,1.571468165,0.198732413,1.811613436,238,128,110,1,1.555712144,1.872800887,1.170500555,2.656561172,-0.473326798,0.473326798,1.170500555,1.872800887,1,1,0
6841,29,122,8,50,58,1,1348.098,100,2401.919,MORE,2398,382,2780,1,2,8,0.749926769,8,-0.174607574,1.274577053,-0.991905773,108,50,58,0,-1.037141429,-1.170500555,-0.858367073,-1.809811376,2.866072835,2.866072835,-0.858367073,-1.170500555,1,0,1
6842,29,123,4,54,50,1,2232.807,74,1642.546,MORE,1762,786,2548,3,2,-4,-0.374963384,4,-0.87303787,0.497578146,0.733609419,104,54,50,1,-1.116921539,-1.014433814,-1.170500555,0.423374898,2.08638922,2.08638922,-1.170500555,-1.014433814,1,1,1
6843,29,124,37,80,69,0,2035.471,64,1506.394,MORE,-856,1538,682,2,2,-11,-1.031149307,11,0.349215148,0.198732413,0.348730023,149,80,69,1,-0.219395302,0,-0.429183537,-0.693218239,-1.123063144,1.123063144,-0.429183537,0,1,0,0
6844,29,125,52,105,110,1,1881.036,94,1285.477,MORE,906,688,1594,3,2,5,0.46870423,5,-0.698430296,1.095269613,0.047523707,215,105,110,0,1.096976512,0.975417129,1.170500555,0.423374898,1.037003726,1.037003726,1.170500555,0.975417129,1,1,1
6845,29,126,5,55,50,0,2333.588,74,1031.331,MORE,-394,1356,962,4,1,-5,-0.46870423,5,-0.698430296,0.497578146,0.930170262,105,55,50,1,-1.096976512,-0.975417129,-1.170500555,1.539968035,-0.556689197,0.556689197,-1.170500555,-0.975417129,1,1,0
6846,29,127,30,96,80,0,2091.484,94,1091.174,MORE,338,1084,1422,4,2,-16,-1.499853537,16,1.222253018,1.095269613,0.457976433,176,96,80,1,0.31912044,0.624266962,0,1.539968035,0.34068251,0.34068251,0,0.624266962,1,1,1
6847,29,128,33,80,75,1,1631.607,74,1545.401,MORE,522,578,1100,3,2,-5,-0.46870423,5,-0.698430296,0.497578146,-0.438956627,155,80,75,1,-0.099725137,0,-0.195083426,0.423374898,0.566251355,0.566251355,-0.195083426,0,1,1,1
6848,29,129,48,110,128,1,1683.828,100,1256.152,MORE,682,570,1252,3,2,18,1.687335229,18,1.571468165,1.274577053,-0.337106042,238,110,128,0,1.555712144,1.170500555,1.872800887,0.423374898,0.762398176,0.762398176,1.872800887,1.170500555,1,1,1
6849,29,130,9,59,50,0,1756.173,14,1158.928,MORE,-652,1044,392,2,1,-9,-0.843667615,9,0,-1.295496255,-0.196006091,109,59,50,1,-1.017196402,-0.819350388,-1.170500555,-0.693218239,-0.872975947,0.872975947,-1.170500555,-0.819350388,0,0,0
6850,29,131,44,110,119,1,3339.763,0,1704.709,MORE,-798,1938,1140,3,1,9,0.843667615,9,0,-1.713880282,2.892589825,229,110,119,0,1.376206896,1.170500555,1.521650721,0.423374898,-1.051959921,1.051959921,1.521650721,1.170500555,0,1,0
6851,29,132,2,52,50,1,1747.04,34,1090.734,MORE,-256,884,628,3,1,-2,-0.187481692,2,-1.222253018,-0.697804788,-0.213818875,102,52,50,1,-1.156811594,-1.092467184,-1.170500555,0.423374898,-0.387512564,0.387512564,-1.170500555,-1.092467184,0,1,0
6852,29,133,8,58,50,0,2280.312,0,1595.796,MORE,-1592,2320,728,4,1,-8,-0.749926769,8,-0.174607574,-1.713880282,0.826262031,108,58,50,1,-1.037141429,-0.858367073,-1.170500555,1.539968035,-2.025338522,2.025338522,-1.170500555,-0.858367073,0,1,0
6853,29,134,44,119,110,0,2269.762,14,1077.853,MORE,-764,1488,724,4,1,-9,-0.843667615,9,0,-1.295496255,0.805685564,229,119,110,1,1.376206896,1.521650721,1.170500555,1.539968035,-1.010278722,1.010278722,1.170500555,1.521650721,0,1,0
6854,29,135,34,74,80,1,2733.787,0,1867.88,MORE,-478,1716,1238,5,1,6,0.562445076,6,-0.523822722,-1.713880282,1.710708783,154,74,80,0,-0.119670165,-0.234100111,0,2.656561172,-0.659666278,0.659666278,0,-0.234100111,0,1,0
6855,29,136,24,86,80,0,3175.214,4,1038.162,MORE,-656,1898,1242,4,1,-6,-0.562445076,6,-0.523822722,-1.594341988,2.571657406,166,86,80,1,0.119670165,0.234100111,0,1.539968035,-0.877879617,0.877879617,0,0.234100111,0,1,0
6856,29,137,39,66,80,1,1692.274,24,1455.601,MORE,174,692,866,3,2,14,1.312371845,14,0.87303787,-0.996650521,-0.320633166,146,66,80,0,-0.279230385,-0.546233592,0,0.423374898,0.139632018,0.139632018,0,-0.546233592,0,1,1
6857,29,138,9,50,59,1,1154.062,100,2032.339,MORE,1342,328,1670,1,2,9,0.843667615,9,0,1.274577053,-1.370348929,109,50,59,0,-1.017196402,-1.170500555,-0.819350388,-1.809811376,1.571503814,1.571503814,-0.819350388,-1.170500555,1,0,1
6858,29,139,57,94,110,1,1598.132,84,1661.088,MORE,194,640,834,3,2,16,1.499853537,16,1.222253018,0.79642388,-0.504245463,204,94,110,0,0.877581209,0.546233592,1.170500555,0.423374898,0.164150371,0.164150371,1.170500555,0.546233592,1,1,1
6859,29,140,60,110,87,0,2456.125,54,1084.037,MORE,-270,1134,864,4,1,-23,-2.15603946,23,2.444506035,-0.100113321,1.169163485,197,110,87,1,0.737966017,1.170500555,0.273116796,1.539968035,-0.404675411,0.404675411,0.273116796,1.170500555,0,1,0
6860,29,141,33,75,80,1,1422.63,84,1318.512,MORE,1244,284,1528,1,2,5,0.46870423,5,-0.698430296,0.79642388,-0.84654035,155,75,80,0,-0.099725137,-0.195083426,0,-1.809811376,1.451363886,1.451363886,0,-0.195083426,1,0,1
6861,29,142,15,50,45,1,2016.306,64,1503.52,MORE,250,792,1042,3,2,-5,-0.46870423,5,-0.698430296,0.198732413,0.311351067,95,50,45,1,-1.296426786,-1.170500555,-1.36558398,0.423374898,0.232801759,0.232801759,-1.36558398,-1.170500555,1,1,1
6862,29,143,59,89,110,1,1763.932,100,1520.91,MORE,754,594,1348,3,2,21,1.968557767,21,2.095290887,1.274577053,-0.180873124,199,89,110,0,0.777856072,0.351150166,1.170500555,0.423374898,0.850664246,0.850664246,1.170500555,0.351150166,1,1,1
6863,29,144,29,80,94,1,1796.877,94,1213.572,MORE,694,662,1356,3,2,14,1.312371845,14,0.87303787,1.095269613,-0.116617986,174,80,94,0,0.279230385,0,0.546233592,0.423374898,0.777109188,0.777109188,0.546233592,0,1,1,1
6864,29,145,55,110,98,0,1514.104,64,1167.941,MORE,-656,1030,374,2,1,-12,-1.124890153,12,0.523822722,0.198732413,-0.668131657,208,110,98,1,0.957361319,1.170500555,0.702300333,-0.693218239,-0.877879617,0.877879617,0.702300333,1.170500555,1,0,0
6865,29,146,29,94,80,0,1614.409,64,1492.502,MORE,-756,1170,414,2,1,-14,-1.312371845,14,0.87303787,0.198732413,-0.472499193,174,94,80,1,0.279230385,0.546233592,0,-0.693218239,-1.000471381,1.000471381,0,0.546233592,1,0,0
6866,29,147,57,110,94,0,1630.308,44,478.817,MORE,-626,1034,408,2,1,-16,-1.499853537,16,1.222253018,-0.398959054,-0.441490165,204,110,94,1,0.877581209,1.170500555,0.546233592,-0.693218239,-0.841102088,0.841102088,0.546233592,1.170500555,0,0,0
6867,29,148,39,80,66,0,1689.162,94,1339.383,MORE,476,1008,1484,3,2,-14,-1.312371845,14,0.87303787,1.095269613,-0.326702736,146,80,66,1,-0.279230385,0,-0.546233592,0.423374898,0.509859144,0.509859144,-0.546233592,0,1,1,1
6868,29,149,4,50,54,0,1618.537,34,1337.639,MORE,-436,942,506,2,1,4,0.374963384,4,-0.87303787,-0.697804788,-0.464448041,104,50,54,0,-1.116921539,-1.170500555,-1.014433814,-0.693218239,-0.608177738,0.608177738,-1.014433814,-1.170500555,0,0,0
6869,29,150,55,98,110,1,2423.751,64,1691.654,MORE,394,918,1312,3,2,12,1.124890153,12,0.523822722,0.198732413,1.106022013,208,98,110,0,0.957361319,0.702300333,1.170500555,0.423374898,0.409333898,0.409333898,1.170500555,0.702300333,0,1,1
6870,29,151,2,50,52,1,2028.835,74,1567.84,MORE,376,818,1194,3,2,2,0.187481692,2,-1.222253018,0.497578146,0.335787328,102,50,52,0,-1.156811594,-1.170500555,-1.092467184,0.423374898,0.38726738,0.38726738,-1.092467184,-1.170500555,1,1,1
6871,29,152,59,110,89,0,1647.331,100,1420.262,MORE,-94,996,902,2,2,-21,-1.968557767,21,2.095290887,1.274577053,-0.408288914,199,110,89,1,0.777856072,1.170500555,0.351150166,-0.693218239,-0.188913907,0.188913907,0.351150166,1.170500555,1,0,0
6872,29,153,60,87,110,1,1088.229,100,1476.524,MORE,1058,306,1364,1,2,23,2.15603946,23,2.444506035,1.274577053,-1.498748032,197,87,110,0,0.737966017,0.273116796,1.170500555,-1.809811376,1.223343206,1.223343206,1.170500555,0.273116796,1,0,1
6873,29,154,52,110,105,0,2262.337,44,2111.672,MORE,-372,1618,1246,5,2,-5,-0.46870423,5,-0.698430296,-0.398959054,0.791204022,215,110,105,1,1.096976512,1.170500555,0.975417129,2.656561172,-0.529719009,0.529719009,0.975417129,1.170500555,0,1,0
6874,29,155,30,80,96,1,1112.231,94,1353.699,MORE,1020,262,1282,1,2,16,1.499853537,16,1.222253018,1.095269613,-1.451935107,176,80,96,0,0.31912044,0,0.624266962,-1.809811376,1.176758336,1.176758336,0.624266962,0,1,0,1
6875,29,156,24,80,86,0,2452.989,0,767.263,MORE,-1094,1918,824,4,1,6,0.562445076,6,-0.523822722,-1.713880282,1.163047106,166,80,86,0,0.119670165,0,0.234100111,1.539968035,-1.414831541,1.414831541,0.234100111,0,0,1,0
6876,29,157,5,50,55,1,1582.194,54,1126.33,MORE,276,728,1004,3,2,5,0.46870423,5,-0.698430296,-0.100113321,-0.535330555,105,50,55,0,-1.096976512,-1.170500555,-0.975417129,0.423374898,0.264675617,0.264675617,-0.975417129,-1.170500555,0,0,1
6877,29,158,34,80,74,1,1688.523,24,902.841,MORE,310,606,916,3,2,-6,-0.562445076,6,-0.523822722,-0.996650521,-0.327949027,154,80,74,1,-0.119670165,0,-0.234100111,0.423374898,0.306356817,0.306356817,-0.234100111,0,0,0,1
6878,29,159,15,45,50,0,1281.465,84,1685.049,MORE,600,906,1506,3,2,5,0.46870423,5,-0.698430296,0.79642388,-1.121865177,95,45,50,0,-1.296426786,-1.36558398,-1.170500555,0.423374898,0.66187293,0.66187293,-1.170500555,-1.36558398,1,0,1
6879,29,160,37,69,80,1,1762.87,74,1249.513,MORE,840,778,1618,4,1,11,1.031149307,11,0.349215148,0.497578146,-0.182944423,149,69,80,0,-0.219395302,-0.429183537,0,1.539968035,0.956093162,0.956093162,0,-0.429183537,1,1,1
6880,29,161,3,50,53,0,2159.923,24,1405.318,LESS,-600,1100,500,2,1,3,0.281222538,3,-1.047645444,-0.996650521,0.591458216,103,50,53,1,-1.136866566,-1.170500555,-1.053450499,-0.693218239,-0.80922823,0.80922823,-1.053450499,-1.170500555,0,0,0
6881,29,162,20,50,40,1,1656.173,100,1158.561,LESS,1488,516,2004,3,2,-10,-0.937408461,10,0.174607574,1.274577053,-0.39104369,90,50,40,0,-1.396151924,-1.170500555,-1.560667406,0.423374898,1.750487789,1.750487789,-1.560667406,-1.170500555,1,1,1
6882,29,163,25,80,88,0,1580.123,54,1358.112,LESS,-510,938,428,2,1,8,0.749926769,8,-0.174607574,-0.100113321,-0.539369784,168,80,88,1,0.15956022,0,0.312133481,-0.693218239,-0.698895643,0.698895643,0.312133481,0,0,0,0
6883,29,164,42,115,110,0,1873.544,0,1155.576,LESS,-988,1714,726,4,1,-5,-0.46870423,5,-0.698430296,-1.713880282,0.03291149,225,115,110,0,1.296426786,1.36558398,1.170500555,1.539968035,-1.284884271,1.284884271,1.170500555,1.36558398,0,1,0
6884,29,165,53,103,110,0,1472.928,50,1652.31,LESS,-364,932,568,2,2,7,0.656185922,7,-0.349215148,-0.219651614,-0.748440338,213,103,110,1,1.057086457,0.897383758,1.170500555,-0.693218239,-0.519911668,0.519911668,1.170500555,0.897383758,0,0,0
6885,29,166,26,90,80,0,1218.814,34,1008.992,LESS,-394,736,342,2,1,-10,-0.937408461,10,0.174607574,-0.697804788,-1.244058183,170,90,80,0,0.199450275,0.390166852,0,-0.693218239,-0.556689197,0.556689197,0,0.390166852,0,0,0
6886,29,167,35,80,72,0,1613.504,4,1059.724,LESS,-1088,1534,446,2,1,-8,-0.749926769,8,-0.174607574,-1.594341988,-0.474264283,152,80,72,0,-0.15956022,0,-0.312133481,-0.693218239,-1.407476035,1.407476035,-0.312133481,0,0,0,0
6887,29,168,28,93,80,1,1653.807,64,1368.368,LESS,286,656,942,3,2,-13,-1.218630999,13,0.698430296,0.198732413,-0.39565828,173,93,80,0,0.259285357,0.507216907,0,0.423374898,0.276934793,0.276934793,0,0.507216907,0,1,1
6888,29,169,26,80,90,0,1194.884,64,721.445,LESS,-370,700,330,2,1,10,0.937408461,10,0.174607574,0.198732413,-1.29073068,170,80,90,1,0.199450275,0,0.390166852,-0.693218239,-0.527267174,0.527267174,0.390166852,0,1,0,0
6889,29,170,25,88,80,0,1343.629,14,1587.882,LESS,-894,1258,364,2,1,-8,-0.749926769,8,-0.174607574,-1.295496255,-1.000622004,168,88,80,0,0.15956022,0.312133481,0,-0.693218239,-1.169648014,1.169648014,0,0.312133481,0,0,0
6890,29,171,36,80,70,1,1314.318,64,1405.016,LESS,666,328,994,1,2,-10,-0.937408461,10,0.174607574,0.198732413,-1.057789474,150,80,70,0,-0.199450275,0,-0.390166852,-1.809811376,0.742783494,0.742783494,-0.390166852,0,0,0,1
6891,29,172,28,80,93,0,1308.85,74,1065.199,LESS,580,830,1410,2,2,13,1.218630999,13,0.698430296,0.497578146,-1.06845413,173,80,93,1,0.259285357,0,0.507216907,-0.693218239,0.637354578,0.637354578,0.507216907,0,1,0,1
6892,29,173,21,82,80,1,1679.965,84,1053.009,LESS,1072,540,1612,3,2,-2,-0.187481692,2,-1.222253018,0.79642388,-0.344640344,162,82,80,0,0.039890055,0.07803337,0,0.423374898,1.240506053,1.240506053,0,0.07803337,1,1,1
6893,29,174,19,50,41,1,1943.104,4,896.449,LESS,-42,1072,1030,3,1,-9,-0.843667615,9,0,-1.594341988,0.168579644,91,50,41,0,-1.376206896,-1.170500555,-1.521650721,0.423374898,-0.12516619,0.12516619,-1.521650721,-1.170500555,0,1,1
6894,29,175,56,96,110,0,1272.624,100,664.854,LESS,46,572,618,2,2,14,1.312371845,14,0.87303787,1.274577053,-1.139108451,206,96,110,1,0.917471264,0.624266962,1.170500555,-0.693218239,-0.017285439,0.017285439,1.170500555,0.624266962,1,0,1
6895,29,176,23,80,85,0,1240.974,94,1281.774,LESS,626,716,1342,3,2,5,0.46870423,5,-0.698430296,1.095269613,-1.200837851,165,80,85,1,0.099725137,0,0.195083426,0.423374898,0.693746789,0.693746789,0.195083426,0,1,1,1
6896,29,177,10,60,50,0,2196.961,34,1168.95,LESS,-658,1396,738,4,1,-10,-0.937408461,10,0.174607574,-0.697804788,0.663696242,110,60,50,0,-0.997251374,-0.780333703,-1.170500555,1.539968035,-0.880331452,0.880331452,-1.170500555,-0.780333703,0,1,0
6897,29,178,19,41,50,0,1192.279,84,1034.492,LESS,726,614,1340,2,2,9,0.843667615,9,0,0.79642388,-1.29581141,91,41,50,1,-1.376206896,-1.521650721,-1.170500555,-0.693218239,0.816338552,0.816338552,-1.170500555,-1.521650721,1,0,1
6898,29,179,56,110,96,1,1584.455,74,1649.831,LESS,684,550,1234,3,2,-14,-1.312371845,14,0.87303787,0.497578146,-0.530920755,206,110,96,0,0.917471264,1.170500555,0.624266962,0.423374898,0.764850011,0.764850011,0.624266962,1.170500555,1,1,1
6899,29,180,35,72,80,0,1190.956,74,1326.623,LESS,-288,756,468,2,2,8,0.749926769,8,-0.174607574,0.497578146,-1.298391757,152,72,80,1,-0.15956022,-0.312133481,0,-0.693218239,-0.426741928,0.426741928,0,-0.312133481,1,0,0
6900,29,181,11,49,50,0,1184.588,74,770.51,LESS,-128,728,600,2,2,1,0.093740846,1,-1.396860592,0.497578146,-1.310811752,99,49,50,1,-1.216646676,-1.20951724,-1.170500555,-0.693218239,-0.230595107,0.230595107,-1.170500555,-1.20951724,1,0,0
6901,29,182,17,43,50,0,1187.92,84,1403.459,LESS,494,704,1198,3,2,7,0.656185922,7,-0.349215148,0.79642388,-1.304313099,93,43,50,1,-1.336316841,-1.443617351,-1.170500555,0.423374898,0.531925661,0.531925661,-1.170500555,-1.443617351,1,1,1
6902,29,183,1,51,50,0,2085.742,74,1222.702,LESS,-120,990,870,4,2,-1,-0.093740846,1,-1.396860592,0.497578146,0.446777374,101,51,50,0,-1.176756621,-1.131483869,-1.170500555,1.539968035,-0.220787766,0.220787766,-1.170500555,-1.131483869,1,1,0
6903,29,184,41,112,110,0,2533.759,0,693.86,LESS,-450,1444,994,4,1,-2,-0.187481692,2,-1.222253018,-1.713880282,1.320578975,222,112,110,0,1.236591704,1.248533925,1.170500555,1.539968035,-0.625340585,0.625340585,1.170500555,1.248533925,0,1,0
6904,29,185,20,40,50,0,1501.316,84,2504.378,LESS,222,1264,1486,2,2,10,0.937408461,10,0.174607574,0.79642388,-0.693073065,90,40,50,1,-1.396151924,-1.560667406,-1.170500555,-0.693218239,0.198476065,0.198476065,-1.170500555,-1.560667406,1,0,1
6905,29,186,1,50,51,0,1459.219,14,1299.405,LESS,-1140,1586,446,2,1,1,0.093740846,1,-1.396860592,-1.295496255,-0.775178043,101,50,51,1,-1.176756621,-1.170500555,-1.131483869,-0.693218239,-1.471223752,1.471223752,-1.131483869,-1.170500555,0,0,0
6906,29,187,23,85,80,0,1220.474,74,886.425,LESS,100,914,1014,2,2,-5,-0.46870423,5,-0.698430296,0.497578146,-1.240820559,165,85,80,0,0.099725137,0.195083426,0,-0.693218239,0.048914114,0.048914114,0,0.195083426,1,0,1
6907,29,188,11,50,49,0,1540.779,0,984.798,LESS,-1540,1876,336,2,1,-1,-0.093740846,1,-1.396860592,-1.713880282,-0.616105377,99,50,49,0,-1.216646676,-1.170500555,-1.20951724,-0.693218239,-1.961590805,1.961590805,-1.20951724,-1.170500555,0,0,0
6908,29,189,17,50,43,1,1720.121,54,806.1,LESS,252,588,840,3,2,-7,-0.656185922,7,-0.349215148,-0.100113321,-0.266321046,93,50,43,0,-1.336316841,-1.170500555,-1.443617351,0.423374898,0.235253594,0.235253594,-1.443617351,-1.170500555,0,1,1
6909,29,190,21,80,82,0,1280.852,64,772.843,LESS,-454,774,320,2,1,2,0.187481692,2,-1.222253018,0.198732413,-1.123060757,162,80,82,1,0.039890055,0,0.07803337,-0.693218239,-0.630244255,0.630244255,0.07803337,0,0,0,0
6910,29,191,10,50,60,0,1280.357,100,816.496,LESS,336,736,1072,3,2,10,0.937408461,10,0.174607574,1.274577053,-1.124026193,110,50,60,1,-0.997251374,-1.170500555,-0.780333703,0.423374898,0.338230675,0.338230675,-0.780333703,-1.170500555,1,1,1
6911,29,192,3,53,50,1,1848.84,0,921.666,LESS,-158,1028,870,3,1,-3,-0.281222538,3,-1.047645444,-1.713880282,-0.015270599,103,53,50,0,-1.136866566,-1.053450499,-1.170500555,0.423374898,-0.267372636,0.267372636,-1.170500555,-1.053450499,0,1,0
6912,29,193,45,122,110,1,1675.457,34,990.057,LESS,-10,870,860,3,2,-12,-1.124890153,12,0.523822722,-0.697804788,-0.353432639,232,122,110,0,1.436041979,1.638700776,1.170500555,0.423374898,-0.085936826,0.085936826,1.170500555,1.638700776,0,1,1
6913,29,194,38,67,80,0,1407.478,64,1137.876,LESS,-336,720,384,2,1,13,1.218630999,13,0.698430296,0.198732413,-0.876092447,147,67,80,1,-0.259285357,-0.507216907,0,-0.693218239,-0.485585975,0.485585975,0,-0.507216907,0,0,0
6914,29,195,38,80,67,1,2247.346,14,1143.24,LESS,-892,1630,738,4,1,-13,-1.218630999,13,0.698430296,-1.295496255,0.761965936,147,80,67,0,-0.259285357,0,-0.507216907,1.539968035,-1.167196179,1.167196179,-0.507216907,0,0,1,0
6915,29,196,36,70,80,0,1306.483,44,1032.934,LESS,-462,808,346,2,1,10,0.937408461,10,0.174607574,-0.398959054,-1.07307067,150,70,80,1,-0.199450275,-0.390166852,0,-0.693218239,-0.640051596,0.640051596,0,-0.390166852,0,0,0
6916,29,197,45,110,122,0,1587.888,80,1268.577,LESS,-118,854,736,2,2,12,1.124890153,12,0.523822722,0.676885586,-0.524225114,232,110,122,1,1.436041979,1.170500555,1.638700776,-0.693218239,-0.21833593,0.21833593,1.638700776,1.170500555,1,0,0
6917,29,198,42,110,115,0,1319.003,100,1167.439,LESS,260,830,1090,2,2,5,0.46870423,5,-0.698430296,1.274577053,-1.048651963,225,110,115,1,1.296426786,1.170500555,1.36558398,-0.693218239,0.245060935,0.245060935,1.36558398,1.170500555,1,0,1
6918,29,199,41,110,112,0,1630.271,74,1297.437,LESS,-992,1350,358,2,1,2,0.187481692,2,-1.222253018,0.497578146,-0.441562329,222,110,112,1,1.236591704,1.170500555,1.248533925,-0.693218239,-1.289787942,1.289787942,1.248533925,1.170500555,1,0,0
6919,29,200,53,110,103,1,2245.057,0,1225.544,LESS,-308,1598,1290,3,1,-7,-0.656185922,7,-0.349215148,-1.713880282,0.757501525,213,110,103,0,1.057086457,1.170500555,0.897383758,0.423374898,-0.451260281,0.451260281,0.897383758,1.170500555,0,1,0
6920,29,201,3,50,53,1,2146.514,24,853.529,MORE,126,802,928,3,2,3,0.281222538,3,-1.047645444,-0.996650521,0.565305624,103,50,53,0,-1.136866566,-1.170500555,-1.053450499,0.423374898,0.080787972,0.080787972,-1.053450499,-1.170500555,0,0,0
6921,29,202,20,50,40,0,1427.287,34,1311.921,MORE,-346,750,404,2,1,-10,-0.937408461,10,0.174607574,-0.697804788,-0.837457449,90,50,40,1,-1.396151924,-1.170500555,-1.560667406,-0.693218239,-0.497845151,0.497845151,-1.560667406,-1.170500555,0,0,0
6922,29,203,25,80,88,1,2003.501,4,1421.41,MORE,-718,1694,976,3,1,8,0.749926769,8,-0.174607574,-1.594341988,0.286376502,168,80,88,0,0.15956022,0,0.312133481,0.423374898,-0.95388651,0.95388651,0.312133481,0,0,1,0
6923,29,204,42,115,110,1,1823.675,44,864.772,MORE,148,782,930,3,2,-5,-0.46870423,5,-0.698430296,-0.398959054,-0.064351811,225,115,110,1,1.296426786,1.36558398,1.170500555,0.423374898,0.10775816,0.10775816,1.170500555,1.36558398,0,1,0
6924,29,205,53,103,110,1,1672.41,54,1370.824,MORE,162,664,826,3,2,7,0.656185922,7,-0.349215148,-0.100113321,-0.359375435,213,103,110,0,1.057086457,0.897383758,1.170500555,0.423374898,0.124921007,0.124921007,1.170500555,0.897383758,0,1,1
6925,29,206,26,90,80,0,1573.302,34,1192.54,MORE,-550,952,402,2,1,-10,-0.937408461,10,0.174607574,-0.697804788,-0.552673299,170,90,80,1,0.199450275,0.390166852,0,-0.693218239,-0.747932348,0.747932348,0,0.390166852,0,0,0
6926,29,207,35,80,72,0,2313.555,14,1602.015,MORE,-296,1106,810,4,1,-8,-0.749926769,8,-0.174607574,-1.295496255,0.89109838,152,80,72,1,-0.15956022,0,-0.312133481,1.539968035,-0.436549269,0.436549269,-0.312133481,0,0,1,0
6927,29,208,28,93,80,0,1861.73,64,713.712,MORE,-392,1152,760,2,2,-13,-1.218630999,13,0.698430296,0.198732413,0.009869748,173,93,80,1,0.259285357,0.507216907,0,-0.693218239,-0.554237362,0.554237362,0,0.507216907,0,0,0
6928,29,209,26,80,90,1,1401.173,84,1933.053,MORE,1320,328,1648,1,2,10,0.937408461,10,0.174607574,0.79642388,-0.888389568,170,80,90,0,0.199450275,0,0.390166852,-1.809811376,1.544533626,1.544533626,0.390166852,0,1,0,1
6929,29,210,25,88,80,0,1163.805,94,1777.952,MORE,1152,626,1778,2,2,-8,-0.749926769,8,-0.174607574,1.095269613,-1.351346416,168,88,80,1,0.15956022,0.312133481,0,-0.693218239,1.338579464,1.338579464,0,0.312133481,1,0,1
6930,29,211,36,80,70,0,1564.929,64,1060.629,MORE,-124,992,868,2,2,-10,-0.937408461,10,0.174607574,0.198732413,-0.569003797,150,80,70,1,-0.199450275,0,-0.390166852,-0.693218239,-0.225691436,0.225691436,-0.390166852,0,0,0,0
6931,29,212,28,80,93,1,1641.945,84,1353.545,MORE,1292,632,1924,3,2,13,1.218630999,13,0.698430296,0.79642388,-0.41879364,173,80,93,0,0.259285357,0,0.507216907,0.423374898,1.510207933,1.510207933,0.507216907,0,1,1,1
6932,29,213,21,82,80,1,1844.862,54,676.605,MORE,220,600,820,2,2,-2,-0.187481692,2,-1.222253018,-0.100113321,-0.023029195,162,82,80,1,0.039890055,0.07803337,0,-0.693218239,0.19602423,0.19602423,0,0.07803337,0,0,1
6933,29,214,19,50,41,0,2734.389,14,1539.662,MORE,-382,1438,1056,4,1,-9,-0.843667615,9,0,-1.295496255,1.71188291,91,50,41,1,-1.376206896,-1.170500555,-1.521650721,1.539968035,-0.541978186,0.541978186,-1.521650721,-1.170500555,0,1,0
6934,29,215,56,96,110,1,1743.563,84,1524.671,MORE,1190,662,1852,3,2,14,1.312371845,14,0.87303787,0.79642388,-0.220600332,206,96,110,0,0.917471264,0.624266962,1.170500555,0.423374898,1.385164334,1.385164334,1.170500555,0.624266962,1,1,1
6935,29,216,23,80,85,1,1723.655,24,716.142,MORE,202,632,834,3,2,5,0.46870423,5,-0.698430296,-0.996650521,-0.259428417,165,80,85,0,0.099725137,0,0.195083426,0.423374898,0.173957712,0.173957712,0.195083426,0,0,0,1
6936,29,217,10,60,50,0,2192.043,0,735.488,MORE,-624,1400,776,4,1,-10,-0.937408461,10,0.174607574,-1.713880282,0.654104292,110,60,50,1,-0.997251374,-0.780333703,-1.170500555,1.539968035,-0.838650253,0.838650253,-1.170500555,-0.780333703,0,1,0
6937,29,218,19,41,50,1,1701.65,44,779.481,MORE,316,578,894,3,2,9,0.843667615,9,0,-0.398959054,-0.302346441,91,41,50,0,-1.376206896,-1.521650721,-1.170500555,0.423374898,0.313712322,0.313712322,-1.170500555,-1.521650721,0,1,1
6938,29,219,56,110,96,0,1354.553,74,1395.011,MORE,288,878,1166,2,2,-14,-1.312371845,14,0.87303787,0.497578146,-0.979316096,206,110,96,1,0.917471264,1.170500555,0.624266962,-0.693218239,0.279386629,0.279386629,0.624266962,1.170500555,1,0,1
6939,29,220,35,72,80,1,1624.107,84,813.269,MORE,814,576,1390,3,2,8,0.749926769,8,-0.174607574,0.79642388,-0.453584446,152,72,80,0,-0.15956022,-0.312133481,0,0.423374898,0.924219304,0.924219304,0,-0.312133481,1,1,1
6940,29,221,11,49,50,1,1996.508,4,628.203,MORE,-18,1048,1030,3,1,1,0.093740846,1,-1.396860592,-1.594341988,0.272737523,99,49,50,0,-1.216646676,-1.20951724,-1.170500555,0.423374898,-0.095744167,0.095744167,-1.170500555,-1.20951724,0,1,0
6941,29,222,17,43,50,1,1863.742,84,1393.378,MORE,1320,598,1918,2,2,7,0.656185922,7,-0.349215148,0.79642388,0.013793904,93,43,50,0,-1.336316841,-1.443617351,-1.170500555,-0.693218239,1.544533626,1.544533626,-1.170500555,-1.443617351,1,0,1
6942,29,223,1,51,50,0,2024.489,44,1154.244,MORE,-906,1356,450,2,1,-1,-0.093740846,1,-1.396860592,-0.398959054,0.327310994,101,51,50,1,-1.176756621,-1.131483869,-1.170500555,-0.693218239,-1.184359026,1.184359026,-1.170500555,-1.131483869,0,0,0
6943,29,224,41,112,110,1,2003.266,64,1449.402,MORE,118,828,946,3,2,-2,-0.187481692,2,-1.222253018,0.198732413,0.285918164,222,112,110,1,1.236591704,1.248533925,1.170500555,0.423374898,0.070980631,0.070980631,1.170500555,1.248533925,1,1,0
6944,29,225,20,40,50,1,1060.139,100,736.398,MORE,1110,286,1396,1,2,10,0.937408461,10,0.174607574,1.274577053,-1.553534093,90,40,50,0,-1.396151924,-1.560667406,-1.170500555,-1.809811376,1.287090923,1.287090923,-1.170500555,-1.560667406,1,0,1
6945,29,226,1,50,51,1,1146.89,100,1121.888,MORE,1254,372,1626,1,2,1,0.093740846,1,-1.396860592,1.274577053,-1.384337026,101,50,51,0,-1.176756621,-1.170500555,-1.131483869,-1.809811376,1.463623062,1.463623062,-1.131483869,-1.170500555,1,0,1
6946,29,227,23,85,80,0,1286.04,64,1939.192,MORE,-384,772,388,2,1,-5,-0.46870423,5,-0.698430296,0.198732413,-1.112942207,165,85,80,1,0.099725137,0.195083426,0,-0.693218239,-0.544430021,0.544430021,0,0.195083426,1,0,0
6947,29,228,11,50,49,1,1779.419,74,1498.56,MORE,50,860,910,3,2,-1,-0.093740846,1,-1.396860592,0.497578146,-0.150667651,99,50,49,1,-1.216646676,-1.170500555,-1.20951724,0.423374898,-0.012381768,0.012381768,-1.20951724,-1.170500555,1,1,0
6948,29,229,17,50,43,0,1254.557,94,682.84,MORE,-76,872,796,2,2,-7,-0.656185922,7,-0.349215148,1.095269613,-1.174345894,93,50,43,1,-1.336316841,-1.170500555,-1.443617351,-0.693218239,-0.16684739,0.16684739,-1.443617351,-1.170500555,1,0,0
6949,29,230,21,80,82,1,1897.761,44,1183.904,MORE,200,674,874,3,2,2,0.187481692,2,-1.222253018,-0.398959054,0.080143745,162,80,82,0,0.039890055,0,0.07803337,0.423374898,0.171505877,0.171505877,0.07803337,0,0,1,1
6950,29,231,10,50,60,1,1935.818,54,1351.48,MORE,328,710,1038,3,2,10,0.937408461,10,0.174607574,-0.100113321,0.154369204,110,50,60,0,-0.997251374,-1.170500555,-0.780333703,0.423374898,0.328423334,0.328423334,-0.780333703,-1.170500555,0,1,1
6951,29,232,3,53,50,0,2163.385,44,1139.782,MORE,-118,988,870,2,1,-3,-0.281222538,3,-1.047645444,-0.398959054,0.598210417,103,53,50,1,-1.136866566,-1.053450499,-1.170500555,-0.693218239,-0.21833593,0.21833593,-1.170500555,-1.053450499,0,0,0
6952,29,233,45,122,110,0,1407.781,4,2647.601,MORE,-1092,2038,946,3,1,-12,-1.124890153,12,0.523822722,-1.594341988,-0.875501483,232,122,110,1,1.436041979,1.638700776,1.170500555,0.423374898,-1.412379705,1.412379705,1.170500555,1.638700776,0,1,0
6953,29,234,38,67,80,1,2491.682,34,1002.053,MORE,240,1160,1400,3,2,13,1.218630999,13,0.698430296,-0.697804788,1.238513004,147,67,80,0,-0.259285357,-0.507216907,0,0.423374898,0.220542582,0.220542582,0,-0.507216907,0,1,1
6954,29,235,38,80,67,0,1636.52,94,1967.345,MORE,950,1216,2166,3,2,-13,-1.218630999,13,0.698430296,1.095269613,-0.429374429,147,80,67,1,-0.259285357,0,-0.507216907,0.423374898,1.090944102,1.090944102,-0.507216907,0,1,1,1
6955,29,236,36,70,80,1,1823.604,54,1022.83,MORE,364,804,1168,3,2,10,0.937408461,10,0.174607574,-0.100113321,-0.064490287,150,70,80,0,-0.199450275,-0.390166852,0,0.423374898,0.372556369,0.372556369,0,-0.390166852,0,0,1
6956,29,237,45,110,122,1,2083.126,84,1421.189,MORE,1380,798,2178,3,2,12,1.124890153,12,0.523822722,0.79642388,0.441675191,232,110,122,0,1.436041979,1.170500555,1.638700776,0.423374898,1.618088684,1.618088684,1.638700776,1.170500555,1,0,1
6957,29,238,42,110,115,0,2784.636,94,1152.032,MORE,-364,1876,1512,5,2,5,0.46870423,5,-0.698430296,1.095269613,1.809883452,225,110,115,0,1.296426786,1.170500555,1.36558398,2.656561172,-0.519911668,0.519911668,1.36558398,1.170500555,1,1,0
6958,29,239,41,110,112,0,1742.896,54,1056.797,MORE,-574,1156,582,2,2,2,0.187481692,2,-1.222253018,-0.100113321,-0.221901233,222,110,112,0,1.236591704,1.170500555,1.248533925,-0.693218239,-0.777354371,0.777354371,1.248533925,1.170500555,0,0,0
6959,29,240,53,110,103,0,1344.178,44,961.552,MORE,-470,832,362,2,1,-7,-0.656185922,7,-0.349215148,-0.398959054,-0.999551247,213,110,103,1,1.057086457,1.170500555,0.897383758,-0.693218239,-0.649858937,0.649858937,0.897383758,1.170500555,0,0,0
6960,30,1,49,110,131,1,4680.924,70,1340.744,MORE,1530,1438,2968,3,2,21,1.968557767,21,2.095290887,0.6903532,1.522732549,241,110,131,0,1.615547226,1.170500555,1.989850943,0.369349189,2.416076671,2.416076671,1.989850943,1.170500555,1,1,1
6961,30,2,13,47,50,1,4996.805,60,879.524,MORE,-834,2784,1950,3,2,3,0.281222538,3,-1.047645444,0.269833484,1.739585462,97,47,50,0,-1.256536731,-1.28755061,-1.170500555,0.369349189,-0.809452201,0.809452201,-1.170500555,-1.28755061,1,1,0
6962,30,3,16,50,44,0,2664.642,20,396.99,MORE,-1474,2194,720,3,1,-6,-0.562445076,6,-0.523822722,-1.412245378,0.138551085,94,50,44,1,-1.316371814,-1.170500555,-1.404600665,0.369349189,-1.682691828,1.682691828,-1.404600665,-1.170500555,0,1,0
6963,30,4,7,57,50,0,6709.106,70,1058.756,MORE,-2694,4466,1772,4,1,-7,-0.656185922,7,-0.349215148,0.6903532,2.915083386,107,57,50,1,-1.057086457,-0.897383758,-1.170500555,1.205611505,-3.347304867,3.347304867,-1.170500555,-0.897383758,1,1,0
6964,30,5,18,42,50,1,5125.906,50,1501.679,MORE,-2806,4030,1224,3,1,8,0.749926769,8,-0.174607574,-0.150686231,1.828213546,92,42,50,0,-1.356261869,-1.482634036,-1.170500555,0.369349189,-3.500121802,3.500121802,-1.170500555,-1.482634036,0,1,0
6965,30,6,51,108,110,1,5155.294,70,1163.376,MORE,732,2302,3034,3,2,2,0.187481692,2,-1.222253018,0.6903532,1.848388465,218,108,110,0,1.156811594,1.092467184,1.170500555,0.369349189,1.327256011,1.327256011,1.170500555,1.092467184,1,1,1
6966,30,7,31,78,80,1,7063.925,70,1614.652,MORE,-1782,4140,2358,5,2,2,0.187481692,2,-1.222253018,0.6903532,3.158667311,158,78,80,0,-0.039890055,-0.07803337,0,2.041873821,-2.102938399,2.102938399,0,-0.07803337,1,1,0
6967,30,8,58,110,92,0,3646.841,70,1044.561,MORE,-1028,2276,1248,2,2,-18,-1.687335229,18,1.571468165,0.6903532,0.812832584,202,110,92,1,0.837691154,1.170500555,0.468200222,-0.466913126,-1.074152963,1.074152963,0.468200222,1.170500555,1,0,0
6968,30,9,12,50,48,1,2330.007,70,1950.45,MORE,-286,1420,1134,2,1,-2,-0.187481692,2,-1.222253018,0.6903532,-0.091176485,98,50,48,1,-1.236591704,-1.170500555,-1.248533925,-0.466913126,-0.061740771,0.061740771,-1.248533925,-1.170500555,1,0,0
6969,30,10,54,110,101,0,2651.306,70,1317.083,MORE,-810,1670,860,2,1,-9,-0.843667615,9,0,0.6903532,0.129395895,211,110,101,1,1.017196402,1.170500555,0.819350388,-0.466913126,-0.776705715,0.776705715,0.819350388,1.170500555,1,0,0
6970,30,11,14,46,50,0,3232.755,20,2647.913,MORE,-642,2452,1810,3,1,4,0.374963384,4,-0.87303787,-1.412245378,0.52856175,96,46,50,0,-1.276481759,-1.326567295,-1.170500555,0.369349189,-0.547480313,0.547480313,-1.170500555,-1.326567295,0,1,0
6971,30,12,22,80,83,1,8080.816,40,2489.405,MORE,1150,2924,4074,4,2,3,0.281222538,3,-1.047645444,-0.571205947,3.856764935,163,80,83,0,0.059835082,0,0.117050055,1.205611505,1.897590643,1.897590643,0.117050055,0,0,1,1
6972,30,13,6,50,56,1,2981.293,70,839.227,MORE,102,1318,1420,3,2,6,0.562445076,6,-0.523822722,0.6903532,0.355932604,106,50,56,0,-1.077031484,-1.170500555,-0.936400444,0.369349189,0.467660753,0.467660753,-0.936400444,-1.170500555,1,1,1
6973,30,14,13,50,47,1,4144.639,30,1754.295,MORE,818,1472,2290,5,2,-3,-0.281222538,3,-1.047645444,-0.991725663,1.154571867,97,50,47,1,-1.256536731,-1.170500555,-1.28755061,2.041873821,1.444597586,1.444597586,-1.28755061,-1.170500555,0,1,1
6974,30,15,46,110,124,1,11431.608,30,1072.76,MORE,1278,4448,5726,4,1,14,1.312371845,14,0.87303787,-0.991725663,6.157090076,234,110,124,0,1.475932034,1.170500555,1.716734147,1.205611505,2.072238568,2.072238568,1.716734147,1.170500555,0,1,1
6975,30,16,27,91,80,0,2894.35,30,1226.732,MORE,-422,1492,1070,2,2,-11,-1.031149307,11,0.349215148,-0.991725663,0.296246068,171,91,80,1,0.219395302,0.429183537,0,-0.466913126,-0.247304191,0.247304191,0,0.429183537,0,0,0
6976,30,17,40,64,80,1,1524.383,70,1208.102,MORE,246,546,792,1,2,16,1.499853537,16,1.222253018,0.6903532,-0.644238908,144,64,80,0,-0.31912044,-0.624266962,0,-1.303175442,0.664139669,0.664139669,0,-0.624266962,1,0,1
6977,30,18,22,83,80,0,2271.368,70,1036.521,MORE,-856,1588,732,2,2,-3,-0.281222538,3,-1.047645444,0.6903532,-0.131432271,163,83,80,1,0.059835082,0.117050055,0,-0.466913126,-0.839469813,0.839469813,0,0.117050055,1,0,0
6978,30,19,54,101,110,1,2265.397,60,1760.691,MORE,430,824,1254,1,2,9,0.843667615,9,0,0.269833484,-0.135531374,211,101,110,0,1.017196402,0.819350388,1.170500555,-1.303175442,0.915196062,0.915196062,1.170500555,0.819350388,1,0,1
6979,30,20,6,56,50,0,3294.158,80,1458.224,MORE,-324,1780,1456,5,2,-6,-0.562445076,6,-0.523822722,1.110872915,0.570715027,106,56,50,1,-1.077031484,-0.936400444,-1.170500555,2.041873821,-0.113589373,0.113589373,-1.170500555,-0.936400444,1,1,0
6980,30,21,18,50,42,0,2488.621,60,1152.711,MORE,-1152,1776,624,2,1,-8,-0.749926769,8,-0.174607574,0.269833484,0.01771233,92,50,42,1,-1.356261869,-1.170500555,-1.482634036,-0.466913126,-1.243343141,1.243343141,-1.482634036,-1.170500555,1,0,0
6981,30,22,43,110,117,1,3996.445,60,1366.809,MORE,1150,1656,2806,3,2,7,0.656185922,7,-0.349215148,0.269833484,1.052836401,227,110,117,0,1.336316841,1.170500555,1.443617351,0.369349189,1.897590643,1.897590643,1.443617351,1.170500555,1,1,1
6982,30,23,32,77,80,0,4653.274,50,1251.456,MORE,-1106,2516,1410,2,1,3,0.281222538,3,-1.047645444,-0.150686231,1.503750771,157,77,80,0,-0.059835082,-0.117050055,0,-0.466913126,-1.180579043,1.180579043,0,-0.117050055,0,1,0
6983,30,24,27,80,91,1,2125.698,80,1068.142,MORE,342,1238,1580,3,2,11,1.031149307,11,0.349215148,1.110872915,-0.231435006,171,80,91,0,0.219395302,0,0.429183537,0.369349189,0.795125614,0.795125614,0.429183537,0,1,1,1
6984,30,25,16,44,50,1,1427.708,80,879.592,MORE,1034,428,1462,1,2,6,0.562445076,6,-0.523822722,1.110872915,-0.710606481,94,44,50,0,-1.316371814,-1.404600665,-1.170500555,-1.303175442,1.73931596,1.73931596,-1.170500555,-1.404600665,1,0,1
6985,30,26,7,50,57,1,4625.55,20,965.623,MORE,-1368,3184,1816,5,1,7,0.656185922,7,-0.349215148,-1.412245378,1.484718192,107,50,57,0,-1.057086457,-1.170500555,-0.897383758,2.041873821,-1.538061515,1.538061515,-0.897383758,-1.170500555,0,1,0
6986,30,27,14,50,46,0,7677.2,40,1249.97,MORE,-1298,3806,2508,5,1,-4,-0.374963384,4,-0.87303787,-0.571205947,3.579681776,96,50,46,1,-1.276481759,-1.170500555,-1.326567295,2.041873821,-1.442550931,1.442550931,-1.326567295,-1.170500555,0,1,0
6987,30,28,51,110,108,1,4418.189,0,1818.327,MORE,-1538,3402,1864,3,1,-2,-0.187481692,2,-1.222253018,-2.253284809,1.342364467,218,110,108,1,1.156811594,1.170500555,1.092467184,0.369349189,-1.770015791,1.770015791,1.092467184,1.170500555,0,1,0
6988,30,29,50,133,110,0,2149.966,50,1139.646,MORE,-978,1580,602,2,1,-23,-2.15603946,23,2.444506035,-0.150686231,-0.214774978,243,133,110,1,1.655437281,2.067884313,1.170500555,-0.466913126,-1.005931117,1.005931117,1.170500555,2.067884313,0,1,0
6989,30,30,49,131,110,0,4008.059,40,772.262,MORE,-928,2342,1414,4,1,-21,-1.968557767,21,2.095290887,-0.571205947,1.060809435,241,131,110,1,1.615547226,1.989850943,1.170500555,1.205611505,-0.937709271,0.937709271,1.170500555,1.989850943,0,1,0
6990,30,31,47,126,110,0,8436.837,20,1636.576,MORE,1530,2750,4280,6,1,-16,-1.499853537,16,1.222253018,-1.412245378,4.101174035,236,126,110,1,1.515822089,1.794767517,1.170500555,2.878136137,2.416076671,2.416076671,1.170500555,1.794767517,0,1,1
6991,30,32,50,110,133,1,3645.965,40,1157.277,MORE,122,1694,1816,3,2,23,2.15603946,23,2.444506035,-0.571205947,0.812231208,243,110,133,0,1.655437281,1.170500555,2.067884313,0.369349189,0.494949492,0.494949492,2.067884313,1.170500555,0,1,1
6992,30,33,47,110,126,1,3643.086,70,795.036,MORE,-816,1922,1106,1,2,16,1.499853537,16,1.222253018,0.6903532,0.810254769,236,110,126,0,1.515822089,1.170500555,1.794767517,-1.303175442,-0.784892337,0.784892337,1.794767517,1.170500555,1,0,0
6993,30,34,12,48,50,1,2815.281,50,505.629,MORE,390,1076,1466,3,2,2,0.187481692,2,-1.222253018,-0.150686231,0.241965047,98,48,50,0,-1.236591704,-1.248533925,-1.170500555,0.369349189,0.860618586,0.860618586,-1.170500555,-1.248533925,0,1,1
6994,30,35,32,80,77,0,6715.91,70,643.909,MORE,-3566,4940,1374,2,1,-3,-0.281222538,3,-1.047645444,0.6903532,2.919754345,157,80,77,1,-0.059835082,0,-0.117050055,-0.466913126,-4.537093859,4.537093859,-0.117050055,0,1,0,0
6995,30,36,43,117,110,0,1956.108,60,1130.256,MORE,-588,1142,554,2,1,-7,-0.656185922,7,-0.349215148,0.269833484,-0.347858867,227,117,110,1,1.336316841,1.443617351,1.170500555,-0.466913126,-0.47380072,0.47380072,1.170500555,1.443617351,1,0,0
6996,30,37,40,80,64,0,2144.529,80,991.187,MORE,-290,980,690,2,1,-16,-1.499853537,16,1.222253018,1.110872915,-0.218507488,144,80,64,1,-0.31912044,0,-0.624266962,-0.466913126,-0.067198518,0.067198518,-0.624266962,0,1,0,0
6997,30,38,31,80,78,1,7202.473,40,400.699,MORE,368,3100,3468,5,2,-2,-0.187481692,2,-1.222253018,-0.571205947,3.253780779,158,80,78,1,-0.039890055,0,-0.07803337,2.041873821,0.830600973,0.830600973,-0.07803337,0,0,1,1
6998,30,39,46,124,110,0,5203.542,50,1377.568,MORE,990,2142,3132,4,2,-14,-1.312371845,14,0.87303787,-0.150686231,1.881510809,234,124,110,1,1.475932034,1.716734147,1.170500555,1.205611505,1.679280736,1.679280736,1.170500555,1.716734147,0,1,1
6999,30,40,58,92,110,1,5757.077,20,497.089,MORE,-56,2758,2702,3,2,18,1.687335229,18,1.571468165,-1.412245378,2.26151365,202,92,110,0,0.837691154,0.468200222,1.170500555,0.369349189,0.25207972,0.25207972,1.170500555,0.468200222,0,1,1
7000,30,41,49,110,131,0,2622.621,60,1071.357,LESS,-772,1546,774,4,1,21,1.968557767,21,2.095290887,0.269833484,0.109703587,241,110,131,1,1.615547226,1.170500555,1.989850943,1.205611505,-0.724857112,0.724857112,1.989850943,1.170500555,0,1,0
7001,30,42,13,47,50,0,1759.82,40,984.233,LESS,-612,1188,576,2,1,3,0.281222538,3,-1.047645444,-0.571205947,-0.482610956,97,47,50,1,-1.256536731,-1.28755061,-1.170500555,-0.466913126,-0.506547206,0.506547206,-1.170500555,-1.28755061,0,0,0
7002,30,43,16,50,44,0,1569.966,40,336.569,LESS,-632,1034,402,2,1,-6,-0.562445076,6,-0.523822722,-0.571205947,-0.612946091,94,50,44,0,-1.316371814,-1.170500555,-1.404600665,-0.466913126,-0.533835944,0.533835944,-1.404600665,-1.170500555,0,0,0
7003,30,44,7,57,50,0,1263.868,60,922.557,LESS,-366,730,364,2,1,-7,-0.656185922,7,-0.349215148,0.269833484,-0.823082956,107,57,50,0,-1.057086457,-0.897383758,-1.170500555,-0.466913126,-0.170895724,0.170895724,-1.170500555,-0.897383758,1,0,1
7004,30,45,18,42,50,0,1502.927,40,498.105,LESS,-778,1118,340,2,1,8,0.749926769,8,-0.174607574,-0.571205947,-0.658968493,92,42,50,1,-1.356261869,-1.482634036,-1.170500555,-0.466913126,-0.733043734,0.733043734,-1.170500555,-1.482634036,0,0,0
7005,30,46,51,108,110,1,1721.158,20,1987.585,LESS,394,944,1338,3,1,2,0.187481692,2,-1.222253018,-1.412245378,-0.509152493,218,108,110,1,1.156811594,1.092467184,1.170500555,0.369349189,0.866076333,0.866076333,1.170500555,1.092467184,0,1,1
7006,30,47,31,78,80,0,1360.625,80,1444.977,LESS,-410,824,414,2,2,2,0.187481692,2,-1.222253018,1.110872915,-0.75665909,158,78,80,1,-0.039890055,-0.07803337,0,-0.466913126,-0.230930948,0.230930948,0,-0.07803337,1,0,1
7007,30,48,58,110,92,1,3261.429,60,964.579,LESS,386,1252,1638,5,2,-18,-1.687335229,18,1.571468165,0.269833484,0.548246506,202,110,92,0,0.837691154,1.170500555,0.468200222,2.041873821,0.855160838,0.855160838,0.468200222,1.170500555,1,1,1
7008,30,49,12,50,48,0,1543.627,50,1581.937,LESS,-554,1030,476,2,1,-2,-0.187481692,2,-1.222253018,-0.150686231,-0.631027865,98,50,48,0,-1.236591704,-1.170500555,-1.248533925,-0.466913126,-0.427409864,0.427409864,-1.248533925,-1.170500555,0,0,0
7009,30,50,54,110,101,1,1838.463,80,1370.449,LESS,-316,1262,946,3,1,-9,-0.843667615,9,0,1.110872915,-0.428622385,211,110,101,0,1.017196402,1.170500555,0.819350388,0.369349189,-0.102673878,0.102673878,0.819350388,1.170500555,1,1,1
7010,30,51,14,46,50,0,1697.884,100,1395.773,LESS,218,1046,1264,2,2,4,0.374963384,4,-0.87303787,1.951912346,-0.525130139,96,46,50,1,-1.276481759,-1.326567295,-1.170500555,-0.466913126,0.625935436,0.625935436,-1.170500555,-1.326567295,1,0,1
7011,30,52,22,80,83,0,2697.758,60,1156.228,LESS,-1444,1978,534,2,1,3,0.281222538,3,-1.047645444,0.269833484,0.161285282,163,80,83,1,0.059835082,0,0.117050055,-0.466913126,-1.641758721,1.641758721,0.117050055,0,0,0,0
7012,30,53,6,50,56,0,1293.9,90,1278.999,LESS,164,910,1074,2,2,6,0.562445076,6,-0.523822722,1.531392631,-0.80246593,106,50,56,1,-1.077031484,-1.170500555,-0.936400444,-0.466913126,0.552255842,0.552255842,-0.936400444,-1.170500555,1,0,1
7013,30,54,13,50,47,0,1246.186,80,792.416,LESS,-506,854,348,2,2,-3,-0.281222538,3,-1.047645444,1.110872915,-0.835221683,97,50,47,0,-1.256536731,-1.170500555,-1.28755061,-0.466913126,-0.361916892,0.361916892,-1.28755061,-1.170500555,1,0,0
7014,30,55,46,110,124,0,1392.368,70,880.078,LESS,-818,1134,316,2,1,14,1.312371845,14,0.87303787,0.6903532,-0.734867459,234,110,124,1,1.475932034,1.170500555,1.716734147,-0.466913126,-0.78762121,0.78762121,1.716734147,1.170500555,1,0,0
7015,30,56,27,91,80,0,2027.396,20,766.716,LESS,-558,1260,702,4,1,-11,-1.031149307,11,0.349215148,-1.412245378,-0.298919518,171,91,80,0,0.219395302,0.429183537,0,1.205611505,-0.432867612,0.432867612,0,0.429183537,0,1,0
7016,30,57,40,64,80,0,1788.23,90,1732.003,LESS,-728,1534,806,2,2,16,1.499853537,16,1.222253018,1.531392631,-0.463107436,144,64,80,1,-0.31912044,-0.624266962,0,-0.466913126,-0.664821888,0.664821888,0,-0.624266962,1,0,0
7017,30,58,22,83,80,0,1729.763,60,608.321,LESS,-794,1212,418,3,2,-3,-0.281222538,3,-1.047645444,0.269833484,-0.503245144,163,83,80,0,0.059835082,0.117050055,0,0.369349189,-0.754874724,0.754874724,0,0.117050055,0,1,0
7018,30,59,54,101,110,0,2108.115,50,913.716,LESS,-1064,1506,442,2,1,9,0.843667615,9,0,-0.150686231,-0.243505769,211,101,110,1,1.017196402,0.819350388,1.170500555,-0.466913126,-1.123272692,1.123272692,1.170500555,0.819350388,0,0,0
7019,30,60,6,56,50,0,1544.911,50,1972.063,LESS,-384,798,414,2,1,-6,-0.562445076,6,-0.523822722,-0.150686231,-0.630146397,106,56,50,0,-1.077031484,-0.936400444,-1.170500555,-0.466913126,-0.195455588,0.195455588,-1.170500555,-0.936400444,0,0,1
7020,30,61,18,50,42,1,2638.971,50,1257.372,LESS,348,1008,1356,3,2,-8,-0.749926769,8,-0.174607574,-0.150686231,0.120927894,92,50,42,0,-1.356261869,-1.170500555,-1.482634036,0.369349189,0.803312235,0.803312235,-1.482634036,-1.170500555,0,1,1
7021,30,62,43,110,117,0,2949.097,60,1521.223,LESS,-138,1836,1698,2,2,7,0.656185922,7,-0.349215148,0.269833484,0.333829988,227,110,117,1,1.336316841,1.170500555,1.443617351,-0.466913126,0.140195893,0.140195893,1.443617351,1.170500555,0,0,1
7022,30,63,32,77,80,0,1586.052,70,1706.996,LESS,-988,1436,448,2,1,3,0.281222538,3,-1.047645444,0.6903532,-0.601903021,157,77,80,1,-0.059835082,-0.117050055,0,-0.466913126,-1.019575486,1.019575486,0,-0.117050055,1,1,0
7023,30,64,27,80,91,0,1955.23,50,1037.708,LESS,-718,1244,526,2,1,11,1.031149307,11,0.349215148,-0.150686231,-0.348461615,171,80,91,1,0.219395302,0,0.429183537,-0.466913126,-0.651177519,0.651177519,0.429183537,0,0,1,0
7024,30,65,16,44,50,0,1639.167,70,1036.549,LESS,-708,1200,492,2,1,6,0.562445076,6,-0.523822722,0.6903532,-0.565439472,94,44,50,1,-1.316371814,-1.404600665,-1.170500555,-0.466913126,-0.63753315,0.63753315,-1.170500555,-1.404600665,1,1,0
7025,30,66,7,50,57,0,2058.719,80,638.609,LESS,-652,1526,874,2,2,7,0.656185922,7,-0.349215148,1.110872915,-0.277416218,107,50,57,1,-1.057086457,-1.170500555,-0.897383758,-0.466913126,-0.561124682,0.561124682,-0.897383758,-1.170500555,1,1,0
7026,30,67,14,50,46,0,2469.654,60,1073.386,LESS,-788,1406,618,2,1,-4,-0.374963384,4,-0.87303787,0.269833484,0.004691448,96,50,46,0,-1.276481759,-1.170500555,-1.326567295,-0.466913126,-0.746688103,0.746688103,-1.326567295,-1.170500555,0,1,0
7027,30,68,51,110,108,0,1890.788,70,1325.277,LESS,-764,1296,532,2,1,-2,-0.187481692,2,-1.222253018,0.6903532,-0.392701172,218,110,108,0,1.156811594,1.170500555,1.092467184,-0.466913126,-0.713941617,0.713941617,1.092467184,1.170500555,1,1,0
7028,30,69,50,133,110,1,2168.348,60,1456.734,LESS,60,906,966,3,2,-23,-2.15603946,23,2.444506035,0.269833484,-0.202155699,243,133,110,0,1.655437281,2.067884313,1.170500555,0.369349189,0.410354403,0.410354403,1.170500555,2.067884313,1,1,1
7029,30,70,49,131,110,1,2051.107,20,989.346,LESS,-536,1530,994,3,1,-21,-1.968557767,21,2.095290887,-1.412245378,-0.282641871,241,131,110,0,1.615547226,1.989850943,1.170500555,0.369349189,-0.40285,0.40285,1.170500555,1.989850943,0,1,0
7030,30,71,47,126,110,1,4226.391,20,926.331,LESS,-108,1926,1818,5,1,-16,-1.499853537,16,1.222253018,-1.412245378,1.210694772,236,126,110,0,1.515822089,1.794767517,1.170500555,2.041873821,0.181129001,0.181129001,1.170500555,1.794767517,0,1,1
7031,30,72,50,110,133,0,1854.214,70,1118.573,LESS,-770,1408,638,2,1,23,2.15603946,23,2.444506035,0.6903532,-0.417809293,243,110,133,1,1.655437281,1.170500555,2.067884313,-0.466913126,-0.722128238,0.722128238,2.067884313,1.170500555,1,1,0
7032,30,73,47,110,126,0,1945.727,40,1130.429,LESS,-786,1356,570,2,1,16,1.499853537,16,1.222253018,-0.571205947,-0.354985443,236,110,126,1,1.515822089,1.170500555,1.794767517,-0.466913126,-0.743959229,0.743959229,1.794767517,1.170500555,0,1,0
7033,30,74,12,48,50,0,1464.471,80,1822.278,LESS,-388,846,458,2,2,2,0.187481692,2,-1.222253018,1.110872915,-0.685368611,98,48,50,1,-1.236591704,-1.248533925,-1.170500555,-0.466913126,-0.200913336,0.200913336,-1.170500555,-1.248533925,1,0,1
7034,30,75,32,80,77,0,1580.989,70,1162.892,LESS,-218,1010,792,2,1,-3,-0.281222538,3,-1.047645444,0.6903532,-0.60537878,157,80,77,0,-0.059835082,0,-0.117050055,-0.466913126,0.03104094,0.03104094,-0.117050055,0,1,0,1
7035,30,76,43,117,110,0,3685.552,20,869.499,LESS,-898,2184,1286,4,1,-7,-0.656185922,7,-0.349215148,-1.412245378,0.83940776,227,117,110,0,1.336316841,1.443617351,1.170500555,1.205611505,-0.896776164,0.896776164,1.170500555,1.443617351,0,1,0
7036,30,77,40,80,64,0,1675.531,70,1205.819,LESS,-528,892,364,2,1,-16,-1.499853537,16,1.222253018,0.6903532,-0.540475516,144,80,64,0,-0.31912044,0,-0.624266962,-0.466913126,-0.391934504,0.391934504,-0.624266962,0,1,0,0
7037,30,78,31,80,78,0,1582.438,10,699.42,LESS,-1272,1672,400,2,1,-2,-0.187481692,2,-1.222253018,-1.832765094,-0.604384039,158,80,78,0,-0.039890055,0,-0.07803337,-0.466913126,-1.407075571,1.407075571,-0.07803337,0,0,0,0
7038,30,79,46,124,110,0,2956.206,30,565.827,LESS,-656,1728,1072,4,1,-14,-1.312371845,14,0.87303787,-0.991725663,0.33871033,234,124,110,0,1.475932034,1.716734147,1.170500555,1.205611505,-0.56658243,0.56658243,1.170500555,1.716734147,0,1,0
7039,30,80,58,92,110,0,1566.142,70,588.672,LESS,-738,1128,390,2,1,18,1.687335229,18,1.571468165,0.6903532,-0.615571274,202,92,110,1,0.837691154,0.468200222,1.170500555,-0.466913126,-0.678466257,0.678466257,1.170500555,0.468200222,1,0,0
7040,30,81,48,128,110,0,1599.643,80,798.767,MORE,86,890,976,2,2,-18,-1.687335229,18,1.571468165,1.110872915,-0.592572774,238,128,110,1,1.555712144,1.872800887,1.170500555,-0.466913126,0.445829763,0.445829763,1.170500555,1.872800887,1,0,1
7041,30,82,8,50,58,1,2116.739,20,1639.429,MORE,54,976,1030,3,1,8,0.749926769,8,-0.174607574,-1.412245378,-0.237585377,108,50,58,0,-1.037141429,-1.170500555,-0.858367073,0.369349189,0.402167781,0.402167781,-0.858367073,-1.170500555,0,1,1
7042,30,83,4,54,50,1,3931.016,80,875.459,MORE,1184,1460,2644,5,2,-4,-0.374963384,4,-0.87303787,1.110872915,1.007919267,104,54,50,1,-1.116921539,-1.014433814,-1.170500555,2.041873821,1.943981498,1.943981498,-1.170500555,-1.014433814,1,1,1
7043,30,84,37,80,69,0,1644.607,60,1045.546,MORE,-482,986,504,2,1,-11,-1.031149307,11,0.349215148,0.269833484,-0.561704901,149,80,69,1,-0.219395302,0,-0.429183537,-0.466913126,-0.329170406,0.329170406,-0.429183537,0,1,1,0
7044,30,85,52,105,110,0,1523.874,40,704.348,MORE,-302,876,574,2,2,5,0.46870423,5,-0.698430296,-0.571205947,-0.644588338,215,105,110,0,1.096976512,0.975417129,1.170500555,-0.466913126,-0.083571761,0.083571761,1.170500555,0.975417129,0,0,0
7045,30,86,5,55,50,1,1139.515,90,979.513,MORE,744,458,1202,1,2,-5,-0.46870423,5,-0.698430296,1.531392631,-0.908451529,105,55,50,1,-1.096976512,-0.975417129,-1.170500555,-1.303175442,1.343629254,1.343629254,-1.170500555,-0.975417129,1,0,1
7046,30,87,30,96,80,0,2213.43,50,988.002,MORE,-828,1666,838,3,1,-16,-1.499853537,16,1.222253018,-0.150686231,-0.17120682,176,96,80,1,0.31912044,0.624266962,0,0.369349189,-0.80126558,0.80126558,0,0.624266962,0,1,0
7047,30,88,33,80,75,0,1556.253,70,960.941,MORE,-676,1142,466,2,1,-5,-0.46870423,5,-0.698430296,0.6903532,-0.622360092,155,80,75,1,-0.099725137,0,-0.195083426,-0.466913126,-0.593871168,0.593871168,-0.195083426,0,1,1,0
7048,30,89,48,110,128,1,1981.274,80,1744.347,MORE,688,898,1586,3,2,18,1.687335229,18,1.571468165,1.110872915,-0.330582359,238,110,128,0,1.555712144,1.170500555,1.872800887,0.369349189,1.267220787,1.267220787,1.872800887,1.170500555,1,1,1
7049,30,90,9,59,50,1,1845.04,20,1216.266,MORE,-238,1234,996,3,1,-9,-0.843667615,9,0,-1.412245378,-0.424107262,109,59,50,1,-1.017196402,-0.819350388,-1.170500555,0.369349189,0.003752202,0.003752202,-1.170500555,-0.819350388,0,1,0
7050,30,91,44,110,119,1,2286.256,10,1375.535,MORE,-644,1956,1312,3,1,9,0.843667615,9,0,-1.832765094,-0.121211631,229,110,119,0,1.376206896,1.170500555,1.521650721,0.369349189,-0.550209187,0.550209187,1.521650721,1.170500555,0,1,0
7051,30,92,2,52,50,1,1161.042,30,1271.683,MORE,-296,914,618,1,2,-2,-0.187481692,2,-1.222253018,-0.991725663,-0.893673202,102,52,50,1,-1.156811594,-1.092467184,-1.170500555,-1.303175442,-0.07538514,0.07538514,-1.170500555,-1.092467184,0,0,0
7052,30,93,8,58,50,0,2561.622,60,1045.305,MORE,-466,1486,1020,4,1,-8,-0.749926769,8,-0.174607574,0.269833484,0.067827657,108,58,50,1,-1.037141429,-0.858367073,-1.170500555,1.205611505,-0.307339416,0.307339416,-1.170500555,-0.858367073,1,1,0
7053,30,94,44,119,110,0,3953.939,30,1654.493,MORE,-172,1894,1722,2,1,-9,-0.843667615,9,0,-0.991725663,1.023655951,229,119,110,1,1.376206896,1.521650721,1.170500555,-0.466913126,0.093805038,0.093805038,1.170500555,1.521650721,0,0,0
7054,30,95,34,74,80,1,2041.792,60,478.292,MORE,200,904,1104,3,2,6,0.562445076,6,-0.523822722,0.269833484,-0.289036636,154,74,80,0,-0.119670165,-0.234100111,0,0.369349189,0.601375571,0.601375571,0,-0.234100111,1,1,1
7055,30,96,24,86,80,0,2881.944,60,464.059,MORE,-300,1440,1140,4,1,-6,-0.562445076,6,-0.523822722,0.269833484,0.287729325,166,86,80,1,0.119670165,0.234100111,0,1.205611505,-0.080842887,0.080842887,0,0.234100111,1,1,0
7056,30,97,39,66,80,1,1194.765,40,893.644,MORE,-26,896,870,1,1,14,1.312371845,14,0.87303787,-0.571205947,-0.870522298,146,66,80,0,-0.279230385,-0.546233592,0,-1.303175442,0.293012828,0.293012828,0,-0.546233592,0,0,1
7057,30,98,9,50,59,1,1735.61,20,1210.22,MORE,510,816,1326,1,1,9,0.843667615,9,0,-1.412245378,-0.499231167,109,50,59,0,-1.017196402,-1.170500555,-0.819350388,-1.303175442,1.024351016,1.024351016,-0.819350388,-1.170500555,0,0,1
7058,30,99,57,94,110,1,1946.147,30,1057.596,MORE,342,886,1228,1,2,16,1.499853537,16,1.222253018,-0.991725663,-0.354697112,204,94,110,0,0.877581209,0.546233592,1.170500555,-1.303175442,0.795125614,0.795125614,1.170500555,0.546233592,0,0,1
7059,30,100,60,110,87,0,2152.195,30,1354.231,MORE,-1094,1652,558,2,1,-23,-2.15603946,23,2.444506035,-0.991725663,-0.213244765,197,110,87,1,0.737966017,1.170500555,0.273116796,-0.466913126,-1.1642058,1.1642058,0.273116796,1.170500555,0,0,0
7060,30,101,33,75,80,1,1246.367,50,885.355,MORE,242,680,922,1,2,5,0.46870423,5,-0.698430296,-0.150686231,-0.835097426,155,75,80,0,-0.099725137,-0.195083426,0,-1.303175442,0.658681922,0.658681922,0,-0.195083426,0,0,1
7061,30,102,15,50,45,0,3708.225,20,1197.695,MORE,-882,2302,1420,4,1,-5,-0.46870423,5,-0.698430296,-1.412245378,0.854972818,95,50,45,1,-1.296426786,-1.170500555,-1.36558398,1.205611505,-0.874945173,0.874945173,-1.36558398,-1.170500555,0,1,0
7062,30,103,59,89,110,1,2636.322,80,1220.038,MORE,824,1182,2006,3,2,21,1.968557767,21,2.095290887,1.110872915,0.11910935,199,89,110,0,0.777856072,0.351150166,1.170500555,0.369349189,1.452784208,1.452784208,1.170500555,0.351150166,1,1,1
7063,30,104,29,80,94,1,2813.348,50,1294.301,MORE,310,1002,1312,3,2,14,1.312371845,14,0.87303787,-0.150686231,0.240638039,174,80,94,0,0.279230385,0,0.546233592,0.369349189,0.751463632,0.751463632,0.546233592,0,0,1,1
7064,30,105,55,110,98,1,1866.035,50,1532.909,MORE,-134,1210,1076,2,1,-12,-1.124890153,12,0.523822722,-0.150686231,-0.409694154,208,110,98,1,0.957361319,1.170500555,0.702300333,-0.466913126,0.145653641,0.145653641,0.702300333,1.170500555,0,0,0
7065,30,106,29,94,80,0,2551.49,10,1029.501,MORE,-1548,2158,610,2,1,-14,-1.312371845,14,0.87303787,-1.832765094,0.060872019,174,94,80,1,0.279230385,0.546233592,0,-0.466913126,-1.78366016,1.78366016,0,0.546233592,0,0,0
7066,30,107,57,110,94,0,2176.205,90,844.607,MORE,-894,1732,838,2,2,-16,-1.499853537,16,1.222253018,1.531392631,-0.196761854,204,110,94,1,0.877581209,1.170500555,0.546233592,-0.466913126,-0.891318416,0.891318416,0.546233592,1.170500555,1,0,0
7067,30,108,39,80,66,1,2625.664,0,1110.012,MORE,-518,1926,1408,3,1,-14,-1.312371845,14,0.87303787,-2.253284809,0.111792613,146,80,66,1,-0.279230385,0,-0.546233592,0.369349189,-0.378290135,0.378290135,-0.546233592,0,0,1,0
7068,30,109,4,50,54,1,1778.538,70,885.763,MORE,-14,786,772,3,2,4,0.374963384,4,-0.87303787,0.6903532,-0.469761013,104,50,54,0,-1.116921539,-1.170500555,-1.014433814,0.369349189,0.309386071,0.309386071,-1.014433814,-1.170500555,1,1,1
7069,30,110,55,98,110,1,2022.268,60,1400.07,MORE,62,910,972,1,2,12,1.124890153,12,0.523822722,0.269833484,-0.3024399,208,98,110,0,0.957361319,0.702300333,1.170500555,-1.303175442,0.413083277,0.413083277,1.170500555,0.702300333,1,0,1
7070,30,111,2,50,52,1,4227.507,70,1122.365,MORE,1578,340,1918,1,2,2,0.187481692,2,-1.222253018,0.6903532,1.211460908,102,50,52,0,-1.156811594,-1.170500555,-1.092467184,-1.303175442,2.481569643,2.481569643,-1.092467184,-1.170500555,1,0,1
7071,30,112,59,110,89,0,1816.041,10,1086.622,MORE,-1030,1408,378,2,1,-21,-1.968557767,21,2.095290887,-1.832765094,-0.444015131,199,110,89,1,0.777856072,1.170500555,0.351150166,-0.466913126,-1.076881837,1.076881837,0.351150166,1.170500555,0,0,0
7072,30,113,60,87,110,1,2079.825,20,1566.875,MORE,-754,1912,1158,3,1,23,2.15603946,23,2.444506035,-1.412245378,-0.262926909,197,87,110,0,0.737966017,0.273116796,1.170500555,0.369349189,-0.700297248,0.700297248,1.170500555,0.273116796,0,1,0
7073,30,114,52,110,105,1,2516.327,30,1525.794,MORE,434,1168,1602,3,2,-5,-0.46870423,5,-0.698430296,-0.991725663,0.036732552,215,110,105,1,1.096976512,1.170500555,0.975417129,0.369349189,0.92065381,0.92065381,0.975417129,1.170500555,0,1,1
7074,30,115,30,80,96,1,2061.501,40,1225.458,MORE,328,952,1280,3,2,16,1.499853537,16,1.222253018,-0.571205947,-0.27550637,176,80,96,0,0.31912044,0,0.624266962,0.369349189,0.776023497,0.776023497,0.624266962,0,0,1,1
7075,30,116,24,80,86,1,2488.583,60,1574.908,MORE,108,1404,1512,3,1,6,0.562445076,6,-0.523822722,0.269833484,0.017686243,166,80,86,0,0.119670165,0,0.234100111,0.369349189,0.475847375,0.475847375,0.234100111,0,1,1,1
7076,30,117,5,50,55,1,2200.586,60,907.501,MORE,470,764,1234,3,2,5,0.46870423,5,-0.698430296,0.269833484,-0.18002425,105,50,55,0,-1.096976512,-1.170500555,-0.975417129,0.369349189,0.969773539,0.969773539,-0.975417129,-1.170500555,0,1,1
7077,30,118,34,80,74,1,3023.51,50,1458.154,MORE,670,1092,1762,3,2,-6,-0.562445076,6,-0.523822722,-0.150686231,0.384914656,154,80,74,1,-0.119670165,0,-0.234100111,0.369349189,1.242660922,1.242660922,-0.234100111,0,0,1,1
7078,30,119,15,45,50,1,1094.31,80,1230.205,MORE,314,370,684,1,2,5,0.46870423,5,-0.698430296,1.110872915,-0.939484848,95,45,50,0,-1.296426786,-1.36558398,-1.170500555,-1.303175442,0.75692138,0.75692138,-1.170500555,-1.36558398,1,0,1
7079,30,120,37,69,80,1,1324.394,60,1215.026,MORE,450,554,1004,0,2,11,1.031149307,11,0.349215148,0.269833484,-0.781531741,149,69,80,0,-0.219395302,-0.429183537,0,-2.139437758,0.942484801,0.942484801,0,-0.429183537,0,0,1
7080,30,121,48,128,110,0,1603.795,80,991.231,LESS,-336,980,644,3,2,-18,-1.687335229,18,1.571468165,1.110872915,-0.589722418,238,128,110,0,1.555712144,1.872800887,1.170500555,0.369349189,-0.129962616,0.129962616,1.170500555,1.872800887,1,1,1
7081,30,122,8,50,58,0,1323.22,80,1907.615,LESS,-878,1230,352,2,2,8,0.749926769,8,-0.174607574,1.110872915,-0.782337694,108,50,58,1,-1.037141429,-1.170500555,-0.858367073,-0.466913126,-0.869487425,0.869487425,-0.858367073,-1.170500555,1,0,0
7082,30,123,4,54,50,1,3588.383,10,1054.513,LESS,386,1638,2024,5,1,-4,-0.374963384,4,-0.87303787,-1.832765094,0.772701055,104,54,50,0,-1.116921539,-1.014433814,-1.170500555,2.041873821,0.855160838,0.855160838,-1.170500555,-1.014433814,0,1,1
7083,30,124,37,80,69,0,2471.817,10,2057.479,LESS,-1062,1954,892,4,1,-11,-1.031149307,11,0.349215148,-1.832765094,0.006176352,149,80,69,0,-0.219395302,0,-0.429183537,1.205611505,-1.120543818,1.120543818,-0.429183537,0,0,1,0
7084,30,125,52,105,110,0,1571.333,90,749.354,LESS,-280,1204,924,2,2,5,0.46870423,5,-0.698430296,1.531392631,-0.612007643,215,105,110,1,1.096976512,0.975417129,1.170500555,-0.466913126,-0.053554149,0.053554149,1.170500555,0.975417129,1,0,1
7085,30,126,5,55,50,0,1910.577,60,876.135,LESS,-602,1116,514,2,1,-5,-0.46870423,5,-0.698430296,0.269833484,-0.379115986,105,55,50,0,-1.096976512,-0.975417129,-1.170500555,-0.466913126,-0.492902836,0.492902836,-1.170500555,-0.975417129,1,0,0
7086,30,127,30,96,80,1,2766.492,70,820.11,LESS,370,1384,1754,3,2,-16,-1.499853537,16,1.222253018,0.6903532,0.208471305,176,96,80,0,0.31912044,0.624266962,0,0.369349189,0.833329847,0.833329847,0,0.624266962,1,1,1
7087,30,128,33,80,75,0,4175.806,20,2374.344,LESS,-678,2540,1862,4,1,-5,-0.46870423,5,-0.698430296,-1.412245378,1.175968072,155,80,75,0,-0.099725137,0,-0.195083426,1.205611505,-0.596600042,0.596600042,-0.195083426,0,0,1,0
7088,30,129,48,110,128,0,1537.506,20,1462.313,LESS,-486,976,490,2,1,18,1.687335229,18,1.571468165,-1.412245378,-0.635229943,238,110,128,1,1.555712144,1.170500555,1.872800887,-0.466913126,-0.334628154,0.334628154,1.872800887,1.170500555,0,0,0
7089,30,130,9,59,50,0,3805.577,50,1296.98,LESS,-494,2006,1512,6,1,-9,-0.843667615,9,0,-0.150686231,0.921805153,109,59,50,0,-1.017196402,-0.819350388,-1.170500555,2.878136137,-0.345543649,0.345543649,-1.170500555,-0.819350388,0,1,0
7090,30,131,44,110,119,0,1168.33,70,1157.44,LESS,-564,978,414,2,1,9,0.843667615,9,0,0.6903532,-0.888669976,229,110,119,1,1.376206896,1.170500555,1.521650721,-0.466913126,-0.441054233,0.441054233,1.521650721,1.170500555,1,0,0
7091,30,132,2,52,50,0,1065.975,70,1043.984,LESS,-474,828,354,2,1,-2,-0.187481692,2,-1.222253018,0.6903532,-0.95893688,102,52,50,0,-1.156811594,-1.092467184,-1.170500555,-0.466913126,-0.318254911,0.318254911,-1.170500555,-1.092467184,1,0,1
7092,30,133,8,58,50,1,2202.548,80,948.779,LESS,0,1106,1106,5,2,-8,-0.749926769,8,-0.174607574,1.110872915,-0.178677334,108,58,50,0,-1.037141429,-0.858367073,-1.170500555,2.041873821,0.328488188,0.328488188,-1.170500555,-0.858367073,1,1,1
7093,30,134,44,119,110,0,2837.009,80,1484.855,LESS,-502,1560,1058,4,2,-9,-0.843667615,9,0,1.110872915,0.256881361,229,119,110,0,1.376206896,1.521650721,1.170500555,1.205611505,-0.356459145,0.356459145,1.170500555,1.521650721,1,1,0
7094,30,135,34,74,80,1,3346.425,70,1324.359,LESS,1084,968,2052,3,2,6,0.562445076,6,-0.523822722,0.6903532,0.606596423,154,74,80,1,-0.119670165,-0.234100111,0,0.369349189,1.807537806,1.807537806,0,-0.234100111,1,1,1
7095,30,136,24,86,80,0,1614.761,80,1763.838,LESS,-738,1196,458,2,1,-6,-0.562445076,6,-0.523822722,1.110872915,-0.582194238,166,86,80,0,0.119670165,0.234100111,0,-0.466913126,-0.678466257,0.678466257,0,0.234100111,1,0,0
7096,30,137,39,66,80,0,1683.858,80,1457.768,LESS,-480,914,434,1,2,14,1.312371845,14,0.87303787,1.110872915,-0.534759014,146,66,80,1,-0.279230385,-0.546233592,0,-1.303175442,-0.326441532,0.326441532,0,-0.546233592,1,0,0
7097,30,138,9,50,59,0,1578.828,70,1233.758,LESS,758,862,1620,2,1,9,0.843667615,9,0,0.6903532,-0.606862311,109,50,59,1,-1.017196402,-1.170500555,-0.819350388,-0.466913126,1.362731371,1.362731371,-0.819350388,-1.170500555,1,0,1
7098,30,139,57,94,110,0,3319.557,50,1146.079,LESS,-564,1756,1192,4,1,16,1.499853537,16,1.222253018,-0.150686231,0.58815149,204,94,110,1,0.877581209,0.546233592,1.170500555,1.205611505,-0.441054233,0.441054233,1.170500555,0.546233592,0,1,0
7099,30,140,60,110,87,1,2298.089,40,2064.845,LESS,82,970,1052,4,1,-23,-2.15603946,23,2.444506035,-0.571205947,-0.113088254,197,110,87,0,0.737966017,1.170500555,0.273116796,1.205611505,0.440372015,0.440372015,0.273116796,1.170500555,0,1,1
7100,30,141,33,75,80,0,1907.883,30,1042.429,LESS,-774,1246,472,2,1,5,0.46870423,5,-0.698430296,-0.991725663,-0.380965422,155,75,80,1,-0.099725137,-0.195083426,0,-0.466913126,-0.727585986,0.727585986,0,-0.195083426,0,0,0
7101,30,142,15,50,45,0,4006.024,10,1375.225,LESS,-912,2636,1724,4,1,-5,-0.46870423,5,-0.698430296,-1.832765094,1.059412403,95,50,45,0,-1.296426786,-1.170500555,-1.36558398,1.205611505,-0.915878281,0.915878281,-1.36558398,-1.170500555,0,1,0
7102,30,143,59,89,110,0,2118.075,50,447.314,LESS,-722,1366,644,1,1,21,1.968557767,21,2.095290887,-0.150686231,-0.23666821,199,89,110,1,0.777856072,0.351150166,1.170500555,-1.303175442,-0.656635266,0.656635266,1.170500555,0.351150166,0,0,0
7103,30,144,29,80,94,0,4360.044,10,1431.235,LESS,-1086,2668,1582,6,1,14,1.312371845,14,0.87303787,-1.832765094,1.302447813,174,80,94,1,0.279230385,0,0.546233592,2.878136137,-1.153290304,1.153290304,0.546233592,0,0,1,0
7104,30,145,55,110,98,1,2469.076,30,1166.668,LESS,-150,1410,1260,3,2,-12,-1.124890153,12,0.523822722,-0.991725663,0.00429465,208,110,98,0,0.957361319,1.170500555,0.702300333,0.369349189,0.12382265,0.12382265,0.702300333,1.170500555,0,1,1
7105,30,146,29,94,80,1,2419.886,50,640.763,LESS,422,888,1310,3,2,-14,-1.312371845,14,0.87303787,-0.150686231,-0.029474379,174,94,80,0,0.279230385,0.546233592,0,0.369349189,0.904280567,0.904280567,0,0.546233592,0,1,1
7106,30,147,57,110,94,1,5145.442,20,1776.128,LESS,-252,2494,2242,5,1,-16,-1.499853537,16,1.222253018,-1.412245378,1.841625048,204,110,94,0,0.877581209,1.170500555,0.546233592,2.041873821,-0.015349915,0.015349915,0.546233592,1.170500555,0,1,1
7107,30,148,39,80,66,0,5647.618,10,1839.032,LESS,-1204,3406,2202,4,1,-14,-1.312371845,14,0.87303787,-1.832765094,2.186369836,146,80,66,0,-0.279230385,0,-0.546233592,1.205611505,-1.314293861,1.314293861,-0.546233592,0,0,1,0
7108,30,149,4,50,54,0,1214.361,90,1131.361,LESS,-64,856,792,2,2,4,0.374963384,4,-0.87303787,1.531392631,-0.857069606,104,50,54,1,-1.116921539,-1.170500555,-1.014433814,-0.466913126,0.241164225,0.241164225,-1.014433814,-1.170500555,1,0,1
7109,30,150,55,98,110,0,1420.738,70,1227.051,LESS,-286,928,642,3,2,12,1.124890153,12,0.523822722,0.6903532,-0.7153914,208,98,110,1,0.957361319,0.702300333,1.170500555,0.369349189,-0.061740771,0.061740771,1.170500555,0.702300333,1,1,1
7110,30,151,2,50,52,0,1675.888,40,1772.432,LESS,-826,1258,432,2,1,2,0.187481692,2,-1.222253018,-0.571205947,-0.540230435,102,50,52,1,-1.156811594,-1.170500555,-1.092467184,-0.466913126,-0.798536706,0.798536706,-1.092467184,-1.170500555,0,0,0
7111,30,152,59,110,89,1,1319.379,70,1585.122,LESS,348,542,890,1,2,-21,-1.968557767,21,2.095290887,0.6903532,-0.784974548,199,110,89,0,0.777856072,1.170500555,0.351150166,-1.303175442,0.803312235,0.803312235,0.351150166,1.170500555,1,0,1
7112,30,153,60,87,110,0,1349.761,40,1273.114,LESS,-232,768,536,2,1,23,2.15603946,23,2.444506035,-0.571205947,-0.764117246,197,87,110,1,0.737966017,0.273116796,1.170500555,-0.466913126,0.011938823,0.011938823,1.170500555,0.273116796,0,0,1
7113,30,154,52,110,105,0,2184.928,60,1257.46,LESS,-1166,1664,498,2,1,-5,-0.46870423,5,-0.698430296,0.269833484,-0.190773497,215,110,105,0,1.096976512,1.170500555,0.975417129,-0.466913126,-1.262445258,1.262445258,0.975417129,1.170500555,0,0,0
7114,30,155,30,80,96,0,1432.667,70,1181.602,LESS,-508,958,450,2,1,16,1.499853537,16,1.222253018,0.6903532,-0.707202118,176,80,96,1,0.31912044,0,0.624266962,-0.466913126,-0.364645766,0.364645766,0.624266962,0,1,0,0
7115,30,156,24,80,86,0,1191.866,80,1577.858,LESS,-380,916,536,2,1,6,0.562445076,6,-0.523822722,1.110872915,-0.872512467,166,80,86,1,0.119670165,0,0.234100111,-0.466913126,-0.189997841,0.189997841,0.234100111,0,1,0,1
7116,30,157,5,50,55,0,1463.003,70,1643.564,LESS,-388,862,474,2,1,5,0.46870423,5,-0.698430296,0.6903532,-0.686376396,105,50,55,1,-1.096976512,-1.170500555,-0.975417129,-0.466913126,-0.200913336,0.200913336,-0.975417129,-1.170500555,1,1,1
7117,30,158,34,80,74,0,1513.214,70,764.295,LESS,-730,1174,444,2,1,-6,-0.562445076,6,-0.523822722,0.6903532,-0.651906448,154,80,74,0,-0.119670165,0,-0.234100111,-0.466913126,-0.667550762,0.667550762,-0.234100111,0,1,0,0
7118,30,159,15,45,50,0,1299.286,70,1240,LESS,328,786,1114,2,2,5,0.46870423,5,-0.698430296,0.6903532,-0.798768431,95,45,50,1,-1.296426786,-1.36558398,-1.170500555,-0.466913126,0.776023497,0.776023497,-1.170500555,-1.36558398,1,0,1
7119,30,160,37,69,80,0,1350.305,60,757.122,LESS,-428,826,398,2,1,11,1.031149307,11,0.349215148,0.269833484,-0.763743789,149,69,80,1,-0.219395302,-0.429183537,0,-0.466913126,-0.255490813,0.255490813,0,-0.429183537,0,0,1
7120,30,161,3,50,53,1,3843.156,30,1143.494,MORE,-210,1604,1394,5,1,3,0.281222538,3,-1.047645444,-0.991725663,0.947603208,103,50,53,0,-1.136866566,-1.170500555,-1.053450499,2.041873821,0.041956435,0.041956435,-1.053450499,-1.170500555,0,1,0
7121,30,162,20,50,40,0,2618.833,40,1060.268,MORE,-530,1454,924,4,1,-10,-0.937408461,10,0.174607574,-0.571205947,0.107103118,90,50,40,1,-1.396151924,-1.170500555,-1.560667406,1.205611505,-0.394663378,0.394663378,-1.560667406,-1.170500555,0,1,0
7122,30,163,25,80,88,1,1985.126,60,908.487,MORE,-106,1074,968,3,2,8,0.749926769,8,-0.174607574,0.269833484,-0.327937954,168,80,88,0,0.15956022,0,0.312133481,0.369349189,0.183857875,0.183857875,0.312133481,0,1,1,0
7123,30,164,42,115,110,0,1415.111,60,932.993,MORE,-618,1090,472,2,1,-5,-0.46870423,5,-0.698430296,0.269833484,-0.719254346,225,115,110,1,1.296426786,1.36558398,1.170500555,-0.466913126,-0.514733827,0.514733827,1.170500555,1.36558398,1,0,0
7124,30,165,53,103,110,1,2119.517,70,1436.276,MORE,210,978,1188,3,2,7,0.656185922,7,-0.349215148,0.6903532,-0.235678274,213,103,110,0,1.057086457,0.897383758,1.170500555,0.369349189,0.61501994,0.61501994,1.170500555,0.897383758,1,1,1
7125,30,166,26,90,80,1,3178.614,70,825,MORE,746,1274,2020,5,2,-10,-0.937408461,10,0.174607574,0.6903532,0.49139385,170,90,80,1,0.199450275,0.390166852,0,2.041873821,1.346358128,1.346358128,0,0.390166852,1,1,1
7126,30,167,35,80,72,1,1363.298,60,1030.086,MORE,288,618,906,1,1,-8,-0.749926769,8,-0.174607574,0.269833484,-0.75482407,152,80,72,1,-0.15956022,0,-0.312133481,-1.303175442,0.72144602,0.72144602,-0.312133481,0,1,0,1
7127,30,168,28,93,80,0,1475.193,60,1307.735,MORE,-616,1100,484,2,1,-13,-1.218630999,13,0.698430296,0.269833484,-0.678007938,173,93,80,1,0.259285357,0.507216907,0,-0.466913126,-0.512004953,0.512004953,0,0.507216907,0,0,0
7128,30,169,26,80,90,1,1567.028,60,1088.898,MORE,528,742,1270,1,2,10,0.937408461,10,0.174607574,0.269833484,-0.614963034,170,80,90,0,0.199450275,0,0.390166852,-1.303175442,1.04891088,1.04891088,0.390166852,0,0,0,1
7129,30,170,25,88,80,0,1515.305,70,1064.207,MORE,-864,1310,446,2,1,-8,-0.749926769,8,-0.174607574,0.6903532,-0.650470973,168,88,80,1,0.15956022,0.312133481,0,-0.466913126,-0.850385309,0.850385309,0,0.312133481,1,0,0
7130,30,171,36,80,70,0,1637.805,70,849.792,MORE,-522,1114,592,2,1,-10,-0.937408461,10,0.174607574,0.6903532,-0.566374487,150,80,70,1,-0.199450275,0,-0.390166852,-0.466913126,-0.383747883,0.383747883,-0.390166852,0,1,0,0
7131,30,172,28,80,93,1,2005.049,60,1133.646,MORE,-78,1176,1098,1,2,13,1.218630999,13,0.698430296,0.269833484,-0.314260776,173,80,93,0,0.259285357,0,0.507216907,-1.303175442,0.222062108,0.222062108,0.507216907,0,0,0,0
7132,30,173,21,82,80,1,1340.078,70,1016.172,MORE,230,622,852,1,2,-2,-0.187481692,2,-1.222253018,0.6903532,-0.770764645,162,82,80,1,0.039890055,0.07803337,0,-1.303175442,0.642308679,0.642308679,0,0.07803337,1,0,1
7133,30,174,19,50,41,0,1613.262,70,1111.502,MORE,-588,1118,530,2,1,-9,-0.843667615,9,0,0.6903532,-0.583223304,91,50,41,1,-1.376206896,-1.170500555,-1.521650721,-0.466913126,-0.47380072,0.47380072,-1.521650721,-1.170500555,1,0,0
7134,30,175,56,96,110,1,1794.529,60,1018.511,MORE,596,756,1352,1,2,14,1.312371845,14,0.87303787,0.269833484,-0.45878316,206,96,110,0,0.917471264,0.624266962,1.170500555,-1.303175442,1.14169259,1.14169259,1.170500555,0.624266962,0,0,1
7135,30,176,23,80,85,1,2032.982,70,993.129,MORE,-288,1046,758,1,2,5,0.46870423,5,-0.698430296,0.6903532,-0.295084718,165,80,85,0,0.099725137,0,0.195083426,-1.303175442,-0.064469644,0.064469644,0.195083426,0,1,0,0
7136,30,177,10,60,50,1,2459.925,40,1245.625,MORE,208,1148,1356,3,1,-10,-0.937408461,10,0.174607574,-0.571205947,-0.001987529,110,60,50,1,-0.997251374,-0.780333703,-1.170500555,0.369349189,0.612291067,0.612291067,-1.170500555,-0.780333703,0,1,1
7137,30,178,19,41,50,1,2123.6,90,820.933,MORE,988,490,1478,1,2,9,0.843667615,9,0,1.531392631,-0.232875287,91,41,50,0,-1.376206896,-1.521650721,-1.170500555,-1.303175442,1.676551862,1.676551862,-1.170500555,-1.521650721,1,0,1
7138,30,179,56,110,96,0,2061.373,0,1199.118,MORE,-1334,1942,608,2,1,-14,-1.312371845,14,0.87303787,-2.253284809,-0.275594242,206,110,96,1,0.917471264,1.170500555,0.624266962,-0.466913126,-1.49167066,1.49167066,0.624266962,1.170500555,0,0,0
7139,30,180,35,72,80,1,1303.593,70,845.978,MORE,676,508,1184,1,2,8,0.749926769,8,-0.174607574,0.6903532,-0.795811667,152,72,80,0,-0.15956022,-0.312133481,0,-1.303175442,1.250847544,1.250847544,0,-0.312133481,1,0,1
7140,30,181,11,49,50,1,1128.022,70,1311.686,MORE,488,424,912,1,2,1,0.093740846,1,-1.396860592,0.6903532,-0.916341496,99,49,50,0,-1.216646676,-1.20951724,-1.170500555,-1.303175442,0.994333403,0.994333403,-1.170500555,-1.20951724,1,0,1
7141,30,182,17,43,50,1,1167.204,70,1013.759,MORE,436,456,892,1,2,7,0.656185922,7,-0.349215148,0.6903532,-0.889442977,93,43,50,0,-1.336316841,-1.443617351,-1.170500555,-1.303175442,0.923382684,0.923382684,-1.170500555,-1.443617351,1,0,1
7142,30,183,1,51,50,1,2388.657,70,1132.643,MORE,244,950,1194,3,2,-1,-0.093740846,1,-1.396860592,0.6903532,-0.050913148,101,51,50,1,-1.176756621,-1.131483869,-1.170500555,0.369349189,0.661410796,0.661410796,-1.170500555,-1.131483869,1,1,1
7143,30,184,41,112,110,1,1491.197,50,1636.046,MORE,-270,860,590,1,1,-2,-0.187481692,2,-1.222253018,-0.150686231,-0.667021161,222,112,110,1,1.236591704,1.248533925,1.170500555,-1.303175442,-0.03990978,0.03990978,1.170500555,1.248533925,0,0,0
7144,30,185,20,40,50,1,1295.26,10,883.767,MORE,-308,1036,728,1,1,10,0.937408461,10,0.174607574,-1.832765094,-0.801532288,90,40,50,0,-1.396151924,-1.560667406,-1.170500555,-1.303175442,-0.091758383,0.091758383,-1.170500555,-1.560667406,0,0,0
7145,30,186,1,50,51,1,1321.192,40,1411.731,MORE,-124,820,696,3,2,1,0.093740846,1,-1.396860592,-0.571205947,-0.78372992,101,50,51,0,-1.176756621,-1.170500555,-1.131483869,0.369349189,0.15929801,0.15929801,-1.131483869,-1.170500555,0,1,0
7146,30,187,23,85,80,0,2679.099,20,1351.941,MORE,-1032,2002,970,4,1,-5,-0.46870423,5,-0.698430296,-1.412245378,0.148475843,165,85,80,1,0.099725137,0.195083426,0,1.205611505,-1.079610711,1.079610711,0,0.195083426,0,1,0
7147,30,188,11,50,49,1,1085.844,30,1034.224,MORE,586,428,1014,1,2,-1,-0.093740846,1,-1.396860592,-0.991725663,-0.945296774,99,50,49,1,-1.216646676,-1.170500555,-1.20951724,-1.303175442,1.128048221,1.128048221,-1.20951724,-1.170500555,0,0,1
7148,30,189,17,50,43,1,1613.271,50,944.328,MORE,564,292,856,1,2,-7,-0.656185922,7,-0.349215148,-0.150686231,-0.583217125,93,50,43,1,-1.336316841,-1.170500555,-1.443617351,-1.303175442,1.098030609,1.098030609,-1.443617351,-1.170500555,0,0,1
7149,30,190,21,80,82,1,1137.866,60,1060.023,MORE,-192,702,510,2,1,2,0.187481692,2,-1.222253018,0.269833484,-0.909583571,162,80,82,0,0.039890055,0,0.07803337,-0.466913126,0.0665163,0.0665163,0.07803337,0,0,0,0
7150,30,191,10,50,60,1,1864.358,70,787.507,MORE,920,480,1400,1,2,10,0.937408461,10,0.174607574,0.6903532,-0.410845418,110,50,60,0,-0.997251374,-1.170500555,-0.780333703,-1.303175442,1.583770152,1.583770152,-0.780333703,-1.170500555,1,0,1
7151,30,192,3,53,50,1,1023.655,60,944.602,MORE,416,304,720,1,2,-3,-0.281222538,3,-1.047645444,0.269833484,-0.987989642,103,53,50,1,-1.136866566,-1.053450499,-1.170500555,-1.303175442,0.896093945,0.896093945,-1.170500555,-1.053450499,0,0,1
7152,30,193,45,122,110,0,3151.754,90,1554.26,MORE,-828,2178,1350,4,2,-12,-1.124890153,12,0.523822722,1.531392631,0.472954408,232,122,110,1,1.436041979,1.638700776,1.170500555,1.205611505,-0.80126558,0.80126558,1.170500555,1.638700776,1,1,0
7153,30,194,38,67,80,1,1274.345,90,826.757,MORE,856,424,1280,1,2,13,1.218630999,13,0.698430296,1.531392631,-0.815890475,147,67,80,0,-0.259285357,-0.507216907,0,-1.303175442,1.496446189,1.496446189,0,-0.507216907,1,0,1
7154,30,195,38,80,67,0,1855.381,80,981.758,MORE,-82,1348,1266,2,2,-13,-1.218630999,13,0.698430296,1.110872915,-0.417008146,147,80,67,1,-0.259285357,0,-0.507216907,-0.466913126,0.216604361,0.216604361,-0.507216907,0,1,0,0
7155,30,196,36,70,80,1,2353.316,60,1385.028,MORE,1468,574,2042,2,2,10,0.937408461,10,0.174607574,0.269833484,-0.075174812,150,70,80,0,-0.199450275,-0.390166852,0,-0.466913126,2.331481582,2.331481582,0,-0.390166852,0,0,1
7156,30,197,45,110,122,1,1601.665,70,732.458,MORE,336,658,994,1,2,12,1.124890153,12,0.523822722,0.6903532,-0.591184667,232,110,122,0,1.436041979,1.170500555,1.638700776,-1.303175442,0.786938992,0.786938992,1.638700776,1.170500555,1,0,1
7157,30,198,42,110,115,1,2335.574,70,1319.983,MORE,16,1260,1276,3,2,5,0.46870423,5,-0.698430296,0.6903532,-0.087354729,225,110,115,0,1.296426786,1.170500555,1.36558398,0.369349189,0.350319178,0.350319178,1.36558398,1.170500555,1,1,1
7158,30,199,41,110,112,1,1638.986,70,1773.668,MORE,-342,1140,798,1,1,2,0.187481692,2,-1.222253018,0.6903532,-0.565563729,222,110,112,0,1.236591704,1.170500555,1.248533925,-1.303175442,-0.138149238,0.138149238,1.248533925,1.170500555,1,0,0
7159,30,200,53,110,103,1,1278.711,60,1233.505,MORE,172,718,890,1,2,-7,-0.656185922,7,-0.349215148,0.269833484,-0.812893208,213,110,103,1,1.057086457,1.170500555,0.897383758,-1.303175442,0.563171338,0.563171338,0.897383758,1.170500555,1,0,1
7160,30,201,3,50,53,0,4951.973,10,1227.55,LESS,-1476,3060,1584,5,1,3,0.281222538,3,-1.047645444,-1.832765094,1.708808208,103,50,53,1,-1.136866566,-1.170500555,-1.053450499,2.041873821,-1.685420702,1.685420702,-1.053450499,-1.170500555,0,1,0
7161,30,202,20,50,40,1,1892.671,20,1437.194,LESS,-292,1256,964,3,1,-10,-0.937408461,10,0.174607574,-1.412245378,-0.391408489,90,50,40,0,-1.396151924,-1.170500555,-1.560667406,0.369349189,-0.069927392,0.069927392,-1.560667406,-1.170500555,0,1,1
7162,30,203,25,80,88,1,1307.743,20,1442.38,LESS,-330,1248,918,2,1,8,0.749926769,8,-0.174607574,-1.412245378,-0.792962684,168,80,88,1,0.15956022,0,0.312133481,-0.466913126,-0.121775995,0.121775995,0.312133481,0,0,0,1
7163,30,204,42,115,110,1,3760.532,10,1741.168,LESS,-606,2580,1974,5,1,-5,-0.46870423,5,-0.698430296,-1.832765094,0.890881674,225,115,110,0,1.296426786,1.36558398,1.170500555,2.041873821,-0.498360584,0.498360584,1.170500555,1.36558398,0,1,0
7164,30,205,53,103,110,1,1488.636,10,869.572,LESS,-610,1348,738,3,1,7,0.656185922,7,-0.349215148,-1.832765094,-0.668779292,213,103,110,1,1.057086457,0.897383758,1.170500555,0.369349189,-0.503818332,0.503818332,1.170500555,0.897383758,0,1,0
7165,30,206,26,90,80,1,2358.702,70,1169.579,LESS,474,1050,1524,3,2,-10,-0.937408461,10,0.174607574,0.6903532,-0.071477313,170,90,80,0,0.199450275,0.390166852,0,0.369349189,0.975231287,0.975231287,0,0.390166852,1,1,1
7166,30,207,35,80,72,1,3096.968,10,1218.605,LESS,-312,1910,1598,3,1,-8,-0.749926769,8,-0.174607574,-1.832765094,0.435343714,152,80,72,0,-0.15956022,0,-0.312133481,0.369349189,-0.09721613,0.09721613,-0.312133481,0,0,1,1
7167,30,208,28,93,80,1,1104.932,60,809.487,LESS,320,474,794,1,2,-13,-1.218630999,13,0.698430296,0.269833484,-0.932192825,173,93,80,0,0.259285357,0.507216907,0,-1.303175442,0.765108001,0.765108001,0,0.507216907,1,0,1
7168,30,209,26,80,90,0,1242.689,90,814.938,LESS,-174,772,598,2,2,10,0.937408461,10,0.174607574,1.531392631,-0.83762238,170,80,90,1,0.199450275,0,0.390166852,-0.466913126,0.091076164,0.091076164,0.390166852,0,1,0,1
7169,30,210,25,88,80,0,1565.027,60,998.198,LESS,-78,1050,972,3,2,-8,-0.749926769,8,-0.174607574,0.269833484,-0.616336724,168,88,80,0,0.15956022,0.312133481,0,0.369349189,0.222062108,0.222062108,0,0.312133481,0,1,1
7170,30,211,36,80,70,1,2800.238,70,904.672,LESS,872,856,1728,3,2,-10,-0.937408461,10,0.174607574,0.6903532,0.231637999,150,80,70,0,-0.199450275,0,-0.390166852,0.369349189,1.51827718,1.51827718,-0.390166852,0,1,1,1
7171,30,212,28,80,93,0,1284.573,100,1392.116,LESS,440,920,1360,2,2,13,1.218630999,13,0.698430296,1.951912346,-0.808868934,173,80,93,1,0.259285357,0,0.507216907,-0.466913126,0.928840431,0.928840431,0.507216907,0,1,1,1
7172,30,213,21,82,80,1,2681.524,10,1344.952,LESS,-1016,2336,1320,5,1,-2,-0.187481692,2,-1.222253018,-1.832765094,0.15014061,162,82,80,0,0.039890055,0.07803337,0,2.041873821,-1.05777972,1.05777972,0,0.07803337,0,1,0
7173,30,214,19,50,41,1,3887.457,70,1216.661,LESS,-152,1932,1780,5,2,-9,-0.843667615,9,0,0.6903532,0.97801593,91,50,41,0,-1.376206896,-1.170500555,-1.521650721,2.041873821,0.121093776,0.121093776,-1.521650721,-1.170500555,1,1,1
7174,30,215,56,96,110,0,2981.58,20,973.016,LESS,-1136,2094,958,2,1,14,1.312371845,14,0.87303787,-1.412245378,0.35612963,206,96,110,1,0.917471264,0.624266962,1.170500555,-0.466913126,-1.22151215,1.22151215,1.170500555,0.624266962,0,0,0
7175,30,216,23,80,85,0,1766.287,70,442.709,LESS,-608,1096,488,2,1,5,0.46870423,5,-0.698430296,0.6903532,-0.478171348,165,80,85,1,0.099725137,0,0.195083426,-0.466913126,-0.501089458,0.501089458,0.195083426,0,1,0,0
7176,30,217,10,60,50,1,3680.474,90,802.1,LESS,1258,1350,2608,3,2,-10,-0.937408461,10,0.174607574,1.531392631,0.835921703,110,60,50,0,-0.997251374,-0.780333703,-1.170500555,0.369349189,2.04494983,2.04494983,-1.170500555,-0.780333703,1,1,1
7177,30,218,19,41,50,0,1529.816,70,1676.671,LESS,-506,918,412,2,1,9,0.843667615,9,0,0.6903532,-0.640509143,91,41,50,1,-1.376206896,-1.521650721,-1.170500555,-0.466913126,-0.361916892,0.361916892,-1.170500555,-1.521650721,1,0,0
7178,30,219,56,110,96,1,1301.982,70,885.393,LESS,652,594,1246,1,2,-14,-1.312371845,14,0.87303787,0.6903532,-0.796917622,206,110,96,0,0.917471264,1.170500555,0.624266962,-1.303175442,1.218101058,1.218101058,0.624266962,1.170500555,1,0,1
7179,30,220,35,72,80,0,2182.417,80,1342.682,LESS,-652,1240,588,2,1,8,0.749926769,8,-0.174607574,1.110872915,-0.192497304,152,72,80,1,-0.15956022,-0.312133481,0,-0.466913126,-0.561124682,0.561124682,0,-0.312133481,1,0,0
7180,30,221,11,49,50,1,4965.714,90,813.191,LESS,290,2438,2728,5,2,1,0.093740846,1,-1.396860592,1.531392631,1.718241431,99,49,50,1,-1.216646676,-1.20951724,-1.170500555,2.041873821,0.724174894,0.724174894,-1.170500555,-1.20951724,1,1,1
7181,30,222,17,43,50,0,1465.364,70,1329.93,LESS,-450,858,408,2,1,7,0.656185922,7,-0.349215148,0.6903532,-0.684755565,93,43,50,1,-1.336316841,-1.443617351,-1.170500555,-0.466913126,-0.285508425,0.285508425,-1.170500555,-1.443617351,1,0,1
7182,30,223,1,51,50,1,2571.036,70,970.081,LESS,1436,1030,2466,3,2,-1,-0.093740846,1,-1.396860592,0.6903532,0.074290386,101,51,50,0,-1.176756621,-1.131483869,-1.170500555,0.369349189,2.287819601,2.287819601,-1.170500555,-1.131483869,1,1,1
7183,30,224,41,112,110,0,2076.659,60,786.132,LESS,-728,1300,572,2,1,-2,-0.187481692,2,-1.222253018,0.269833484,-0.265100374,222,112,110,0,1.236591704,1.248533925,1.170500555,-0.466913126,-0.664821888,0.664821888,1.170500555,1.248533925,0,0,0
7184,30,225,20,40,50,0,1933.268,90,820.576,LESS,-142,1444,1302,3,2,10,0.937408461,10,0.174607574,1.531392631,-0.363538571,90,40,50,1,-1.396151924,-1.560667406,-1.170500555,0.369349189,0.134738146,0.134738146,-1.170500555,-1.560667406,1,1,1
7185,30,226,1,50,51,0,1267.656,30,1021.401,LESS,-110,788,678,2,1,1,0.093740846,1,-1.396860592,-0.991725663,-0.820482487,101,50,51,1,-1.176756621,-1.170500555,-1.131483869,-0.466913126,0.178400127,0.178400127,-1.131483869,-1.170500555,0,0,1
7186,30,227,23,85,80,1,1443.931,80,1377.263,LESS,522,506,1028,1,2,-5,-0.46870423,5,-0.698430296,1.110872915,-0.699469361,165,85,80,0,0.099725137,0.195083426,0,-1.303175442,1.040724259,1.040724259,0,0.195083426,1,0,1
7187,30,228,11,50,49,1,2438.279,50,1387.191,LESS,-76,1552,1476,1,2,-1,-0.093740846,1,-1.396860592,-0.150686231,-0.016847549,99,50,49,0,-1.216646676,-1.170500555,-1.20951724,-1.303175442,0.224790982,0.224790982,-1.20951724,-1.170500555,0,0,1
7188,30,229,17,50,43,1,2751.097,60,1324.45,LESS,214,1452,1666,3,1,-7,-0.656185922,7,-0.349215148,0.269833484,0.197902608,93,50,43,0,-1.336316841,-1.170500555,-1.443617351,0.369349189,0.620477688,0.620477688,-1.443617351,-1.170500555,1,1,1
7189,30,230,21,80,82,0,1564.722,10,1165.874,LESS,-98,848,750,3,1,2,0.187481692,2,-1.222253018,-1.832765094,-0.616546107,162,80,82,1,0.039890055,0,0.07803337,0.369349189,0.19477337,0.19477337,0.07803337,0,0,1,1
7190,30,231,10,50,60,0,2352.118,20,902.811,LESS,-12,1100,1088,4,1,10,0.937408461,10,0.174607574,-1.412245378,-0.075997241,110,50,60,1,-0.997251374,-1.170500555,-0.780333703,1.205611505,0.312114945,0.312114945,-0.780333703,-1.170500555,0,1,1
7191,30,232,3,53,50,0,1822.72,40,697.059,LESS,-528,1224,696,2,1,-3,-0.281222538,3,-1.047645444,-0.571205947,-0.439429985,103,53,50,0,-1.136866566,-1.053450499,-1.170500555,-0.466913126,-0.391934504,0.391934504,-1.170500555,-1.053450499,0,0,0
7192,30,233,45,122,110,0,1442.999,30,660.623,LESS,-422,990,568,2,1,-12,-1.124890153,12,0.523822722,-0.991725663,-0.70010918,232,122,110,0,1.436041979,1.638700776,1.170500555,-0.466913126,-0.247304191,0.247304191,1.170500555,1.638700776,0,0,1
7193,30,234,38,67,80,0,1255.61,20,1240.169,LESS,-1150,1554,404,2,1,13,1.218630999,13,0.698430296,-1.412245378,-0.828752089,147,67,80,1,-0.259285357,-0.507216907,0,-0.466913126,-1.240614267,1.240614267,0,-0.507216907,0,0,0
7194,30,235,38,80,67,1,2348.812,30,1537.596,LESS,128,1190,1318,3,1,-13,-1.218630999,13,0.698430296,-0.991725663,-0.078266817,147,80,67,0,-0.259285357,0,-0.507216907,0.369349189,0.503136113,0.503136113,-0.507216907,0,0,1,1
7195,30,236,36,70,80,0,1643.121,30,1305.859,LESS,-636,1254,618,2,1,10,0.937408461,10,0.174607574,-0.991725663,-0.562725043,150,70,80,1,-0.199450275,-0.390166852,0,-0.466913126,-0.539293692,0.539293692,0,-0.390166852,0,1,0
7196,30,237,45,110,122,0,1182.747,60,1325.32,LESS,-342,822,480,2,1,12,1.124890153,12,0.523822722,0.269833484,-0.878772678,232,110,122,1,1.436041979,1.170500555,1.638700776,-0.466913126,-0.138149238,0.138149238,1.638700776,1.170500555,1,0,1
7197,30,238,42,110,115,0,1408.478,70,1535.702,LESS,-536,1012,476,2,1,5,0.46870423,5,-0.698430296,0.6903532,-0.723807913,225,110,115,1,1.296426786,1.170500555,1.36558398,-0.466913126,-0.40285,0.40285,1.36558398,1.170500555,1,0,0
7198,30,239,41,110,112,0,1268.188,70,1022.02,LESS,-642,984,342,2,1,2,0.187481692,2,-1.222253018,0.6903532,-0.820117268,222,110,112,1,1.236591704,1.170500555,1.248533925,-0.466913126,-0.547480313,0.547480313,1.248533925,1.170500555,1,0,0
7199,30,240,53,110,103,0,2633.434,30,1285.419,LESS,-188,1246,1058,4,1,-7,-0.656185922,7,-0.349215148,-0.991725663,0.117126733,213,110,103,0,1.057086457,1.170500555,0.897383758,1.205611505,0.071974047,0.071974047,0.897383758,1.170500555,0,1,1
7440,32,1,49,110,131,0,4973.784,64,2175.703,LESS,-1702,3196,1494,4,1,21,1.968557767,21,2.095290887,-0.592559971,1.172987361,241,110,131,1,1.615547226,1.170500555,1.989850943,1.365512643,-1.707620907,1.707620907,1.989850943,1.170500555,0,1,0
7441,32,2,13,47,50,0,2447.307,84,954.965,LESS,-190,1474,1284,2,2,3,0.281222538,3,-1.047645444,0.782821006,-0.777895709,97,47,50,1,-1.256536731,-1.28755061,-1.170500555,-0.460242423,0.159954363,0.159954363,-1.170500555,-1.28755061,1,1,1
7442,32,3,16,50,44,0,2449.867,84,1976.785,LESS,-454,1606,1152,2,2,-6,-0.562445076,6,-0.523822722,0.782821006,-0.775918941,94,50,44,0,-1.316371814,-1.170500555,-1.404600665,-0.460242423,-0.166130208,0.166130208,-1.404600665,-1.170500555,1,1,1
7443,32,4,7,57,50,1,2613.994,74,2174.999,LESS,154,1032,1186,3,2,-7,-0.656185922,7,-0.349215148,0.095130518,-0.649184129,107,57,50,0,-1.057086457,-0.897383758,-1.170500555,0.45263511,0.584852441,0.584852441,-1.170500555,-0.897383758,1,1,1
7444,32,5,18,42,50,0,2133.02,94,1246.103,LESS,-360,1454,1094,2,2,8,0.749926769,8,-0.174607574,1.470511494,-1.02058036,92,42,50,1,-1.356261869,-1.482634036,-1.170500555,-0.460242423,-0.050024338,0.050024338,-1.170500555,-1.482634036,1,0,1
7445,32,6,51,108,110,0,3913.398,24,2654.584,LESS,-1818,3314,1496,4,1,2,0.187481692,2,-1.222253018,-3.343321923,0.35418351,218,108,110,1,1.156811594,1.092467184,1.170500555,1.365512643,-1.850900491,1.850900491,1.170500555,1.092467184,0,1,0
7446,32,7,31,78,80,0,3603.907,44,2643.189,LESS,-760,2026,1266,4,1,2,0.187481692,2,-1.222253018,-1.967940947,0.115202213,158,78,80,1,-0.039890055,-0.07803337,0,1.365512643,-0.544091869,0.544091869,0,-0.07803337,0,1,0
7447,32,8,58,110,92,0,9125.077,14,3568.122,LESS,-3080,5512,2432,6,1,-18,-1.687335229,18,1.571468165,-4.031012411,4.37851317,202,110,92,0,0.837691154,1.170500555,0.468200222,3.191267708,-3.409683554,3.409683554,0.468200222,1.170500555,0,1,0
7448,32,9,12,50,48,0,4338.833,54,2663.55,LESS,-1064,2602,1538,4,1,-2,-0.187481692,2,-1.222253018,-1.280250459,0.682693898,98,50,48,0,-1.236591704,-1.170500555,-1.248533925,1.365512643,-0.919583194,0.919583194,-1.248533925,-1.170500555,0,1,0
7449,32,10,54,110,101,1,7992.463,54,2609.988,LESS,384,3264,3648,4,2,-9,-0.843667615,9,0,-1.280250459,3.503936645,211,110,101,0,1.017196402,1.170500555,0.819350388,1.365512643,0.868941272,0.868941272,0.819350388,1.170500555,0,1,1
7450,32,11,14,46,50,1,7006.809,44,2277.437,LESS,-1258,3716,2458,6,1,4,0.374963384,4,-0.87303787,-1.967940947,2.742838997,96,46,50,1,-1.276481759,-1.326567295,-1.170500555,3.191267708,-1.159205947,1.159205947,-1.170500555,-1.326567295,0,1,0
7451,32,12,22,80,83,0,3355.692,64,1744.517,LESS,-456,1378,922,1,2,3,0.281222538,3,-1.047645444,-0.592559971,-0.076463273,163,80,83,1,0.059835082,0,0.117050055,-1.373119956,-0.168600545,0.168600545,0.117050055,0,0,0,1
7452,32,13,6,50,56,0,3626.428,44,2978.235,LESS,-1172,2004,832,2,2,6,0.562445076,6,-0.523822722,-1.967940947,0.132592372,106,50,56,1,-1.077031484,-1.170500555,-0.936400444,-0.460242423,-1.052981427,1.052981427,-0.936400444,-1.170500555,0,1,0
7453,32,14,13,50,47,1,3624.866,54,2705.852,LESS,494,1082,1576,3,2,-3,-0.281222538,3,-1.047645444,-1.280250459,0.131386234,97,50,47,0,-1.256536731,-1.170500555,-1.28755061,0.45263511,1.004809843,1.004809843,-1.28755061,-1.170500555,0,1,1
7454,32,15,46,110,124,0,2910.647,64,2740.089,LESS,-340,1292,952,2,1,14,1.312371845,14,0.87303787,-0.592559971,-0.420116018,234,110,124,1,1.475932034,1.170500555,1.716734147,-0.460242423,-0.025320961,0.025320961,1.716734147,1.170500555,0,0,1
7455,32,16,27,91,80,1,4485.889,64,4283.776,LESS,-982,2344,1362,3,2,-11,-1.031149307,11,0.349215148,-0.592559971,0.796246905,171,91,80,0,0.219395302,0.429183537,0,0.45263511,-0.81829935,0.81829935,0,0.429183537,0,1,0
7456,32,17,40,64,80,0,3688.215,44,2646.054,LESS,-990,2146,1156,4,1,16,1.499853537,16,1.222253018,-1.967940947,0.180302766,144,64,80,1,-0.31912044,-0.624266962,0,1.365512643,-0.8281807,0.8281807,0,-0.624266962,0,1,0
7457,32,18,22,83,80,0,4392.83,74,1921.136,LESS,-66,1998,1932,1,2,-3,-0.281222538,3,-1.047645444,0.095130518,0.724389046,163,83,80,0,0.059835082,0.117050055,0,-1.373119956,0.313115298,0.313115298,0,0.117050055,0,0,1
7458,32,19,54,101,110,0,3815.968,74,2548.105,LESS,-450,1908,1458,2,2,9,0.843667615,9,0,0.095130518,0.278950473,211,101,110,1,1.017196402,0.819350388,1.170500555,-0.460242423,-0.161189532,0.161189532,1.170500555,0.819350388,0,0,1
7459,32,20,6,56,50,1,4269.464,84,2030.166,LESS,296,2084,2380,3,2,-6,-0.562445076,6,-0.523822722,0.782821006,0.629128871,106,56,50,0,-1.077031484,-0.936400444,-1.170500555,0.45263511,0.760246415,0.760246415,-1.170500555,-0.936400444,1,1,1
7460,32,21,18,50,42,1,7251.212,74,2396.932,LESS,-1850,3956,2106,3,2,-8,-0.749926769,8,-0.174607574,0.095130518,2.931560951,92,50,42,0,-1.356261869,-1.170500555,-1.482634036,0.45263511,-1.890425894,1.890425894,-1.482634036,-1.170500555,1,1,0
7461,32,22,43,110,117,0,6089.505,64,1733.096,LESS,-242,2786,2544,3,2,7,0.656185922,7,-0.349215148,-0.592559971,2.034519529,227,110,117,1,1.336316841,1.170500555,1.443617351,0.45263511,0.095725584,0.095725584,1.443617351,1.170500555,0,1,1
7462,32,23,32,77,80,1,6634.553,64,2408.467,LESS,-560,3228,2668,3,1,3,0.281222538,3,-1.047645444,-0.592559971,2.455392118,157,77,80,1,-0.059835082,-0.117050055,0,0.45263511,-0.297058104,0.297058104,0,-0.117050055,0,1,0
7463,32,24,27,80,91,0,5592.339,24,1500.603,LESS,-1682,3374,1692,4,1,11,1.031149307,11,0.349215148,-3.343321923,1.650620237,171,80,91,1,0.219395302,0,0.429183537,1.365512643,-1.68291753,1.68291753,0.429183537,0,0,1,0
7464,32,25,16,44,50,0,7972.491,64,1955.274,LESS,-1564,4028,2464,2,2,6,0.562445076,6,-0.523822722,-0.592559971,3.48851476,94,44,50,1,-1.316371814,-1.404600665,-1.170500555,-0.460242423,-1.537167609,1.537167609,-1.170500555,-1.404600665,0,0,0
7465,32,26,7,50,57,0,4657.252,54,1726.473,LESS,-762,2250,1488,2,1,7,0.656185922,7,-0.349215148,-1.280250459,0.928569177,107,50,57,1,-1.057086457,-1.170500555,-0.897383758,-0.460242423,-0.546562207,0.546562207,-0.897383758,-1.170500555,0,0,0
7466,32,27,14,50,46,0,4748.323,64,1592.345,LESS,-298,2044,1746,2,2,-4,-0.374963384,4,-0.87303787,-0.592559971,0.998891951,96,50,46,0,-1.276481759,-1.170500555,-1.326567295,-0.460242423,0.02655613,0.02655613,-1.326567295,-1.170500555,0,0,1
7467,32,28,51,110,108,1,4865.221,44,3382.449,LESS,-480,2698,2218,3,2,-2,-0.187481692,2,-1.222253018,-1.967940947,1.089157696,218,110,108,0,1.156811594,1.170500555,1.092467184,0.45263511,-0.198244597,0.198244597,1.092467184,1.170500555,0,1,1
7468,32,29,50,133,110,1,2766.319,84,1404.503,LESS,340,1316,1656,1,2,-23,-2.15603946,23,2.444506035,0.782821006,-0.531562531,243,133,110,0,1.655437281,2.067884313,1.170500555,-1.373119956,0.814593843,0.814593843,1.170500555,2.067884313,1,0,1
7469,32,30,49,131,110,1,6360.724,64,1975.509,LESS,-16,2724,2708,3,2,-21,-1.968557767,21,2.095290887,-0.592559971,2.243948135,241,131,110,0,1.615547226,1.989850943,1.170500555,0.45263511,0.37487374,0.37487374,1.170500555,1.989850943,0,1,1
7470,32,31,47,126,110,1,2372.35,74,3909.816,LESS,-328,1350,1022,1,2,-16,-1.499853537,16,1.222253018,0.095130518,-0.835775651,236,126,110,0,1.515822089,1.794767517,1.170500555,-1.373119956,-0.010498935,0.010498935,1.170500555,1.794767517,1,0,1
7471,32,32,50,110,133,0,3719.128,94,1115.824,LESS,-694,2132,1438,1,2,23,2.15603946,23,2.444506035,1.470511494,0.20417302,243,110,133,1,1.655437281,1.170500555,2.067884313,-1.373119956,-0.462570727,0.462570727,2.067884313,1.170500555,1,0,0
7472,32,33,47,110,126,0,2716.71,84,2620.619,LESS,-1146,1852,706,2,2,16,1.499853537,16,1.222253018,0.782821006,-0.569869374,236,110,126,1,1.515822089,1.170500555,1.794767517,-0.460242423,-1.020867038,1.020867038,1.794767517,1.170500555,1,0,0
7473,32,34,12,48,50,0,2358.278,90,3610.059,LESS,1702,1744,3446,3,2,2,0.187481692,2,-1.222253018,1.195435299,-0.846641702,98,48,50,1,-1.236591704,-1.248533925,-1.170500555,0.45263511,2.496893789,2.496893789,-1.170500555,-1.248533925,1,1,1
7474,32,35,32,80,77,1,4822.752,64,1797.668,LESS,-74,2016,1942,3,2,-3,-0.281222538,3,-1.047645444,-0.592559971,1.056364185,157,80,77,0,-0.059835082,0,-0.117050055,0.45263511,0.303233948,0.303233948,-0.117050055,0,0,1,1
7475,32,36,43,117,110,1,3126.044,74,1377.253,LESS,-336,1092,756,1,2,-7,-0.656185922,7,-0.349215148,0.095130518,-0.25379178,227,117,110,0,1.336316841,1.443617351,1.170500555,-1.373119956,-0.020380286,0.020380286,1.170500555,1.443617351,1,0,1
7476,32,37,40,80,64,1,3600.869,84,2163.836,LESS,124,1348,1472,3,2,-16,-1.499853537,16,1.222253018,0.782821006,0.112856344,144,80,64,0,-0.31912044,0,-0.624266962,0.45263511,0.547797376,0.547797376,-0.624266962,0,1,1,1
7477,32,38,31,80,78,0,3107.19,74,3710.233,LESS,-1164,2410,1246,2,2,-2,-0.187481692,2,-1.222253018,0.095130518,-0.268350373,158,80,78,0,-0.039890055,0,-0.07803337,-0.460242423,-1.043100077,1.043100077,-0.07803337,0,1,0,0
7478,32,39,46,124,110,0,4655.17,74,3188.095,LESS,-2562,4044,1482,4,2,-14,-1.312371845,14,0.87303787,0.095130518,0.926961508,234,124,110,0,1.475932034,1.716734147,1.170500555,1.365512643,-2.769866101,2.769866101,1.170500555,1.716734147,0,1,0
7479,32,40,58,92,110,0,5102.729,64,2194.097,LESS,-816,2720,1904,6,2,18,1.687335229,18,1.571468165,-0.592559971,1.272555501,202,92,110,1,0.837691154,0.468200222,1.170500555,3.191267708,-0.613261324,0.613261324,1.170500555,0.468200222,0,1,0
7480,32,41,49,110,131,1,2169.981,84,833.951,MORE,30,818,848,1,2,21,1.968557767,21,2.095290887,0.782821006,-0.992039989,241,110,131,0,1.615547226,1.170500555,1.989850943,-1.373119956,0.431691506,0.431691506,1.989850943,1.170500555,1,0,1
7481,32,42,13,47,50,1,1525.653,94,2346.117,MORE,1654,614,2268,2,2,3,0.281222538,3,-1.047645444,1.470511494,-1.489574139,97,47,50,0,-1.256536731,-1.28755061,-1.170500555,-0.460242423,2.437605685,2.437605685,-1.170500555,-1.28755061,1,0,1
7482,32,43,16,50,44,0,3527.272,84,1122.704,MORE,-200,1870,1670,4,2,-6,-0.562445076,6,-0.523822722,0.782821006,0.05602656,94,50,44,1,-1.316371814,-1.170500555,-1.404600665,1.365512643,0.147602675,0.147602675,-1.404600665,-1.170500555,1,1,0
7483,32,44,7,57,50,0,2587.509,94,2106.536,MORE,214,1764,1978,2,2,-7,-0.656185922,7,-0.349215148,1.470511494,-0.669635192,107,57,50,1,-1.057086457,-0.897383758,-1.170500555,-0.460242423,0.658962571,0.658962571,-1.170500555,-0.897383758,1,0,1
7484,32,45,18,42,50,1,2460.559,94,2201.973,MORE,1426,1078,2504,3,2,8,0.749926769,8,-0.174607574,1.470511494,-0.767662843,92,42,50,0,-1.356261869,-1.482634036,-1.170500555,0.45263511,2.155987192,2.155987192,-1.170500555,-1.482634036,1,1,1
7485,32,46,51,108,110,0,3924.869,74,1524.486,MORE,716,1716,2432,2,2,2,0.187481692,2,-1.222253018,0.095130518,0.363041133,218,108,110,0,1.156811594,1.092467184,1.170500555,-0.460242423,1.279017323,1.279017323,1.170500555,1.092467184,0,0,1
7486,32,47,31,78,80,0,4416.136,84,1440.56,MORE,-262,2560,2298,4,2,2,0.187481692,2,-1.222253018,0.782821006,0.742385363,158,78,80,0,-0.039890055,-0.07803337,0,1.365512643,0.071022208,0.071022208,0,-0.07803337,1,1,0
7487,32,48,58,110,92,0,3099.247,84,1309.475,MORE,16,1576,1592,2,2,-18,-1.687335229,18,1.571468165,0.782821006,-0.274483761,202,110,92,1,0.837691154,1.170500555,0.468200222,-0.460242423,0.414399142,0.414399142,0.468200222,1.170500555,1,0,1
7488,32,49,12,50,48,1,1738.83,94,1059.186,MORE,634,602,1236,1,2,-2,-0.187481692,2,-1.222253018,1.470511494,-1.324964131,98,50,48,1,-1.236591704,-1.170500555,-1.248533925,-1.373119956,1.177733479,1.177733479,-1.248533925,-1.170500555,1,0,1
7489,32,50,54,110,101,1,3090.735,74,2805.064,MORE,-394,1648,1254,3,2,-9,-0.843667615,9,0,0.095130518,-0.281056517,211,110,101,1,1.017196402,1.170500555,0.819350388,0.45263511,-0.092020078,0.092020078,0.819350388,1.170500555,0,1,0
7490,32,51,14,46,50,1,1568.167,100,2473.385,MORE,1606,628,2234,1,2,4,0.374963384,4,-0.87303787,1.883125787,-1.45674588,96,46,50,0,-1.276481759,-1.326567295,-1.170500555,-1.373119956,2.378317582,2.378317582,-1.170500555,-1.326567295,1,0,1
7491,32,52,22,80,83,1,2744.58,94,1163.462,MORE,326,1222,1548,3,2,3,0.281222538,3,-1.047645444,1.470511494,-0.548348849,163,80,83,0,0.059835082,0,0.117050055,0.45263511,0.79730148,0.79730148,0.117050055,0,1,1,1
7492,32,53,6,50,56,1,1720.153,84,950.554,MORE,-92,736,644,1,2,6,0.562445076,6,-0.523822722,0.782821006,-1.339386049,106,50,56,0,-1.077031484,-1.170500555,-0.936400444,-1.373119956,0.281000909,0.281000909,-0.936400444,-1.170500555,1,0,0
7493,32,54,13,50,47,0,3698.014,74,2387.662,MORE,-684,2088,1404,4,2,-3,-0.281222538,3,-1.047645444,0.095130518,0.187869311,97,50,47,1,-1.256536731,-1.170500555,-1.28755061,1.365512643,-0.450219038,0.450219038,-1.28755061,-1.170500555,0,1,0
7494,32,55,46,110,124,1,3143.852,94,958.289,MORE,752,1340,2092,3,2,14,1.312371845,14,0.87303787,1.470511494,-0.240040883,234,110,124,0,1.475932034,1.170500555,1.716734147,0.45263511,1.323483401,1.323483401,1.716734147,1.170500555,1,1,1
7495,32,56,27,91,80,0,2448.685,84,1489.995,MORE,254,1296,1550,2,2,-11,-1.031149307,11,0.349215148,0.782821006,-0.776831652,171,91,80,1,0.219395302,0.429183537,0,-0.460242423,0.708369324,0.708369324,0,0.429183537,1,0,1
7496,32,57,40,64,80,1,1909.725,84,1263.838,MORE,980,648,1628,1,2,16,1.499853537,16,1.222253018,0.782821006,-1.193003238,144,64,80,0,-0.31912044,-0.624266962,0,-1.373119956,1.605101894,1.605101894,0,-0.624266962,1,0,1
7497,32,58,22,83,80,1,2104.962,94,822.077,MORE,364,746,1110,1,2,-3,-0.281222538,3,-1.047645444,1.470511494,-1.042246054,163,83,80,1,0.059835082,0.117050055,0,-1.373119956,0.844237895,0.844237895,0,0.117050055,1,0,1
7498,32,59,54,101,110,1,2030.587,94,2565.478,MORE,252,1194,1446,1,2,9,0.843667615,9,0,1.470511494,-1.09967659,211,101,110,0,1.017196402,0.819350388,1.170500555,-1.373119956,0.705898986,0.705898986,1.170500555,0.819350388,1,0,1
7499,32,60,6,56,50,0,3106.985,64,1894.216,MORE,-368,1510,1142,4,1,-6,-0.562445076,6,-0.523822722,-0.592559971,-0.268508669,106,56,50,1,-1.077031484,-0.936400444,-1.170500555,1.365512643,-0.059905688,0.059905688,-1.170500555,-0.936400444,0,1,0
7500,32,61,18,50,42,0,5378.982,54,1620.288,MORE,-3274,4062,788,2,1,-8,-0.749926769,8,-0.174607574,-1.280250459,1.485871237,92,50,42,1,-1.356261869,-1.170500555,-1.482634036,-0.460242423,-3.649306307,3.649306307,-1.482634036,-1.170500555,0,0,0
7501,32,62,43,110,117,1,5366.847,44,1245.106,MORE,502,1948,2450,2,2,7,0.656185922,7,-0.349215148,-1.967940947,1.47650089,227,110,117,0,1.336316841,1.170500555,1.443617351,-0.460242423,1.014691194,1.014691194,1.443617351,1.170500555,0,0,1
7502,32,63,32,77,80,1,4671.012,64,2382.869,MORE,-480,2172,1692,3,2,3,0.281222538,3,-1.047645444,-0.592559971,0.939194308,157,77,80,0,-0.059835082,-0.117050055,0,0.45263511,-0.198244597,0.198244597,0,-0.117050055,0,1,0
7503,32,64,27,80,91,1,3127.647,74,1088.833,MORE,230,1386,1616,3,2,11,1.031149307,11,0.349215148,0.095130518,-0.252553983,171,80,91,0,0.219395302,0,0.429183537,0.45263511,0.678725272,0.678725272,0.429183537,0,0,1,1
7504,32,65,16,44,50,1,3024.109,84,1632.273,MORE,1098,1070,2168,3,2,6,0.562445076,6,-0.523822722,0.782821006,-0.332503467,94,44,50,0,-1.316371814,-1.404600665,-1.170500555,0.45263511,1.750851816,1.750851816,-1.170500555,-1.404600665,1,1,1
7505,32,66,7,50,57,1,1621.382,74,2063.463,MORE,308,542,850,1,2,7,0.656185922,7,-0.349215148,0.095130518,-1.415654573,107,50,57,0,-1.057086457,-1.170500555,-0.897383758,-1.373119956,0.775068441,0.775068441,-0.897383758,-1.170500555,1,0,1
7506,32,67,14,50,46,0,3252.851,64,2367.995,MORE,-976,2072,1096,4,1,-4,-0.374963384,4,-0.87303787,-0.592559971,-0.15587455,96,50,46,1,-1.276481759,-1.170500555,-1.326567295,1.365512643,-0.810888337,0.810888337,-1.326567295,-1.170500555,0,1,0
7507,32,68,51,110,108,1,5723.203,64,1283.53,MORE,-188,2856,2668,6,2,-2,-0.187481692,2,-1.222253018,-0.592559971,1.751670182,218,110,108,1,1.156811594,1.170500555,1.092467184,3.191267708,0.162424701,0.162424701,1.092467184,1.170500555,0,1,0
7508,32,69,50,133,110,0,2111.826,94,1160.924,MORE,-206,1722,1516,3,2,-23,-2.15603946,23,2.444506035,1.470511494,-1.036945842,243,133,110,1,1.655437281,2.067884313,1.170500555,0.45263511,0.140191662,0.140191662,1.170500555,2.067884313,1,1,0
7509,32,70,49,131,110,0,3406.429,74,1205.411,MORE,-1130,2220,1090,2,2,-21,-1.968557767,21,2.095290887,0.095130518,-0.037285416,241,131,110,1,1.615547226,1.989850943,1.170500555,-0.460242423,-1.001104336,1.001104336,1.170500555,1.989850943,1,0,0
7510,32,71,47,126,110,0,4654.883,74,1304.188,MORE,-980,2654,1674,4,1,-16,-1.499853537,16,1.222253018,0.095130518,0.926739893,236,126,110,1,1.515822089,1.794767517,1.170500555,1.365512643,-0.815829012,0.815829012,1.170500555,1.794767517,1,1,0
7511,32,72,50,110,133,1,3102.309,74,1741.853,MORE,-172,1344,1172,3,2,23,2.15603946,23,2.444506035,0.095130518,-0.27211936,243,110,133,0,1.655437281,1.170500555,2.067884313,0.45263511,0.182187402,0.182187402,2.067884313,1.170500555,1,1,0
7512,32,73,47,110,126,1,4252.069,84,1057.244,MORE,332,1984,2316,3,2,16,1.499853537,16,1.222253018,0.782821006,0.615696883,236,110,126,0,1.515822089,1.170500555,1.794767517,0.45263511,0.804712493,0.804712493,1.794767517,1.170500555,1,1,1
7513,32,74,12,48,50,1,1644.53,84,1457.629,MORE,402,494,896,1,2,2,0.187481692,2,-1.222253018,0.782821006,-1.397780259,98,48,50,0,-1.236591704,-1.248533925,-1.170500555,-1.373119956,0.891174311,0.891174311,-1.170500555,-1.248533925,1,0,1
7514,32,75,32,80,77,1,3659.592,64,1567.228,MORE,270,1358,1628,3,2,-3,-0.281222538,3,-1.047645444,-0.592559971,0.158200793,157,80,77,1,-0.059835082,0,-0.117050055,0.45263511,0.728132025,0.728132025,-0.117050055,0,0,1,1
7515,32,76,43,117,110,1,5479.013,74,1045.352,MORE,-180,2704,2524,5,2,-7,-0.656185922,7,-0.349215148,0.095130518,1.563112702,227,117,110,1,1.336316841,1.443617351,1.170500555,2.278390176,0.172306052,0.172306052,1.170500555,1.443617351,1,1,0
7516,32,77,40,80,64,1,4699.088,64,2109.769,MORE,-782,2342,1560,3,2,-16,-1.499853537,16,1.222253018,-0.592559971,0.960873901,144,80,64,1,-0.31912044,0,-0.624266962,0.45263511,-0.571265584,0.571265584,-0.624266962,0,0,1,0
7517,32,78,31,80,78,1,5455.37,44,900.21,MORE,102,2538,2640,2,2,-2,-0.187481692,2,-1.222253018,-1.967940947,1.544856162,158,80,78,1,-0.039890055,0,-0.07803337,-0.460242423,0.520623662,0.520623662,-0.07803337,0,0,0,1
7518,32,79,46,124,110,0,4432.944,64,1628.764,MORE,-70,2156,2086,4,2,-14,-1.312371845,14,0.87303787,-0.592559971,0.755364085,234,124,110,1,1.475932034,1.716734147,1.170500555,1.365512643,0.308174623,0.308174623,1.170500555,1.716734147,0,1,1
7519,32,80,58,92,110,1,4477.63,74,1978.029,MORE,346,2106,2452,3,2,18,1.687335229,18,1.571468165,0.095130518,0.78986951,202,92,110,0,0.837691154,0.468200222,1.170500555,0.45263511,0.822004856,0.822004856,1.170500555,0.468200222,1,1,1
7520,32,81,48,128,110,1,2847.501,64,1541.226,LESS,-74,1014,940,1,2,-18,-1.687335229,18,1.571468165,-0.592559971,-0.468875798,238,128,110,0,1.555712144,1.872800887,1.170500555,-1.373119956,0.303233948,0.303233948,1.170500555,1.872800887,0,0,1
7521,32,82,8,50,58,0,3332.761,74,824.206,LESS,-222,1302,1080,4,2,8,0.749926769,8,-0.174607574,0.095130518,-0.094170024,108,50,58,1,-1.037141429,-1.170500555,-0.858367073,1.365512643,0.120428961,0.120428961,-0.858367073,-1.170500555,1,1,1
7522,32,83,4,54,50,1,2604.903,84,1404.54,LESS,-110,1270,1160,3,2,-4,-0.374963384,4,-0.87303787,0.782821006,-0.656203975,104,54,50,0,-1.116921539,-1.014433814,-1.170500555,0.45263511,0.25876787,0.25876787,-1.170500555,-1.014433814,1,1,1
7523,32,84,37,80,69,1,3215.97,44,1631.292,LESS,234,1018,1252,3,1,-11,-1.031149307,11,0.349215148,-1.967940947,-0.184353147,149,80,69,0,-0.219395302,0,-0.429183537,0.45263511,0.683665947,0.683665947,-0.429183537,0,0,1,1
7524,32,85,52,105,110,0,2411.776,44,1311.113,LESS,-524,1244,720,2,1,5,0.46870423,5,-0.698430296,-1.967940947,-0.805331869,215,105,110,1,1.096976512,0.975417129,1.170500555,-0.460242423,-0.252592026,0.252592026,1.170500555,0.975417129,0,0,0
7525,32,86,5,55,50,1,2901.321,54,1354.464,LESS,-218,1292,1074,3,2,-5,-0.46870423,5,-0.698430296,-1.280250459,-0.427317324,105,55,50,0,-1.096976512,-0.975417129,-1.170500555,0.45263511,0.125369636,0.125369636,-1.170500555,-0.975417129,0,1,1
7526,32,87,30,96,80,1,4724.711,64,1746.155,LESS,-248,2168,1920,5,1,-16,-1.499853537,16,1.222253018,-0.592559971,0.980659348,176,96,80,0,0.31912044,0.624266962,0,2.278390176,0.088314571,0.088314571,0,0.624266962,0,1,1
7527,32,88,33,80,75,1,4137.106,64,2985.604,LESS,-484,1998,1514,3,2,-5,-0.46870423,5,-0.698430296,-0.592559971,0.526925297,155,80,75,0,-0.099725137,0,-0.195083426,0.45263511,-0.203185272,0.203185272,-0.195083426,0,0,1,1
7528,32,89,48,110,128,0,3240.717,74,1897.16,LESS,-1696,2414,718,2,2,18,1.687335229,18,1.571468165,0.095130518,-0.165244125,238,110,128,1,1.555712144,1.170500555,1.872800887,-0.460242423,-1.700209894,1.700209894,1.872800887,1.170500555,1,0,0
7529,32,90,9,59,50,1,2971.405,74,1092.204,LESS,-28,1298,1270,3,2,-9,-0.843667615,9,0,0.095130518,-0.373200193,109,59,50,0,-1.017196402,-0.819350388,-1.170500555,0.45263511,0.360051714,0.360051714,-1.170500555,-0.819350388,1,1,1
7530,32,91,44,110,119,0,2404.123,94,1785.312,LESS,-590,1910,1320,2,2,9,0.843667615,9,0,1.470511494,-0.811241326,229,110,119,1,1.376206896,1.170500555,1.521650721,-0.460242423,-0.334113168,0.334113168,1.521650721,1.170500555,1,0,0
7531,32,92,2,52,50,0,2843.715,84,1444.194,LESS,30,1498,1528,2,1,-2,-0.187481692,2,-1.222253018,0.782821006,-0.471799253,102,52,50,0,-1.156811594,-1.092467184,-1.170500555,-0.460242423,0.431691506,0.431691506,-1.170500555,-1.092467184,1,0,1
7532,32,93,8,58,50,0,3737.71,74,1441.265,LESS,-980,2340,1360,4,1,-8,-0.749926769,8,-0.174607574,0.095130518,0.218521581,108,58,50,0,-1.037141429,-0.858367073,-1.170500555,1.365512643,-0.815829012,0.815829012,-1.170500555,-0.858367073,1,1,0
7533,32,94,44,119,110,0,2425.805,84,1122.151,LESS,-536,1674,1138,2,2,-9,-0.843667615,9,0,0.782821006,-0.794499022,229,119,110,0,1.376206896,1.521650721,1.170500555,-0.460242423,-0.267414052,0.267414052,1.170500555,1.521650721,1,0,0
7534,32,95,34,74,80,0,2122.435,84,1845.587,LESS,-174,854,680,2,2,6,0.562445076,6,-0.523822722,0.782821006,-1.028753835,154,74,80,1,-0.119670165,-0.234100111,0,-0.460242423,0.179717065,0.179717065,0,-0.234100111,1,0,1
7535,32,96,24,86,80,1,3350.104,84,1517.777,LESS,426,1626,2052,3,2,-6,-0.562445076,6,-0.523822722,0.782821006,-0.080778188,166,86,80,0,0.119670165,0.234100111,0,0.45263511,0.920818363,0.920818363,0,0.234100111,1,1,1
7536,32,97,39,66,80,0,2141.798,74,1749.244,LESS,-590,1160,570,2,2,14,1.312371845,14,0.87303787,0.095130518,-1.013802205,146,66,80,1,-0.279230385,-0.546233592,0,-0.460242423,-0.334113168,0.334113168,0,-0.546233592,1,0,0
7537,32,98,9,50,59,0,2095.662,74,1557.601,LESS,-614,1334,720,2,2,9,0.843667615,9,0,0.095130518,-1.049427284,109,50,59,1,-1.017196402,-1.170500555,-0.819350388,-0.460242423,-0.36375722,0.36375722,-0.819350388,-1.170500555,1,0,0
7538,32,99,57,94,110,0,2333.478,74,840.996,LESS,-944,1530,586,2,1,16,1.499853537,16,1.222253018,0.095130518,-0.865791649,204,94,110,1,0.877581209,0.546233592,1.170500555,-0.460242423,-0.771362934,0.771362934,1.170500555,0.546233592,1,0,0
7539,32,100,60,110,87,1,3182.332,64,1770.378,LESS,256,1264,1520,3,2,-23,-2.15603946,23,2.444506035,-0.592559971,-0.210327579,197,110,87,0,0.737966017,1.170500555,0.273116796,0.45263511,0.710839661,0.710839661,0.273116796,1.170500555,0,1,1
7540,32,101,33,75,80,0,3580.692,44,1966.37,LESS,-926,2032,1106,4,1,5,0.46870423,5,-0.698430296,-1.967940947,0.097276164,155,75,80,1,-0.099725137,-0.195083426,0,1.365512643,-0.749129895,0.749129895,0,-0.195083426,0,1,0
7541,32,102,15,50,45,1,2275.55,64,1964.59,LESS,-72,956,884,3,2,-5,-0.46870423,5,-0.698430296,-0.592559971,-0.910522218,95,50,45,0,-1.296426786,-1.170500555,-1.36558398,0.45263511,0.305704285,0.305704285,-1.36558398,-1.170500555,0,1,1
7542,32,103,59,89,110,0,2015.739,74,1374.337,LESS,-538,1268,730,2,2,21,1.968557767,21,2.095290887,0.095130518,-1.111141848,199,89,110,1,0.777856072,0.351150166,1.170500555,-0.460242423,-0.269884389,0.269884389,1.170500555,0.351150166,1,0,0
7543,32,104,29,80,94,0,2166.149,84,1671.016,LESS,-124,1616,1492,2,2,14,1.312371845,14,0.87303787,0.782821006,-0.994998965,174,80,94,1,0.279230385,0,0.546233592,-0.460242423,0.241475506,0.241475506,0.546233592,0,1,0,1
7544,32,105,55,110,98,1,3133.713,84,1070.496,LESS,526,1316,1842,3,2,-12,-1.124890153,12,0.523822722,0.782821006,-0.247869968,208,110,98,0,0.957361319,1.170500555,0.702300333,0.45263511,1.044335246,1.044335246,0.702300333,1.170500555,1,1,1
7545,32,106,29,94,80,1,3932.812,64,1303.1,LESS,-790,1708,918,2,1,-14,-1.312371845,14,0.87303787,-0.592559971,0.369174521,174,94,80,0,0.279230385,0.546233592,0,-0.460242423,-0.581146934,0.581146934,0,0.546233592,0,0,0
7546,32,107,57,110,94,0,2562.549,44,1799.88,LESS,-1268,1846,578,2,1,-16,-1.499853537,16,1.222253018,-1.967940947,-0.688908686,204,110,94,0,0.877581209,1.170500555,0.546233592,-0.460242423,-1.171557635,1.171557635,0.546233592,1.170500555,0,0,0
7547,32,108,39,80,66,1,2873.384,74,2150.216,LESS,-6,1286,1280,3,2,-14,-1.312371845,14,0.87303787,0.095130518,-0.448889585,146,80,66,0,-0.279230385,0,-0.546233592,0.45263511,0.387225428,0.387225428,-0.546233592,0,1,1,1
7548,32,109,4,50,54,0,2038.064,74,1144.884,LESS,-1072,1294,222,2,1,4,0.374963384,4,-0.87303787,0.095130518,-1.093903035,104,50,54,1,-1.116921539,-1.170500555,-1.014433814,-0.460242423,-0.929464544,0.929464544,-1.014433814,-1.170500555,1,0,0
7549,32,110,55,98,110,0,1876.256,54,3099.144,LESS,-898,1346,448,2,2,12,1.124890153,12,0.523822722,-1.280250459,-1.218847172,208,98,110,1,0.957361319,0.702300333,1.170500555,-0.460242423,-0.714545168,0.714545168,1.170500555,0.702300333,0,0,0
7550,32,111,2,50,52,0,2247.133,84,1023.333,LESS,-420,1456,1036,2,1,2,0.187481692,2,-1.222253018,0.782821006,-0.932465123,102,50,52,1,-1.156811594,-1.170500555,-1.092467184,-0.460242423,-0.124134467,0.124134467,-1.092467184,-1.170500555,1,0,1
7551,32,112,59,110,89,1,2840.683,94,2382.184,LESS,1908,940,2848,1,2,-21,-1.968557767,21,2.095290887,1.470511494,-0.474140489,199,110,89,0,0.777856072,1.170500555,0.351150166,-1.373119956,2.751338568,2.751338568,0.351150166,1.170500555,1,0,1
7552,32,113,60,87,110,0,2125.671,84,927.948,LESS,-720,1256,536,2,2,23,2.15603946,23,2.444506035,0.782821006,-1.026255076,197,87,110,1,0.737966017,0.273116796,1.170500555,-0.460242423,-0.494685116,0.494685116,1.170500555,0.273116796,1,0,0
7553,32,114,52,110,105,0,2495.896,74,2398.888,LESS,-1042,1648,606,2,1,-5,-0.46870423,5,-0.698430296,0.095130518,-0.740376485,215,110,105,0,1.096976512,1.170500555,0.975417129,-0.460242423,-0.892409479,0.892409479,0.975417129,1.170500555,0,0,0
7554,32,115,30,80,96,0,2116.409,84,1358.142,LESS,-1106,1508,402,2,1,16,1.499853537,16,1.222253018,0.782821006,-1.033406963,176,80,96,1,0.31912044,0,0.624266962,-0.460242423,-0.971460285,0.971460285,0.624266962,0,1,1,0
7555,32,116,24,80,86,0,2303.77,84,1498.206,LESS,-948,1404,456,2,1,6,0.562445076,6,-0.523822722,0.782821006,-0.888731432,166,80,86,1,0.119670165,0,0.234100111,-0.460242423,-0.776303609,0.776303609,0.234100111,0,1,0,0
7556,32,117,5,50,55,0,1693.304,100,1914.62,LESS,1448,706,2154,3,2,5,0.46870423,5,-0.698430296,1.883125787,-1.360118183,105,50,55,1,-1.096976512,-1.170500555,-0.975417129,0.45263511,2.183160906,2.183160906,-0.975417129,-1.170500555,1,1,1
7557,32,118,34,80,74,0,2734.911,64,1356.177,LESS,-782,1310,528,2,1,-6,-0.562445076,6,-0.523822722,-0.592559971,-0.555815012,154,80,74,0,-0.119670165,0,-0.234100111,-0.460242423,-0.571265584,0.571265584,-0.234100111,0,0,0,0
7558,32,119,15,45,50,0,1791.831,94,1005.524,LESS,-174,1032,858,2,2,5,0.46870423,5,-0.698430296,1.470511494,-1.284038069,95,45,50,1,-1.296426786,-1.36558398,-1.170500555,-0.460242423,0.179717065,0.179717065,-1.170500555,-1.36558398,1,0,1
7559,32,120,37,69,80,0,2076.221,44,1909.938,LESS,-854,1314,460,2,1,11,1.031149307,11,0.349215148,-1.967940947,-1.064439143,149,69,80,1,-0.219395302,-0.429183537,0,-0.460242423,-0.660197739,0.660197739,0,-0.429183537,0,0,0
7560,32,121,48,128,110,0,2352.167,74,1654.561,MORE,-1002,1878,876,2,2,-18,-1.687335229,18,1.571468165,0.095130518,-0.851360465,238,128,110,1,1.555712144,1.872800887,1.170500555,-0.460242423,-0.843002726,0.843002726,1.170500555,1.872800887,1,0,0
7561,32,122,8,50,58,1,1890.006,84,2020.737,MORE,880,548,1428,1,2,8,0.749926769,8,-0.174607574,0.782821006,-1.208229762,108,50,58,0,-1.037141429,-1.170500555,-0.858367073,-1.373119956,1.481585011,1.481585011,-0.858367073,-1.170500555,1,0,1
7562,32,123,4,54,50,1,3024.194,84,1443.667,MORE,-300,1482,1182,3,2,-4,-0.374963384,4,-0.87303787,0.782821006,-0.332437832,104,54,50,1,-1.116921539,-1.014433814,-1.170500555,0.45263511,0.024085792,0.024085792,-1.170500555,-1.014433814,1,1,0
7563,32,124,37,80,69,1,2162.894,74,2335.754,MORE,296,892,1188,1,1,-11,-1.031149307,11,0.349215148,0.095130518,-0.997512396,149,80,69,1,-0.219395302,0,-0.429183537,-1.373119956,0.760246415,0.760246415,-0.429183537,0,1,0,1
7564,32,125,52,105,110,0,2391.499,84,2164.002,MORE,-656,1366,710,1,2,5,0.46870423,5,-0.698430296,0.782821006,-0.820989267,215,105,110,0,1.096976512,0.975417129,1.170500555,-1.373119956,-0.415634311,0.415634311,1.170500555,0.975417129,1,0,0
7565,32,126,5,55,50,0,4366.9,54,1803.777,MORE,-2286,3156,870,2,1,-5,-0.46870423,5,-0.698430296,-1.280250459,0.704366541,105,55,50,1,-1.096976512,-0.975417129,-1.170500555,-0.460242423,-2.428959504,2.428959504,-1.170500555,-0.975417129,0,1,0
7566,32,127,30,96,80,0,2564.39,64,1862.432,MORE,-1052,1626,574,2,1,-16,-1.499853537,16,1.222253018,-0.592559971,-0.687487112,176,96,80,1,0.31912044,0.624266962,0,-0.460242423,-0.904761168,0.904761168,0,0.624266962,0,1,0
7567,32,128,33,80,75,1,2622.347,74,1455.229,MORE,-402,1158,756,1,2,-5,-0.46870423,5,-0.698430296,0.095130518,-0.642734149,155,80,75,1,-0.099725137,0,-0.195083426,-1.373119956,-0.101901428,0.101901428,-0.195083426,0,1,0,0
7568,32,129,48,110,128,1,1943.471,74,2289.78,MORE,-396,996,600,1,1,18,1.687335229,18,1.571468165,0.095130518,-1.166945411,238,110,128,0,1.555712144,1.170500555,1.872800887,-1.373119956,-0.094490415,0.094490415,1.872800887,1.170500555,0,0,0
7569,32,130,9,59,50,1,2889.177,64,1071.06,MORE,116,1088,1204,3,2,-9,-0.843667615,9,0,-0.592559971,-0.436694621,109,59,50,1,-1.017196402,-0.819350388,-1.170500555,0.45263511,0.537916025,0.537916025,-1.170500555,-0.819350388,0,1,1
7570,32,131,44,110,119,1,3451.02,74,997.198,MORE,-506,1718,1212,3,2,9,0.843667615,9,0,0.095130518,-0.002853349,229,110,119,0,1.376206896,1.170500555,1.521650721,0.45263511,-0.230358987,0.230358987,1.521650721,1.170500555,1,1,0
7571,32,132,2,52,50,0,4240.37,64,1554.333,MORE,-714,2396,1682,4,1,-2,-0.187481692,2,-1.222253018,-0.592559971,0.606663204,102,52,50,1,-1.156811594,-1.092467184,-1.170500555,1.365512643,-0.487274103,0.487274103,-1.170500555,-1.092467184,0,1,0
7572,32,133,8,58,50,0,3075.051,74,851.563,MORE,-1844,2436,592,2,1,-8,-0.749926769,8,-0.174607574,0.095130518,-0.293167314,108,58,50,1,-1.037141429,-0.858367073,-1.170500555,-0.460242423,-1.883014881,1.883014881,-1.170500555,-0.858367073,0,0,0
7573,32,134,44,119,110,1,3467.656,64,1832.652,MORE,-140,1682,1542,3,1,-9,-0.843667615,9,0,-0.592559971,0.009992559,229,119,110,1,1.376206896,1.521650721,1.170500555,0.45263511,0.221712805,0.221712805,1.170500555,1.521650721,0,1,0
7574,32,135,34,74,80,1,3618.222,74,1665.196,MORE,-364,1736,1372,3,2,6,0.562445076,6,-0.523822722,0.095130518,0.126255902,154,74,80,0,-0.119670165,-0.234100111,0,0.45263511,-0.054965013,0.054965013,0,-0.234100111,0,1,0
7575,32,136,24,86,80,1,2880.448,74,1531.529,MORE,-294,1434,1140,3,2,-6,-0.562445076,6,-0.523822722,0.095130518,-0.443434939,166,86,80,1,0.119670165,0.234100111,0,0.45263511,0.031496805,0.031496805,0,0.234100111,0,1,0
7576,32,137,39,66,80,1,1817.517,84,1035.858,MORE,698,730,1428,1,2,14,1.312371845,14,0.87303787,0.782821006,-1.264203975,146,66,80,0,-0.279230385,-0.546233592,0,-1.373119956,1.256784284,1.256784284,0,-0.546233592,1,0,1
7577,32,138,9,50,59,1,2805.364,74,1677.427,MORE,580,1042,1622,3,2,9,0.843667615,9,0,0.095130518,-0.501412947,109,50,59,0,-1.017196402,-1.170500555,-0.819350388,0.45263511,1.111034362,1.111034362,-0.819350388,-1.170500555,0,1,1
7578,32,139,57,94,110,1,3332.649,84,1670.355,MORE,700,1456,2156,3,2,16,1.499853537,16,1.222253018,0.782821006,-0.094256508,204,94,110,0,0.877581209,0.546233592,1.170500555,0.45263511,1.259254622,1.259254622,1.170500555,0.546233592,1,1,1
7579,32,140,60,110,87,0,3075.65,94,939.408,MORE,-446,2010,1564,2,2,-23,-2.15603946,23,2.444506035,1.470511494,-0.292704781,197,110,87,1,0.737966017,1.170500555,0.273116796,-0.460242423,-0.156248857,0.156248857,0.273116796,1.170500555,1,0,0
7580,32,141,33,75,80,0,3745.706,84,1249.943,MORE,314,2016,2330,4,2,5,0.46870423,5,-0.698430296,0.782821006,0.224695894,155,75,80,0,-0.099725137,-0.195083426,0,1.365512643,0.782479454,0.782479454,0,-0.195083426,1,1,1
7581,32,142,15,50,45,1,3500.502,54,1014.076,MORE,72,1454,1526,3,2,-5,-0.46870423,5,-0.698430296,-1.280250459,0.035355428,95,50,45,1,-1.296426786,-1.170500555,-1.36558398,0.45263511,0.483568597,0.483568597,-1.36558398,-1.170500555,0,1,1
7582,32,143,59,89,110,1,1909.953,84,1681.403,MORE,12,894,906,1,2,21,1.968557767,21,2.095290887,0.782821006,-1.192827182,199,89,110,0,0.777856072,0.351150166,1.170500555,-1.373119956,0.409458467,0.409458467,1.170500555,0.351150166,1,0,1
7583,32,144,29,80,94,1,2221.725,94,1796.138,MORE,1244,904,2148,1,2,14,1.312371845,14,0.87303787,1.470511494,-0.952084552,174,80,94,0,0.279230385,0,0.546233592,-1.373119956,1.931186465,1.931186465,0.546233592,0,1,0,1
7584,32,145,55,110,98,1,3660.15,94,1064.165,MORE,596,1214,1810,3,2,-12,-1.124890153,12,0.523822722,1.470511494,0.158631667,208,110,98,1,0.957361319,1.170500555,0.702300333,0.45263511,1.130797064,1.130797064,0.702300333,1.170500555,1,1,1
7585,32,146,29,94,80,0,4733.189,64,1614.96,MORE,-202,1534,1332,3,1,-14,-1.312371845,14,0.87303787,-0.592559971,0.98720585,174,94,80,1,0.279230385,0.546233592,0,0.45263511,0.145132337,0.145132337,0,0.546233592,0,1,0
7586,32,147,57,110,94,0,4532.641,84,1592.308,MORE,46,2236,2282,4,2,-16,-1.499853537,16,1.222253018,0.782821006,0.832347644,204,110,94,1,0.877581209,1.170500555,0.546233592,1.365512643,0.451454207,0.451454207,0.546233592,1.170500555,1,1,1
7587,32,148,39,80,66,0,3310.778,64,1445.878,MORE,-370,1580,1210,4,1,-14,-1.312371845,14,0.87303787,-0.592559971,-0.111144753,146,80,66,1,-0.279230385,0,-0.546233592,1.365512643,-0.062376026,0.062376026,-0.546233592,0,0,1,0
7588,32,149,4,50,54,1,2658.876,84,1990.541,MORE,76,1062,1138,3,2,4,0.374963384,4,-0.87303787,0.782821006,-0.614527359,104,50,54,0,-1.116921539,-1.170500555,-1.014433814,0.45263511,0.488509272,0.488509272,-1.014433814,-1.170500555,1,1,1
7589,32,150,55,98,110,0,3831.082,54,2190.114,MORE,38,1422,1460,1,1,12,1.124890153,12,0.523822722,-1.280250459,0.29062113,208,98,110,0,0.957361319,0.702300333,1.170500555,-1.373119956,0.441572857,0.441572857,1.170500555,0.702300333,0,0,1
7590,32,151,2,50,52,1,3158.335,64,1197.865,MORE,-94,1498,1404,4,1,2,0.187481692,2,-1.222253018,-0.592559971,-0.228857469,102,50,52,0,-1.156811594,-1.170500555,-1.092467184,1.365512643,0.278530571,0.278530571,-1.092467184,-1.170500555,0,1,0
7591,32,152,59,110,89,0,2740.618,74,1009.105,MORE,-1098,1872,774,2,1,-21,-1.968557767,21,2.095290887,0.095130518,-0.551408208,199,110,89,1,0.777856072,1.170500555,0.351150166,-0.460242423,-0.961578934,0.961578934,0.351150166,1.170500555,0,0,0
7592,32,153,60,87,110,1,2287.171,94,1891.878,MORE,1168,734,1902,1,2,23,2.15603946,23,2.444506035,1.470511494,-0.901548769,197,87,110,0,0.737966017,0.273116796,1.170500555,-1.373119956,1.837313634,1.837313634,1.170500555,0.273116796,1,0,1
7593,32,154,52,110,105,1,3943.594,74,1586.269,MORE,316,1764,2080,3,2,-5,-0.46870423,5,-0.698430296,0.095130518,0.377500115,215,110,105,1,1.096976512,1.170500555,0.975417129,0.45263511,0.784949791,0.784949791,0.975417129,1.170500555,0,1,1
7594,32,155,30,80,96,1,2154.936,84,1690.766,MORE,130,856,986,1,2,16,1.499853537,16,1.222253018,0.782821006,-1.003657366,176,80,96,0,0.31912044,0,0.624266962,-1.373119956,0.555208389,0.555208389,0.624266962,0,1,0,1
7595,32,156,24,80,86,1,4163.911,74,1566.447,MORE,744,1806,2550,5,2,6,0.562445076,6,-0.523822722,0.095130518,0.547623455,166,80,86,0,0.119670165,0,0.234100111,2.278390176,1.31360205,1.31360205,0.234100111,0,0,1,1
7596,32,157,5,50,55,1,3020.912,54,1596.548,MORE,-88,1478,1390,4,1,5,0.46870423,5,-0.698430296,-1.280250459,-0.334972111,105,50,55,0,-1.096976512,-1.170500555,-0.975417129,1.365512643,0.285941584,0.285941584,-0.975417129,-1.170500555,0,1,1
7597,32,158,34,80,74,1,3992.604,54,2258.951,MORE,-878,2634,1756,3,1,-6,-0.562445076,6,-0.523822722,-1.280250459,0.415344425,154,80,74,1,-0.119670165,0,-0.234100111,0.45263511,-0.689841791,0.689841791,-0.234100111,0,0,1,0
7598,32,159,15,45,50,1,3372.336,64,1122.719,MORE,-194,1402,1208,3,2,5,0.46870423,5,-0.698430296,-0.592559971,-0.063611188,95,45,50,0,-1.296426786,-1.36558398,-1.170500555,0.45263511,0.155013688,0.155013688,-1.170500555,-1.36558398,0,1,0
7599,32,160,37,69,80,1,2535.258,94,1065.564,MORE,166,1142,1308,1,2,11,1.031149307,11,0.349215148,1.470511494,-0.709982122,149,69,80,0,-0.219395302,-0.429183537,0,-1.373119956,0.599674467,0.599674467,0,-0.429183537,1,0,1
7600,32,161,3,50,53,0,2613.993,54,1221.106,LESS,-324,1016,692,2,1,3,0.281222538,3,-1.047645444,-1.280250459,-0.649184902,103,50,53,1,-1.136866566,-1.170500555,-1.053450499,-0.460242423,-0.00555826,0.00555826,-1.053450499,-1.170500555,0,0,1
7601,32,162,20,50,40,0,3252.334,74,2824.906,LESS,-1474,2318,844,2,2,-10,-0.937408461,10,0.174607574,0.095130518,-0.156273765,90,50,40,0,-1.396151924,-1.170500555,-1.560667406,-0.460242423,-1.426002414,1.426002414,-1.560667406,-1.170500555,0,0,0
7602,32,163,25,80,88,0,2824.573,84,1397.241,LESS,-678,1826,1148,2,2,8,0.749926769,8,-0.174607574,0.782821006,-0.486580232,168,80,88,1,0.15956022,0,0.312133481,-0.460242423,-0.442808025,0.442808025,0.312133481,0,1,0,0
7603,32,164,42,115,110,0,4964.001,74,2264.32,LESS,-1080,3164,2084,4,2,-5,-0.46870423,5,-0.698430296,0.095130518,1.16543317,225,115,110,0,1.296426786,1.36558398,1.170500555,1.365512643,-0.939345895,0.939345895,1.170500555,1.36558398,0,1,0
7604,32,165,53,103,110,0,2466.865,74,1403.957,LESS,-1350,1942,592,2,1,7,0.656185922,7,-0.349215148,0.095130518,-0.762793505,213,103,110,1,1.057086457,0.897383758,1.170500555,-0.460242423,-1.272841479,1.272841479,1.170500555,0.897383758,0,0,0
7605,32,166,26,90,80,0,3069.295,74,1345.103,LESS,-1260,2166,906,2,1,-10,-0.937408461,10,0.174607574,0.095130518,-0.297611955,170,90,80,0,0.199450275,0.390166852,0,-0.460242423,-1.161676284,1.161676284,0,0.390166852,0,0,0
7606,32,167,35,80,72,1,2504.254,84,2651.558,LESS,258,1308,1566,2,2,-8,-0.749926769,8,-0.174607574,0.782821006,-0.733922644,152,80,72,0,-0.15956022,0,-0.312133481,-0.460242423,0.713309999,0.713309999,-0.312133481,0,1,0,1
7607,32,168,28,93,80,1,4963.509,94,1701.734,LESS,1348,1908,3256,3,2,-13,-1.218630999,13,0.698430296,1.470511494,1.16505326,173,93,80,0,0.259285357,0.507216907,0,0.45263511,2.059644024,2.059644024,0,0.507216907,1,1,1
7608,32,169,26,80,90,0,4152.402,74,1467.205,LESS,-1272,2510,1238,4,1,10,0.937408461,10,0.174607574,0.095130518,0.53873649,170,80,90,1,0.199450275,0,0.390166852,1.365512643,-1.17649831,1.17649831,0.390166852,0,1,1,0
7609,32,170,25,88,80,1,4223.139,74,1703.859,LESS,-936,2362,1426,4,1,-8,-0.749926769,8,-0.174607574,0.095130518,0.593357852,168,88,80,0,0.15956022,0.312133481,0,1.365512643,-0.761481584,0.761481584,0,0.312133481,0,1,0
7610,32,171,36,80,70,1,4826.068,64,1187.133,LESS,2,1830,1832,3,2,-10,-0.937408461,10,0.174607574,-0.592559971,1.058924718,150,80,70,0,-0.199450275,0,-0.390166852,0.45263511,0.397106779,0.397106779,-0.390166852,0,0,1,1
7611,32,172,28,80,93,0,3077.549,64,3265.703,LESS,-1226,2220,994,2,2,13,1.218630999,13,0.698430296,-0.592559971,-0.29123842,173,80,93,1,0.259285357,0,0.507216907,-0.460242423,-1.119680544,1.119680544,0.507216907,0,0,0,0
7612,32,173,21,82,80,0,3432.836,84,1214.437,LESS,-522,2054,1532,2,2,-2,-0.187481692,2,-1.222253018,0.782821006,-0.016894584,162,82,80,0,0.039890055,0.07803337,0,-0.460242423,-0.250121688,0.250121688,0,0.07803337,1,0,1
7613,32,174,19,50,41,1,2923.814,84,1724.254,LESS,644,1186,1830,3,2,-9,-0.843667615,9,0,0.782821006,-0.409948786,91,50,41,0,-1.376206896,-1.170500555,-1.521650721,0.45263511,1.190085167,1.190085167,-1.521650721,-1.170500555,1,1,1
7614,32,175,56,96,110,0,5728.365,54,1968.002,LESS,-972,3002,2030,6,1,14,1.312371845,14,0.87303787,-1.280250459,1.755656151,206,96,110,1,0.917471264,0.624266962,1.170500555,3.191267708,-0.805947661,0.805947661,1.170500555,0.624266962,0,1,0
7615,32,176,23,80,85,1,4850.283,74,2276.623,LESS,260,1882,2142,3,2,5,0.46870423,5,-0.698430296,0.095130518,1.077622942,165,80,85,1,0.099725137,0,0.195083426,0.45263511,0.715780337,0.715780337,0.195083426,0,0,1,1
7616,32,177,10,60,50,1,3255.376,84,1997.786,LESS,874,1430,2304,3,2,-10,-0.937408461,10,0.174607574,0.782821006,-0.153924808,110,60,50,0,-0.997251374,-0.780333703,-1.170500555,0.45263511,1.474173998,1.474173998,-1.170500555,-0.780333703,1,1,1
7617,32,178,19,41,50,0,2792.095,94,794.628,LESS,-920,1914,994,2,2,9,0.843667615,9,0,1.470511494,-0.511658941,91,41,50,1,-1.376206896,-1.521650721,-1.170500555,-0.460242423,-0.741718882,0.741718882,-1.170500555,-1.521650721,1,0,0
7618,32,179,56,110,96,1,3506.5,74,883.339,LESS,-84,1660,1576,3,2,-14,-1.312371845,14,0.87303787,0.095130518,0.039986936,206,110,96,0,0.917471264,1.170500555,0.624266962,0.45263511,0.290882259,0.290882259,0.624266962,1.170500555,0,1,1
7619,32,180,35,72,80,0,2462.956,84,1461.375,LESS,-614,1314,700,2,2,8,0.749926769,8,-0.174607574,0.782821006,-0.765811938,152,72,80,1,-0.15956022,-0.312133481,0,-0.460242423,-0.36375722,0.36375722,0,-0.312133481,1,0,0
7620,32,181,11,49,50,1,2762.168,84,2308.218,LESS,452,1442,1894,3,2,1,0.093740846,1,-1.396860592,0.782821006,-0.53476783,99,49,50,1,-1.216646676,-1.20951724,-1.170500555,0.45263511,0.952932752,0.952932752,-1.170500555,-1.20951724,1,1,1
7621,32,182,17,43,50,0,2217.496,84,951.757,LESS,-1082,1776,694,2,2,7,0.656185922,7,-0.349215148,0.782821006,-0.955350081,93,43,50,1,-1.336316841,-1.443617351,-1.170500555,-0.460242423,-0.941816233,0.941816233,-1.170500555,-1.443617351,1,0,0
7622,32,183,1,51,50,0,2119.951,84,1617.278,LESS,-14,1506,1492,2,2,-1,-0.093740846,1,-1.396860592,0.782821006,-1.030671918,101,51,50,0,-1.176756621,-1.131483869,-1.170500555,-0.460242423,0.377344077,0.377344077,-1.170500555,-1.131483869,1,0,1
7623,32,184,41,112,110,0,2815.246,74,1144.227,LESS,-890,1588,698,2,1,-2,-0.187481692,2,-1.222253018,0.095130518,-0.493782311,222,112,110,0,1.236591704,1.248533925,1.170500555,-0.460242423,-0.704663817,0.704663817,1.170500555,1.248533925,1,0,0
7624,32,185,20,40,50,0,2350.208,94,905.688,LESS,-286,1446,1160,1,2,10,0.937408461,10,0.174607574,1.470511494,-0.852873156,90,40,50,1,-1.396151924,-1.560667406,-1.170500555,-1.373119956,0.041378156,0.041378156,-1.170500555,-1.560667406,1,0,1
7625,32,186,1,50,51,0,1811.799,94,1126.082,LESS,-12,1216,1204,2,2,1,0.093740846,1,-1.396860592,1.470511494,-1.268619273,101,50,51,1,-1.176756621,-1.170500555,-1.131483869,-0.460242423,0.379814415,0.379814415,-1.131483869,-1.170500555,1,0,1
7626,32,187,23,85,80,0,2669.652,74,2150.522,LESS,-1274,1804,530,2,1,-5,-0.46870423,5,-0.698430296,0.095130518,-0.606206398,165,85,80,0,0.099725137,0.195083426,0,-0.460242423,-1.178968648,1.178968648,0,0.195083426,1,0,0
7627,32,188,11,50,49,0,2749.159,74,1262.91,LESS,-894,1852,958,2,2,-1,-0.093740846,1,-1.396860592,0.095130518,-0.544813059,99,50,49,0,-1.216646676,-1.170500555,-1.20951724,-0.460242423,-0.709604493,0.709604493,-1.20951724,-1.170500555,1,0,0
7628,32,189,17,50,43,1,3320.006,64,2108.529,LESS,352,1302,1654,3,2,-7,-0.656185922,7,-0.349215148,-0.592559971,-0.10401912,93,50,43,0,-1.336316841,-1.170500555,-1.443617351,0.45263511,0.829415869,0.829415869,-1.443617351,-1.170500555,0,1,1
7629,32,190,21,80,82,0,2410.983,64,2370.246,LESS,-822,1386,564,1,1,2,0.187481692,2,-1.222253018,-0.592559971,-0.805944204,162,80,82,1,0.039890055,0,0.07803337,-1.373119956,-0.620672337,0.620672337,0.07803337,0,0,0,0
7630,32,191,10,50,60,0,2270.307,84,1851.293,LESS,-722,1246,524,2,1,10,0.937408461,10,0.174607574,0.782821006,-0.914570733,110,50,60,1,-0.997251374,-1.170500555,-0.780333703,-0.460242423,-0.497155454,0.497155454,-0.780333703,-1.170500555,1,1,0
7631,32,192,3,53,50,0,6083.601,64,1596.459,LESS,-314,2290,1976,3,2,-3,-0.281222538,3,-1.047645444,-0.592559971,2.029960607,103,53,50,0,-1.136866566,-1.053450499,-1.170500555,0.45263511,0.006793429,0.006793429,-1.170500555,-1.053450499,0,1,1
7632,32,193,45,122,110,1,3608.935,74,1400.012,LESS,108,1798,1906,2,2,-12,-1.124890153,12,0.523822722,0.095130518,0.11908471,232,122,110,0,1.436041979,1.638700776,1.170500555,-0.460242423,0.528034675,0.528034675,1.170500555,1.638700776,1,0,1
7633,32,194,38,67,80,0,2338.91,54,1329.288,LESS,-1110,1734,624,2,1,13,1.218630999,13,0.698430296,-1.280250459,-0.861597193,147,67,80,1,-0.259285357,-0.507216907,0,-0.460242423,-0.97640096,0.97640096,0,-0.507216907,0,0,0
7634,32,195,38,80,67,1,3836.239,84,2382.871,LESS,1628,1682,3310,3,2,-13,-1.218630999,13,0.698430296,0.782821006,0.294603238,147,80,67,0,-0.259285357,0,-0.507216907,0.45263511,2.405491296,2.405491296,-0.507216907,0,1,1,1
7635,32,196,36,70,80,0,2278.55,74,1974.788,LESS,-564,1358,794,2,1,10,0.937408461,10,0.174607574,0.095130518,-0.908205692,150,70,80,1,-0.199450275,-0.390166852,0,-0.460242423,-0.301998779,0.301998779,0,-0.390166852,1,0,0
7636,32,197,45,110,122,0,5138.037,64,2911.839,LESS,-1924,3104,1180,4,1,12,1.124890153,12,0.523822722,-0.592559971,1.299819466,232,110,122,1,1.436041979,1.170500555,1.638700776,1.365512643,-1.981828387,1.981828387,1.638700776,1.170500555,0,1,0
7637,32,198,42,110,115,0,3721.075,54,2819.124,LESS,-2170,2822,652,1,1,5,0.46870423,5,-0.698430296,-1.280250459,0.205676445,225,110,115,1,1.296426786,1.170500555,1.36558398,-1.373119956,-2.285679919,2.285679919,1.36558398,1.170500555,0,0,0
7638,32,199,41,110,112,1,6363.511,44,3147.213,LESS,-420,2764,2344,4,2,2,0.187481692,2,-1.222253018,-1.967940947,2.246100188,222,110,112,1,1.236591704,1.170500555,1.248533925,1.365512643,-0.124134467,0.124134467,1.248533925,1.170500555,0,1,1
7639,32,200,53,110,103,0,5694.148,54,2397.092,LESS,194,2264,2458,3,1,-7,-0.656185922,7,-0.349215148,-1.280250459,1.72923463,213,110,103,0,1.057086457,1.170500555,0.897383758,0.45263511,0.634259194,0.634259194,0.897383758,1.170500555,0,1,1
7640,32,201,3,50,53,0,2537.057,74,2401.537,MORE,-1748,2238,490,2,1,3,0.281222538,3,-1.047645444,0.095130518,-0.708592979,103,50,53,0,-1.136866566,-1.170500555,-1.053450499,-0.460242423,-1.764438673,1.764438673,-1.053450499,-1.170500555,0,0,0
7641,32,202,20,50,40,0,2533.419,74,2363.078,MORE,-778,1680,902,2,2,-10,-0.937408461,10,0.174607574,0.095130518,-0.711402152,90,50,40,1,-1.396151924,-1.170500555,-1.560667406,-0.460242423,-0.566324908,0.566324908,-1.560667406,-1.170500555,1,0,0
7642,32,203,25,80,88,1,3211.621,74,1934.07,MORE,110,1420,1530,3,2,8,0.749926769,8,-0.174607574,0.095130518,-0.187711337,168,80,88,0,0.15956022,0,0.312133481,0.45263511,0.530505012,0.530505012,0.312133481,0,1,1,1
7643,32,204,42,115,110,1,2105.686,84,1898.676,MORE,872,814,1686,1,2,-5,-0.46870423,5,-0.698430296,0.782821006,-1.041686999,225,115,110,1,1.296426786,1.36558398,1.170500555,-1.373119956,1.471703661,1.471703661,1.170500555,1.36558398,1,0,1
7644,32,205,53,103,110,1,2204.542,74,2156.395,MORE,404,876,1280,1,2,7,0.656185922,7,-0.349215148,0.095130518,-0.96535284,213,103,110,0,1.057086457,0.897383758,1.170500555,-1.373119956,0.893644648,0.893644648,1.170500555,0.897383758,0,0,1
7645,32,206,26,90,80,0,4184.561,74,1920.586,MORE,-1322,2720,1398,4,1,-10,-0.937408461,10,0.174607574,0.095130518,0.563568874,170,90,80,1,0.199450275,0.390166852,0,1.365512643,-1.238256752,1.238256752,0,0.390166852,0,1,0
7646,32,207,35,80,72,1,4248.435,74,1739.723,MORE,356,1652,2008,2,2,-8,-0.749926769,8,-0.174607574,0.095130518,0.612890798,152,80,72,1,-0.15956022,0,-0.312133481,-0.460242423,0.834356544,0.834356544,-0.312133481,0,0,0,1
7647,32,208,28,93,80,0,3635.295,64,1701.995,MORE,-440,1556,1116,2,1,-13,-1.218630999,13,0.698430296,-0.592559971,0.13943925,173,93,80,1,0.259285357,0.507216907,0,-0.460242423,-0.148837844,0.148837844,0,0.507216907,0,0,0
7648,32,209,26,80,90,1,4342.773,84,1002.775,MORE,464,1974,2438,3,2,10,0.937408461,10,0.174607574,0.782821006,0.685736269,170,80,90,0,0.199450275,0,0.390166852,0.45263511,0.967754778,0.967754778,0.390166852,0,1,1,1
7649,32,210,25,88,80,0,4628.122,64,2160.836,MORE,-804,2360,1556,2,1,-8,-0.749926769,8,-0.174607574,-0.592559971,0.906075711,168,88,80,1,0.15956022,0.312133481,0,-0.460242423,-0.598439298,0.598439298,0,0.312133481,0,0,0
7650,32,211,36,80,70,0,4088.15,74,974.637,MORE,-1448,2692,1244,2,2,-10,-0.937408461,10,0.174607574,0.095130518,0.489122684,150,80,70,1,-0.199450275,0,-0.390166852,-0.460242423,-1.393888024,1.393888024,-0.390166852,0,0,0,0
7651,32,212,28,80,93,1,3594.637,84,1974.853,MORE,-1596,2682,1086,1,2,13,1.218630999,13,0.698430296,0.782821006,0.108044148,173,80,93,0,0.259285357,0,0.507216907,-1.373119956,-1.576693011,1.576693011,0.507216907,0,1,0,0
7652,32,213,21,82,80,1,4395.555,64,1545.98,MORE,-438,2554,2116,3,2,-2,-0.187481692,2,-1.222253018,-0.592559971,0.726493224,162,82,80,1,0.039890055,0.07803337,0,0.45263511,-0.146367506,0.146367506,0,0.07803337,0,1,0
7653,32,214,19,50,41,0,2505.763,84,1947.364,MORE,-680,1582,902,2,2,-9,-0.843667615,9,0,0.782821006,-0.732757432,91,50,41,1,-1.376206896,-1.170500555,-1.521650721,-0.460242423,-0.445278363,0.445278363,-1.521650721,-1.170500555,1,0,0
7654,32,215,56,96,110,1,5229.414,74,1405.411,MORE,200,1822,2022,3,2,14,1.312371845,14,0.87303787,0.095130518,1.370378526,206,96,110,0,0.917471264,0.624266962,1.170500555,0.45263511,0.641670207,0.641670207,1.170500555,0.624266962,0,1,1
7655,32,216,23,80,85,0,3355.346,74,1734.003,MORE,-1438,2190,752,2,1,5,0.46870423,5,-0.698430296,0.095130518,-0.076730446,165,80,85,0,0.099725137,0,0.195083426,-0.460242423,-1.381536336,1.381536336,0.195083426,0,1,0,0
7656,32,217,10,60,50,0,2938.083,64,1564.078,MORE,-298,1554,1256,2,2,-10,-0.937408461,10,0.174607574,-0.592559971,-0.398930617,110,60,50,1,-0.997251374,-0.780333703,-1.170500555,-0.460242423,0.02655613,0.02655613,-1.170500555,-0.780333703,0,0,0
7657,32,218,19,41,50,1,1876.789,94,960.159,MORE,344,1012,1356,1,2,9,0.843667615,9,0,1.470511494,-1.218435602,91,41,50,0,-1.376206896,-1.521650721,-1.170500555,-1.373119956,0.819534519,0.819534519,-1.170500555,-1.521650721,1,0,1
7658,32,219,56,110,96,0,4752.43,64,2448.397,MORE,-1002,2662,1660,2,1,-14,-1.312371845,14,0.87303787,-0.592559971,1.002063275,206,110,96,1,0.917471264,1.170500555,0.624266962,-0.460242423,-0.843002726,0.843002726,0.624266962,1.170500555,0,0,0
7659,32,220,35,72,80,1,2400.546,84,978.448,MORE,50,1086,1136,0,2,8,0.749926769,8,-0.174607574,0.782821006,-0.814003397,152,72,80,0,-0.15956022,-0.312133481,0,-2.285997488,0.456394883,0.456394883,0,-0.312133481,1,0,1
7660,32,221,11,49,50,1,1978.196,84,788.689,MORE,-112,970,858,1,2,1,0.093740846,1,-1.396860592,0.782821006,-1.140131624,99,49,50,0,-1.216646676,-1.20951724,-1.170500555,-1.373119956,0.256297532,0.256297532,-1.170500555,-1.20951724,1,0,0
7661,32,222,17,43,50,1,3250.197,84,910.167,MORE,-1014,2232,1218,1,2,7,0.656185922,7,-0.349215148,0.782821006,-0.157923904,93,43,50,0,-1.336316841,-1.443617351,-1.170500555,-1.373119956,-0.857824752,0.857824752,-1.170500555,-1.443617351,1,0,0
7662,32,223,1,51,50,1,4684.154,64,2294.369,MORE,288,2042,2330,3,1,-1,-0.093740846,1,-1.396860592,-0.592559971,0.949342236,101,51,50,1,-1.176756621,-1.131483869,-1.170500555,0.45263511,0.750365064,0.750365064,-1.170500555,-1.131483869,0,1,1
7663,32,224,41,112,110,0,3395.576,84,2562.338,MORE,-1086,2284,1198,2,2,-2,-0.187481692,2,-1.222253018,0.782821006,-0.045665834,222,112,110,1,1.236591704,1.248533925,1.170500555,-0.460242423,-0.946756908,0.946756908,1.170500555,1.248533925,1,0,0
7664,32,225,20,40,50,1,2339.674,84,1538.828,MORE,176,1370,1546,1,2,10,0.937408461,10,0.174607574,0.782821006,-0.861007251,90,40,50,0,-1.396151924,-1.560667406,-1.170500555,-1.373119956,0.612026155,0.612026155,-1.170500555,-1.560667406,1,0,1
7665,32,226,1,50,51,1,5724.238,64,1142.075,MORE,-106,2538,2432,3,2,1,0.093740846,1,-1.396860592,-0.592559971,1.752469384,101,50,51,0,-1.176756621,-1.170500555,-1.131483869,0.45263511,0.263708545,0.263708545,-1.131483869,-1.170500555,0,1,0
7666,32,227,23,85,80,0,5207.404,54,1711.697,MORE,-1242,2954,1712,3,1,-5,-0.46870423,5,-0.698430296,-1.280250459,1.353382948,165,85,80,1,0.099725137,0.195083426,0,0.45263511,-1.139443245,1.139443245,0,0.195083426,0,1,0
7667,32,228,11,50,49,1,4020.919,84,786.767,MORE,506,1814,2320,3,2,-1,-0.093740846,1,-1.396860592,0.782821006,0.437208568,99,50,49,1,-1.216646676,-1.170500555,-1.20951724,0.45263511,1.019631869,1.019631869,-1.20951724,-1.170500555,1,1,1
7668,32,229,17,50,43,0,3630.439,74,1567.495,MORE,-1380,2374,994,2,2,-7,-0.656185922,7,-0.349215148,0.095130518,0.135689567,93,50,43,1,-1.336316841,-1.170500555,-1.443617351,-0.460242423,-1.309896544,1.309896544,-1.443617351,-1.170500555,0,0,0
7669,32,230,21,80,82,1,6681.408,64,1519.026,MORE,-126,3056,2930,3,2,2,0.187481692,2,-1.222253018,-0.592559971,2.491572391,162,80,82,0,0.039890055,0,0.07803337,0.45263511,0.239005169,0.239005169,0.07803337,0,0,1,0
7670,32,231,10,50,60,1,1670.856,64,2525.067,MORE,-20,1236,1216,1,2,10,0.937408461,10,0.174607574,-0.592559971,-1.377451973,110,50,60,0,-0.997251374,-1.170500555,-0.780333703,-1.373119956,0.369933064,0.369933064,-0.780333703,-1.170500555,0,0,1
7671,32,232,3,53,50,0,4236.72,74,1450.134,MORE,-534,2466,1932,2,2,-3,-0.281222538,3,-1.047645444,0.095130518,0.603844764,103,53,50,1,-1.136866566,-1.053450499,-1.170500555,-0.460242423,-0.264943714,0.264943714,-1.170500555,-1.053450499,0,0,0
7672,32,233,45,122,110,1,4435.93,54,1326.39,MORE,-490,2288,1798,3,2,-12,-1.124890153,12,0.523822722,-1.280250459,0.757669801,232,122,110,1,1.436041979,1.638700776,1.170500555,0.45263511,-0.210596285,0.210596285,1.170500555,1.638700776,0,1,0
7673,32,234,38,67,80,1,2732.065,84,1557.41,MORE,548,1338,1886,1,2,13,1.218630999,13,0.698430296,0.782821006,-0.558012623,147,67,80,0,-0.259285357,-0.507216907,0,-1.373119956,1.07150896,1.07150896,0,-0.507216907,1,0,1
7674,32,235,38,80,67,0,4494.399,54,1635.714,MORE,-534,2470,1936,2,1,-13,-1.218630999,13,0.698430296,-1.280250459,0.802818117,147,80,67,1,-0.259285357,0,-0.507216907,-0.460242423,-0.264943714,0.264943714,-0.507216907,0,0,0,0
7675,32,236,36,70,80,1,3767.521,74,1623.433,MORE,-192,1554,1362,2,2,10,0.937408461,10,0.174607574,0.095130518,0.241540898,150,70,80,0,-0.199450275,-0.390166852,0,-0.460242423,0.157484026,0.157484026,0,-0.390166852,0,0,0
7676,32,237,45,110,122,1,4557.91,74,2627.101,MORE,22,2236,2258,4,1,12,1.124890153,12,0.523822722,0.095130518,0.851859741,232,110,122,0,1.436041979,1.170500555,1.638700776,1.365512643,0.421810155,0.421810155,1.638700776,1.170500555,0,1,1
7677,32,238,42,110,115,0,5155.694,44,2408.588,MORE,910,1810,2720,3,2,5,0.46870423,5,-0.698430296,-1.967940947,1.313453765,225,110,115,0,1.296426786,1.170500555,1.36558398,0.45263511,1.518640076,1.518640076,1.36558398,1.170500555,0,1,1
7678,32,239,41,110,112,0,4482.946,64,870.664,MORE,-892,2282,1390,2,1,2,0.187481692,2,-1.222253018,-0.592559971,0.793974393,222,110,112,0,1.236591704,1.170500555,1.248533925,-0.460242423,-0.707134155,0.707134155,1.248533925,1.170500555,0,0,0
7679,32,240,53,110,103,0,4269.819,74,1068.912,MORE,804,1580,2384,2,2,-7,-0.656185922,7,-0.349215148,0.095130518,0.629402994,213,110,103,1,1.057086457,1.170500555,0.897383758,-0.460242423,1.38771218,1.38771218,0.897383758,1.170500555,0,1,1
7680,33,1,49,110,131,0,4969.825,10,3628.837,MORE,-576,2804,2228,3,1,21,1.968557767,21,2.095290887,-1.531130216,0.47220471,241,110,131,0,1.615547226,1.170500555,1.989850943,-0.627533494,-0.752643807,0.752643807,1.989850943,1.170500555,0,0,0
7681,33,2,13,47,50,0,4530.13,90,1300.112,MORE,182,2222,2404,5,2,3,0.281222538,3,-1.047645444,1.45340787,0.256738527,97,47,50,0,-1.256536731,-1.28755061,-1.170500555,0.606958625,0.258723741,0.258723741,-1.170500555,-1.28755061,1,1,1
7682,33,3,16,50,44,0,4601.218,80,1288.594,MORE,-218,2188,1970,6,1,-6,-0.562445076,6,-0.523822722,1.08034061,0.291574174,94,50,44,1,-1.316371814,-1.170500555,-1.404600665,1.224204684,-0.274979451,0.274979451,-1.404600665,-1.170500555,1,1,0
7683,33,4,7,57,50,0,8198.148,70,2341.387,MORE,734,2996,3730,7,2,-7,-0.656185922,7,-0.349215148,0.707273349,2.054197759,107,57,50,1,-1.057086457,-0.897383758,-1.170500555,1.841450743,0.995234145,0.995234145,-1.170500555,-0.897383758,1,1,1
7684,33,5,18,42,50,0,5220.994,20,1495.077,MORE,736,2062,2798,7,2,8,0.749926769,8,-0.174607574,-1.158062956,0.59528645,92,42,50,0,-1.356261869,-1.482634036,-1.170500555,1.841450743,0.997902661,0.997902661,-1.170500555,-1.482634036,0,1,1
7685,33,6,51,108,110,1,6595.503,30,1115.652,MORE,1286,2548,3834,4,1,2,0.187481692,2,-1.222253018,-0.784995695,1.268844729,218,108,110,0,1.156811594,1.092467184,1.170500555,-0.010287434,1.731744549,1.731744549,1.170500555,1.092467184,0,1,1
7686,33,7,31,78,80,1,3854.562,50,1356.324,MORE,686,1514,2200,5,2,2,0.187481692,2,-1.222253018,-0.038861173,-0.074313812,158,78,80,0,-0.039890055,-0.07803337,0,0.606958625,0.931189762,0.931189762,0,-0.07803337,0,1,1
7687,33,8,58,110,92,0,2077.783,80,806.313,MORE,-78,1184,1106,2,2,-18,-1.687335229,18,1.571468165,1.08034061,-0.944998693,202,110,92,1,0.837691154,1.170500555,0.468200222,-1.244779553,-0.088183334,0.088183334,0.468200222,1.170500555,1,0,0
7688,33,9,12,50,48,0,3941.463,10,962.82,MORE,-1286,2776,1490,4,1,-2,-0.187481692,2,-1.222253018,-1.531130216,-0.031729232,98,50,48,1,-1.236591704,-1.170500555,-1.248533925,-0.010287434,-1.699966971,1.699966971,-1.248533925,-1.170500555,0,1,0
7689,33,10,54,110,101,0,4884.396,100,1601.307,MORE,456,2486,2942,5,1,-9,-0.843667615,9,0,1.826475131,0.430341462,211,110,101,1,1.017196402,1.170500555,0.819350388,0.606958625,0.624310427,0.624310427,0.819350388,1.170500555,1,1,1
7690,33,11,14,46,50,1,3222.219,80,992.597,MORE,628,1340,1968,5,2,4,0.374963384,4,-0.87303787,1.08034061,-0.384184364,96,46,50,0,-1.276481759,-1.326567295,-1.170500555,0.606958625,0.853802799,0.853802799,-1.170500555,-1.326567295,1,1,1
7691,33,12,22,80,83,0,2489.951,60,1426.35,MORE,-572,1520,948,4,1,3,0.281222538,3,-1.047645444,0.334206088,-0.743021719,163,80,83,0,0.059835082,0,0.117050055,-0.010287434,-0.747306775,0.747306775,0.117050055,0,0,0,0
7692,33,13,6,50,56,1,7643.177,10,1372.289,MORE,1086,3234,4320,9,1,6,0.562445076,6,-0.523822722,-1.531130216,1.782242237,106,50,56,0,-1.077031484,-1.170500555,-0.936400444,3.075942862,1.464892953,1.464892953,-0.936400444,-1.170500555,0,1,1
7693,33,14,13,50,47,0,1917.466,30,1958.489,MORE,-1014,1548,534,2,1,-3,-0.281222538,3,-1.047645444,-0.784995695,-1.023559723,97,50,47,1,-1.256536731,-1.170500555,-1.28755061,-1.244779553,-1.337048801,1.337048801,-1.28755061,-1.170500555,0,0,0
7694,33,15,46,110,124,1,1941.468,90,933.277,MORE,908,1004,1912,3,2,14,1.312371845,14,0.87303787,1.45340787,-1.01179789,234,110,124,0,1.475932034,1.170500555,1.716734147,-0.627533494,1.227395033,1.227395033,1.716734147,1.170500555,1,0,1
7695,33,16,27,91,80,0,2712.297,60,1341.516,MORE,-406,1596,1190,4,2,-11,-1.031149307,11,0.349215148,0.334206088,-0.634064274,171,91,80,1,0.219395302,0.429183537,0,-0.010287434,-0.52581995,0.52581995,0,0.429183537,0,0,0
7696,33,17,40,64,80,1,2710.743,50,1498.559,MORE,366,1016,1382,3,2,16,1.499853537,16,1.222253018,-0.038861173,-0.634825789,144,64,80,0,-0.31912044,-0.624266962,0,-0.627533494,0.504227209,0.504227209,0,-0.624266962,0,0,1
7697,33,18,22,83,80,1,7260.29,0,1508.396,MORE,-1958,4872,2914,7,1,-3,-0.281222538,3,-1.047645444,-1.904197477,1.594613994,163,83,80,1,0.059835082,0.117050055,0,1.841450743,-2.596588333,2.596588333,0,0.117050055,0,1,0
7698,33,19,54,101,110,1,6293.369,10,1151.97,MORE,-196,3256,3060,5,1,9,0.843667615,9,0,-1.531130216,1.120788327,211,101,110,0,1.017196402,0.819350388,1.170500555,0.606958625,-0.245625775,0.245625775,1.170500555,0.819350388,0,1,0
7699,33,20,6,56,50,1,2697.521,60,1081.697,MORE,44,1234,1278,3,2,-6,-0.562445076,6,-0.523822722,0.334206088,-0.641305039,106,56,50,1,-1.077031484,-0.936400444,-1.170500555,-0.627533494,0.07459614,0.07459614,-1.170500555,-0.936400444,1,0,1
7700,33,21,18,50,42,0,3416.717,40,1540.965,MORE,-842,2204,1362,4,1,-8,-0.749926769,8,-0.174607574,-0.411928434,-0.288873429,92,50,42,1,-1.356261869,-1.170500555,-1.482634036,-0.010287434,-1.107556429,1.107556429,-1.482634036,-1.170500555,0,1,0
7701,33,22,43,110,117,0,10374.132,10,2008.325,MORE,-136,5104,4968,7,1,7,0.656185922,7,-0.349215148,-1.531130216,3.120507283,227,110,117,0,1.336316841,1.170500555,1.443617351,1.841450743,-0.165570296,0.165570296,1.443617351,1.170500555,0,1,0
7702,33,23,32,77,80,0,5886.034,70,1073.746,MORE,-634,2854,2220,6,2,3,0.281222538,3,-1.047645444,0.707273349,0.921179694,157,77,80,0,-0.059835082,-0.117050055,0,1.224204684,-0.830030769,0.830030769,0,-0.117050055,1,1,0
7703,33,24,27,80,91,1,2947.345,60,1290.567,MORE,460,1224,1684,3,2,11,1.031149307,11,0.349215148,0.334206088,-0.518882397,171,80,91,0,0.219395302,0,0.429183537,-0.627533494,0.629647459,0.629647459,0.429183537,0,1,0,1
7704,33,25,16,44,50,0,5863.949,30,962.466,MORE,-634,2962,2328,6,1,6,0.562445076,6,-0.523822722,-0.784995695,0.910357259,94,44,50,0,-1.316371814,-1.404600665,-1.170500555,1.224204684,-0.830030769,0.830030769,-1.170500555,-1.404600665,0,1,0
7705,33,26,7,50,57,1,3906.319,70,1003.352,MORE,656,1602,2258,5,2,7,0.656185922,7,-0.349215148,0.707273349,-0.048951042,107,50,57,0,-1.057086457,-1.170500555,-0.897383758,0.606958625,0.891162023,0.891162023,-0.897383758,-1.170500555,1,1,1
7706,33,27,14,50,46,0,5133.982,20,1745.75,MORE,-1432,3182,1750,4,1,-4,-0.374963384,4,-0.87303787,-1.158062956,0.552647476,96,50,46,1,-1.276481759,-1.170500555,-1.326567295,-0.010287434,-1.894768636,1.894768636,-1.326567295,-1.170500555,0,1,0
7707,33,28,51,110,108,0,6102.943,50,1252.723,MORE,166,2872,3038,6,2,-2,-0.187481692,2,-1.222253018,-0.038861173,1.027472816,218,110,108,1,1.156811594,1.170500555,1.092467184,1.224204684,0.237375613,0.237375613,1.092467184,1.170500555,0,1,1
7708,33,29,50,133,110,0,1920.556,100,1464.344,MORE,656,1276,1932,2,2,-23,-2.15603946,23,2.444506035,1.826475131,-1.022045513,243,133,110,1,1.655437281,2.067884313,1.170500555,-1.244779553,0.891162023,0.891162023,1.170500555,2.067884313,1,0,1
7709,33,30,49,131,110,0,6324.341,10,1440.722,MORE,-1692,4132,2440,6,1,-21,-1.968557767,21,2.095290887,-1.531130216,1.135965708,241,131,110,1,1.615547226,1.989850943,1.170500555,1.224204684,-2.241675711,2.241675711,1.170500555,1.989850943,0,1,0
7710,33,31,47,126,110,0,2556.406,90,967.885,MORE,-426,1584,1158,2,2,-16,-1.499853537,16,1.222253018,1.45340787,-0.710456406,236,126,110,1,1.515822089,1.794767517,1.170500555,-1.244779553,-0.55250511,0.55250511,1.170500555,1.794767517,1,0,0
7711,33,32,50,110,133,1,2875.659,80,1466.37,MORE,-26,1460,1434,2,2,23,2.15603946,23,2.444506035,1.08034061,-0.554011086,243,110,133,0,1.655437281,1.170500555,2.067884313,-1.244779553,-0.018801919,0.018801919,2.067884313,1.170500555,1,0,0
7712,33,33,47,110,126,1,6366.476,40,1997.687,MORE,112,2950,3062,3,2,16,1.499853537,16,1.222253018,-0.411928434,1.156613356,236,110,126,0,1.515822089,1.170500555,1.794767517,-0.627533494,0.165325682,0.165325682,1.794767517,1.170500555,0,0,1
7713,33,34,12,48,50,0,2097.473,70,676.666,MORE,-334,1106,772,2,1,2,0.187481692,2,-1.222253018,0.707273349,-0.935349893,98,48,50,0,-1.236591704,-1.248533925,-1.170500555,-1.244779553,-0.429753376,0.429753376,-1.170500555,-1.248533925,1,0,0
7714,33,35,32,80,77,0,5123.344,30,1051.652,MORE,-760,2800,2040,4,1,-3,-0.281222538,3,-1.047645444,-0.784995695,0.547434478,157,80,77,1,-0.059835082,0,-0.117050055,-0.010287434,-0.998147275,0.998147275,-0.117050055,0,0,1,0
7715,33,36,43,117,110,0,3561.31,40,948.994,MORE,-142,1610,1468,4,1,-7,-0.656185922,7,-0.349215148,-0.411928434,-0.218017718,227,117,110,1,1.336316841,1.443617351,1.170500555,-0.010287434,-0.173575844,0.173575844,1.170500555,1.443617351,0,1,0
7716,33,37,40,80,64,0,4914.125,30,1479.649,MORE,-1312,3126,1814,4,1,-16,-1.499853537,16,1.222253018,-0.784995695,0.444909729,144,80,64,1,-0.31912044,0,-0.624266962,-0.010287434,-1.734657679,1.734657679,-0.624266962,0,0,0,0
7717,33,38,31,80,78,0,2074.403,20,989.223,MORE,-782,1438,656,2,1,-2,-0.187481692,2,-1.222253018,-1.158062956,-0.946655013,158,80,78,1,-0.039890055,0,-0.07803337,-1.244779553,-1.02750095,1.02750095,-0.07803337,0,0,0,0
7718,33,39,46,124,110,0,2981.091,60,880.483,MORE,-710,1740,1030,3,1,-14,-1.312371845,14,0.87303787,0.334206088,-0.502345657,234,124,110,1,1.475932034,1.716734147,1.170500555,-0.627533494,-0.931434376,0.931434376,1.170500555,1.716734147,1,0,0
7719,33,40,58,92,110,1,3238.827,90,984.635,MORE,1034,1432,2466,3,2,18,1.687335229,18,1.571468165,1.45340787,-0.376045854,202,92,110,0,0.837691154,0.468200222,1.170500555,-0.627533494,1.395511538,1.395511538,1.170500555,0.468200222,1,0,1
7720,33,41,49,110,131,0,2713.69,100,973.269,LESS,-328,1668,1340,2,2,21,1.968557767,21,2.095290887,1.826475131,-0.633381654,241,110,131,1,1.615547226,1.170500555,1.989850943,-1.244779553,-0.421747828,0.421747828,1.989850943,1.170500555,1,0,0
7721,33,42,13,47,50,0,1857.956,70,1775.48,LESS,-862,1474,612,2,1,3,0.281222538,3,-1.047645444,0.707273349,-1.052721739,97,47,50,1,-1.256536731,-1.28755061,-1.170500555,-1.244779553,-1.134241589,1.134241589,-1.170500555,-1.28755061,1,0,0
7722,33,43,16,50,44,1,2420.8,40,1062.992,LESS,402,924,1326,3,2,-6,-0.562445076,6,-0.523822722,-0.411928434,-0.776908168,94,50,44,0,-1.316371814,-1.170500555,-1.404600665,-0.627533494,0.552260496,0.552260496,-1.404600665,-1.170500555,0,0,1
7723,33,44,7,57,50,1,7465.545,0,2075.836,LESS,-1632,4974,3342,7,1,-7,-0.656185922,7,-0.349215148,-1.904197477,1.695196242,107,57,50,0,-1.057086457,-0.897383758,-1.170500555,1.841450743,-2.161620232,2.161620232,-1.170500555,-0.897383758,0,1,0
7724,33,45,18,42,50,1,3167.684,40,1296.201,LESS,580,1172,1752,3,2,8,0.749926769,8,-0.174607574,-0.411928434,-0.410908453,92,42,50,1,-1.356261869,-1.482634036,-1.170500555,-0.627533494,0.789758416,0.789758416,-1.170500555,-1.482634036,0,0,1
7725,33,46,51,108,110,1,6983.798,30,1620.912,LESS,590,3030,3620,6,2,2,0.187481692,2,-1.222253018,-0.784995695,1.459123084,218,108,110,1,1.156811594,1.092467184,1.170500555,1.224204684,0.803100996,0.803100996,1.170500555,1.092467184,0,1,1
7726,33,47,31,78,80,0,3161.079,60,2484.946,LESS,-496,1722,1226,4,1,2,0.187481692,2,-1.222253018,0.334206088,-0.414145138,158,78,80,1,-0.039890055,-0.07803337,0,-0.010287434,-0.645903168,0.645903168,0,-0.07803337,1,1,0
7727,33,48,58,110,92,1,2150.882,80,1377.343,LESS,710,864,1574,3,2,-18,-1.687335229,18,1.571468165,1.08034061,-0.909177584,202,110,92,0,0.837691154,1.170500555,0.468200222,-0.627533494,0.963211953,0.963211953,0.468200222,1.170500555,1,0,1
7728,33,49,12,50,48,0,1691.261,90,1736.635,LESS,950,984,1934,2,2,-2,-0.187481692,2,-1.222253018,1.45340787,-1.134408216,98,50,48,0,-1.236591704,-1.170500555,-1.248533925,-1.244779553,1.283433868,1.283433868,-1.248533925,-1.170500555,1,0,1
7729,33,50,54,110,101,1,6771.723,0,1335.783,LESS,-156,3780,3624,8,1,-9,-0.843667615,9,0,-1.904197477,1.355198794,211,110,101,0,1.017196402,1.170500555,0.819350388,2.458696803,-0.192255456,0.192255456,0.819350388,1.170500555,0,1,0
7730,33,51,14,46,50,0,2614.847,50,2014.504,LESS,-720,1592,872,4,1,4,0.374963384,4,-0.87303787,-0.038861173,-0.681818239,96,46,50,1,-1.276481759,-1.326567295,-1.170500555,-0.010287434,-0.944776956,0.944776956,-1.170500555,-1.326567295,1,1,0
7731,33,52,22,80,83,1,3907.799,30,869.263,LESS,910,1406,2316,5,2,3,0.281222538,3,-1.047645444,-0.784995695,-0.048225789,163,80,83,1,0.059835082,0,0.117050055,0.606958625,1.230063549,1.230063549,0.117050055,0,0,1,1
7732,33,53,6,50,56,0,3284.743,0,1986.815,LESS,-1342,2702,1360,4,1,6,0.562445076,6,-0.523822722,-1.904197477,-0.353545381,106,50,56,1,-1.077031484,-1.170500555,-0.936400444,-0.010287434,-1.774685418,1.774685418,-0.936400444,-1.170500555,0,1,0
7733,33,54,13,50,47,1,5225.165,30,2804.127,LESS,1084,2144,3228,5,2,-3,-0.281222538,3,-1.047645444,-0.784995695,0.597330388,97,50,47,0,-1.256536731,-1.170500555,-1.28755061,0.606958625,1.462224437,1.462224437,-1.28755061,-1.170500555,0,1,1
7734,33,55,46,110,124,0,3174.476,70,1093.915,LESS,230,1798,2028,4,2,14,1.312371845,14,0.87303787,0.707273349,-0.407580132,234,110,124,1,1.475932034,1.170500555,1.716734147,-0.010287434,0.322768124,0.322768124,1.716734147,1.170500555,1,1,1
7735,33,56,27,91,80,1,4310.989,50,1894.479,LESS,254,1938,2192,5,2,-11,-1.031149307,11,0.349215148,-0.038861173,0.149351646,171,91,80,0,0.219395302,0.429183537,0,0.606958625,0.354790315,0.354790315,0,0.429183537,1,1,1
7736,33,57,40,64,80,0,3744.422,70,1299.335,LESS,-226,1876,1650,4,1,16,1.499853537,16,1.222253018,0.707273349,-0.128286328,144,64,80,1,-0.31912044,-0.624266962,0,-0.010287434,-0.285653514,0.285653514,0,-0.624266962,1,1,0
7737,33,58,22,83,80,1,3383.477,60,982.277,LESS,640,1452,2092,3,2,-3,-0.281222538,3,-1.047645444,0.334206088,-0.305162211,163,83,80,0,0.059835082,0.117050055,0,-0.627533494,0.869813895,0.869813895,0,0.117050055,1,0,1
7738,33,59,54,101,110,1,6491.788,10,1297.814,LESS,1084,3014,4098,5,1,9,0.843667615,9,0,-1.531130216,1.218020691,211,101,110,1,1.017196402,0.819350388,1.170500555,0.606958625,1.462224437,1.462224437,1.170500555,0.819350388,0,1,1
7739,33,60,6,56,50,1,2968.831,50,1573.64,LESS,274,1272,1546,3,2,-6,-0.562445076,6,-0.523822722,-0.038861173,-0.508353493,106,56,50,0,-1.077031484,-0.936400444,-1.170500555,-0.627533494,0.381475475,0.381475475,-1.170500555,-0.936400444,1,0,1
7740,33,61,18,50,42,0,2635.346,70,1742.201,LESS,-658,1610,952,4,1,-8,-0.749926769,8,-0.174607574,0.707273349,-0.671773,92,50,42,0,-1.356261869,-1.170500555,-1.482634036,-0.010287434,-0.862052961,0.862052961,-1.482634036,-1.170500555,1,1,0
7741,33,62,43,110,117,0,3411.244,30,1298.9,LESS,-426,1858,1432,4,1,7,0.656185922,7,-0.349215148,-0.784995695,-0.291555394,227,110,117,1,1.336316841,1.170500555,1.443617351,-0.010287434,-0.55250511,0.55250511,1.443617351,1.170500555,0,0,0
7742,33,63,32,77,80,0,5853.726,10,2080.64,LESS,-1974,4644,2670,6,1,3,0.281222538,3,-1.047645444,-1.531130216,0.905347626,157,77,80,1,-0.059835082,-0.117050055,0,1.224204684,-2.61793646,2.61793646,0,-0.117050055,0,1,0
7743,33,64,27,80,91,0,6196.491,0,1493.795,LESS,-388,3452,3064,6,1,11,1.031149307,11,0.349215148,-1.904197477,1.073314662,171,80,91,1,0.219395302,0,0.429183537,1.224204684,-0.501803307,0.501803307,0.429183537,0,0,1,0
7744,33,65,16,44,50,0,3858.986,10,1765.343,LESS,-1670,3232,1562,4,1,6,0.562445076,6,-0.523822722,-1.531130216,-0.072145895,94,44,50,1,-1.316371814,-1.404600665,-1.170500555,-0.010287434,-2.212322035,2.212322035,-1.170500555,-1.404600665,0,0,0
7745,33,66,7,50,57,0,4190.61,20,1640.493,LESS,-134,2464,2330,4,1,7,0.656185922,7,-0.349215148,-1.158062956,0.090361656,107,50,57,1,-1.057086457,-1.170500555,-0.897383758,-0.010287434,-0.16290178,0.16290178,-0.897383758,-1.170500555,0,1,0
7746,33,67,14,50,46,1,2659.802,20,1788.59,LESS,-236,1810,1574,3,1,-4,-0.374963384,4,-0.87303787,-1.158062956,-0.65978869,96,50,46,0,-1.276481759,-1.170500555,-1.326567295,-0.627533494,-0.298996094,0.298996094,-1.326567295,-1.170500555,0,0,0
7747,33,68,51,110,108,0,2562.392,70,1206.53,LESS,-216,1372,1156,4,1,-2,-0.187481692,2,-1.222253018,0.707273349,-0.707523054,218,110,108,0,1.156811594,1.170500555,1.092467184,-0.010287434,-0.272310935,0.272310935,1.092467184,1.170500555,1,1,0
7748,33,69,50,133,110,1,2433.32,80,1584.182,LESS,346,1048,1394,3,2,-23,-2.15603946,23,2.444506035,1.08034061,-0.770772923,243,133,110,0,1.655437281,2.067884313,1.170500555,-0.627533494,0.477542049,0.477542049,1.170500555,2.067884313,1,0,1
7749,33,70,49,131,110,1,2741.156,80,2712.045,LESS,724,1062,1786,3,2,-21,-1.968557767,21,2.095290887,1.08034061,-0.619922338,241,131,110,0,1.615547226,1.989850943,1.170500555,-0.627533494,0.981891565,0.981891565,1.170500555,1.989850943,1,0,1
7750,33,71,47,126,110,1,2847.174,50,1956.919,LESS,580,1132,1712,3,2,-16,-1.499853537,16,1.222253018,-0.038861173,-0.567969749,236,126,110,0,1.515822089,1.794767517,1.170500555,-0.627533494,0.789758416,0.789758416,1.170500555,1.794767517,1,0,1
7751,33,72,50,110,133,0,2610.871,30,1714.016,LESS,-386,1456,1070,4,1,23,2.15603946,23,2.444506035,-0.784995695,-0.68376662,243,110,133,1,1.655437281,1.170500555,2.067884313,-0.010287434,-0.499134791,0.499134791,2.067884313,1.170500555,0,1,0
7752,33,73,47,110,126,0,4865.008,10,1444.753,LESS,-1726,3674,1948,6,1,16,1.499853537,16,1.222253018,-1.531130216,0.420840653,236,110,126,1,1.515822089,1.170500555,1.794767517,1.224204684,-2.287040482,2.287040482,1.794767517,1.170500555,0,1,0
7753,33,74,12,48,50,1,3744.192,90,1598.106,LESS,806,1914,2720,5,2,2,0.187481692,2,-1.222253018,1.45340787,-0.128399036,98,48,50,1,-1.236591704,-1.248533925,-1.170500555,0.606958625,1.091300719,1.091300719,-1.170500555,-1.248533925,1,1,1
7754,33,75,32,80,77,1,2733.39,70,2292.487,LESS,152,1454,1606,3,1,-3,-0.281222538,3,-1.047645444,0.707273349,-0.623727954,157,80,77,0,-0.059835082,0,-0.117050055,-0.627533494,0.218696001,0.218696001,-0.117050055,0,1,0,1
7755,33,76,43,117,110,0,6087.852,50,2361.071,LESS,-1272,3562,2290,4,1,-7,-0.656185922,7,-0.349215148,-0.038861173,1.02007769,227,117,110,0,1.336316841,1.443617351,1.170500555,-0.010287434,-1.68128736,1.68128736,1.170500555,1.443617351,1,1,0
7756,33,77,40,80,64,1,3382.359,60,1836.709,LESS,1256,1090,2346,2,2,-16,-1.499853537,16,1.222253018,0.334206088,-0.305710071,144,80,64,0,-0.31912044,0,-0.624266962,-1.244779553,1.69171681,1.69171681,-0.624266962,0,1,0,1
7757,33,78,31,80,78,1,9695.418,20,1537.652,LESS,496,4494,4990,7,1,-2,-0.187481692,2,-1.222253018,-1.158062956,2.787913292,158,80,78,0,-0.039890055,0,-0.07803337,1.841450743,0.677680746,0.677680746,-0.07803337,0,0,1,1
7758,33,79,46,124,110,1,4884.484,20,1726.298,LESS,426,2336,2762,5,1,-14,-1.312371845,14,0.87303787,-1.158062956,0.430384586,234,124,110,0,1.475932034,1.716734147,1.170500555,0.606958625,0.584282688,0.584282688,1.170500555,1.716734147,0,1,1
7759,33,80,58,92,110,0,1776.086,90,1022.648,LESS,124,1200,1324,2,2,18,1.687335229,18,1.571468165,1.45340787,-1.09284095,202,92,110,1,0.837691154,0.468200222,1.170500555,-1.244779553,0.181336778,0.181336778,1.170500555,0.468200222,1,0,0
7760,33,81,48,128,110,0,1880.618,50,1388.506,MORE,-518,1130,612,2,1,-18,-1.687335229,18,1.571468165,-0.038861173,-1.041616553,238,128,110,1,1.555712144,1.872800887,1.170500555,-1.244779553,-0.675256844,0.675256844,1.170500555,1.872800887,0,0,0
7761,33,82,8,50,58,1,3428.671,30,1687.123,MORE,954,1124,2078,4,2,8,0.749926769,8,-0.174607574,-0.784995695,-0.283015544,108,50,58,0,-1.037141429,-1.170500555,-0.858367073,-0.010287434,1.2887709,1.2887709,-0.858367073,-1.170500555,0,1,1
7762,33,83,4,54,50,1,1851.164,40,1889.349,MORE,190,926,1116,2,2,-4,-0.374963384,4,-0.87303787,-0.411928434,-1.05605006,104,54,50,1,-1.116921539,-1.014433814,-1.170500555,-1.244779553,0.269397805,0.269397805,-1.170500555,-1.014433814,0,0,1
7763,33,84,37,80,69,0,4353.013,60,870.874,MORE,98,2098,2196,4,1,-11,-1.031149307,11,0.349215148,0.334206088,0.1699449,149,80,69,1,-0.219395302,0,-0.429183537,-0.010287434,0.146646071,0.146646071,-0.429183537,0,0,1,1
7764,33,85,52,105,110,0,3279.08,70,936.877,MORE,-712,1936,1224,4,1,5,0.46870423,5,-0.698430296,0.707273349,-0.356320453,215,105,110,0,1.096976512,0.975417129,1.170500555,-0.010287434,-0.934102892,0.934102892,1.170500555,0.975417129,1,1,0
7765,33,86,5,55,50,0,1684.774,90,1760.643,MORE,534,1022,1556,2,2,-5,-0.46870423,5,-0.698430296,1.45340787,-1.137587076,105,55,50,1,-1.096976512,-0.975417129,-1.170500555,-1.244779553,0.728382549,0.728382549,-1.170500555,-0.975417129,1,0,1
7766,33,87,30,96,80,0,3889.745,90,1960.45,MORE,262,1814,2076,3,2,-16,-1.499853537,16,1.222253018,1.45340787,-0.057072891,176,96,80,1,0.31912044,0.624266962,0,-0.627533494,0.365464379,0.365464379,0,0.624266962,1,0,1
7767,33,88,33,80,75,0,4650.883,50,1196.003,MORE,58,2156,2214,4,1,-5,-0.46870423,5,-0.698430296,-0.038861173,0.31591179,155,80,75,1,-0.099725137,0,-0.195083426,-0.010287434,0.093275752,0.093275752,-0.195083426,0,0,1,1
7768,33,89,48,110,128,1,2252.627,70,1868.655,MORE,138,1080,1218,3,2,18,1.687335229,18,1.571468165,0.707273349,-0.859318917,238,110,128,0,1.555712144,1.170500555,1.872800887,-0.627533494,0.20001639,0.20001639,1.872800887,1.170500555,1,0,1
7769,33,90,9,59,50,0,5194.09,20,921.33,MORE,-732,2914,2182,6,1,-9,-0.843667615,9,0,-1.158062956,0.582102533,109,59,50,1,-1.017196402,-0.819350388,-1.170500555,1.224204684,-0.960788051,0.960788051,-1.170500555,-0.819350388,0,1,0
7770,33,91,44,110,119,1,2303.383,70,1510.37,MORE,362,914,1276,3,2,9,0.843667615,9,0,0.707273349,-0.834446672,229,110,119,0,1.376206896,1.170500555,1.521650721,-0.627533494,0.498890177,0.498890177,1.521650721,1.170500555,1,0,1
7771,33,92,2,52,50,0,6131.493,10,2105.343,MORE,-1010,3772,2762,6,1,-2,-0.187481692,2,-1.222253018,-1.531130216,1.041463331,102,52,50,1,-1.156811594,-1.092467184,-1.170500555,1.224204684,-1.331711769,1.331711769,-1.170500555,-1.092467184,0,1,0
7772,33,93,8,58,50,0,6647.55,20,1255.787,MORE,-320,3296,2976,8,1,-8,-0.749926769,8,-0.174607574,-1.158062956,1.294349609,108,58,50,1,-1.037141429,-0.858367073,-1.170500555,2.458696803,-0.411073764,0.411073764,-1.170500555,-0.858367073,0,1,0
7773,33,94,44,119,110,0,3527.815,50,1420.428,MORE,-492,1820,1328,4,1,-9,-0.843667615,9,0,-0.038861173,-0.234431459,229,119,110,1,1.376206896,1.521650721,1.170500555,-0.010287434,-0.640566137,0.640566137,1.170500555,1.521650721,0,1,0
7774,33,95,34,74,80,1,4392.521,30,1269.567,MORE,284,2058,2342,5,2,6,0.562445076,6,-0.523822722,-0.784995695,0.189305224,154,74,80,0,-0.119670165,-0.234100111,0,0.606958625,0.394818055,0.394818055,0,-0.234100111,0,1,1
7775,33,96,24,86,80,0,5417.684,30,1045.188,MORE,-1202,3380,2178,6,1,-6,-0.562445076,6,-0.523822722,-0.784995695,0.691671543,166,86,80,1,0.119670165,0.234100111,0,1.224204684,-1.587889301,1.587889301,0,0.234100111,0,1,0
7776,33,97,39,66,80,0,3722.858,70,1169.005,MORE,-826,2208,1382,4,1,14,1.312371845,14,0.87303787,0.707273349,-0.138853455,146,66,80,0,-0.279230385,-0.546233592,0,-0.010287434,-1.086208301,1.086208301,0,-0.546233592,1,1,0
7777,33,98,9,50,59,1,5929.8,10,1176.414,MORE,-372,3290,2918,5,1,9,0.843667615,9,0,-1.531130216,0.94262659,109,50,59,0,-1.017196402,-1.170500555,-0.819350388,0.606958625,-0.480455179,0.480455179,-0.819350388,-1.170500555,0,1,0
7778,33,99,57,94,110,1,1745.63,60,970.544,MORE,462,730,1192,3,2,16,1.499853537,16,1.222253018,0.334206088,-1.107765473,204,94,110,0,0.877581209,0.546233592,1.170500555,-0.627533494,0.632315975,0.632315975,1.170500555,0.546233592,1,0,1
7779,33,100,60,110,87,0,3357.066,80,1783.45,MORE,-54,1830,1776,3,1,-23,-2.15603946,23,2.444506035,1.08034061,-0.31810454,197,110,87,1,0.737966017,1.170500555,0.273116796,-0.627533494,-0.056161142,0.056161142,0.273116796,1.170500555,1,0,0
7780,33,101,33,75,80,1,4251.426,70,1392.657,MORE,312,1966,2278,5,2,5,0.46870423,5,-0.698430296,0.707273349,0.120163658,155,75,80,0,-0.099725137,-0.195083426,0,0.606958625,0.432177278,0.432177278,0,-0.195083426,1,1,1
7781,33,102,15,50,45,0,1431.442,90,1517.729,MORE,140,964,1104,2,2,-5,-0.46870423,5,-0.698430296,1.45340787,-1.261728763,95,50,45,1,-1.296426786,-1.170500555,-1.36558398,-1.244779553,0.202684906,0.202684906,-1.36558398,-1.170500555,1,0,1
7782,33,103,59,89,110,0,4601.336,70,1145.678,MORE,194,2238,2432,4,2,21,1.968557767,21,2.095290887,0.707273349,0.291631999,199,89,110,0,0.777856072,0.351150166,1.170500555,-0.010287434,0.274734837,0.274734837,1.170500555,0.351150166,1,1,1
7783,33,104,29,80,94,1,2398.748,100,1005.307,MORE,1026,992,2018,3,2,14,1.312371845,14,0.87303787,1.826475131,-0.787714432,174,80,94,0,0.279230385,0,0.546233592,-0.627533494,1.384837475,1.384837475,0.546233592,0,1,0,1
7784,33,105,55,110,98,0,3649.435,60,1093.37,MORE,538,1622,2160,5,2,-12,-1.124890153,12,0.523822722,0.334206088,-0.174833335,208,110,98,1,0.957361319,1.170500555,0.702300333,0.606958625,0.733719581,0.733719581,0.702300333,1.170500555,1,1,1
7785,33,106,29,94,80,0,3241.128,50,1770.389,MORE,-40,1720,1680,3,1,-14,-1.312371845,14,0.87303787,-0.038861173,-0.374918282,174,94,80,1,0.279230385,0.546233592,0,-0.627533494,-0.03748153,0.03748153,0,0.546233592,0,0,0
7786,33,107,57,110,94,0,3708.628,20,2056.259,MORE,1032,1602,2634,3,1,-16,-1.499853537,16,1.222253018,-1.158062956,-0.145826661,204,110,94,1,0.877581209,1.170500555,0.546233592,-0.627533494,1.392843022,1.392843022,0.546233592,1.170500555,0,0,1
7787,33,108,39,80,66,0,1534.357,60,1218.858,MORE,-292,930,638,2,1,-14,-1.312371845,14,0.87303787,0.334206088,-1.211296754,146,80,66,1,-0.279230385,0,-0.546233592,-1.244779553,-0.373714541,0.373714541,-0.546233592,0,1,0,0
7788,33,109,4,50,54,1,5089.783,50,1021.336,MORE,1584,1650,3234,5,2,4,0.374963384,4,-0.87303787,-0.038861173,0.530988395,104,50,54,0,-1.116921539,-1.170500555,-1.014433814,0.606958625,2.129353426,2.129353426,-1.014433814,-1.170500555,0,1,1
7789,33,110,55,98,110,1,10374.381,30,1517.192,MORE,1618,3958,5576,9,2,12,1.124890153,12,0.523822722,-0.784995695,3.120629302,208,98,110,0,0.957361319,0.702300333,1.170500555,3.075942862,2.174718198,2.174718198,1.170500555,0.702300333,0,1,1
7790,33,111,2,50,52,1,6969.709,60,1057.01,MORE,1120,2826,3946,7,2,2,0.187481692,2,-1.222253018,0.334206088,1.452218973,102,50,52,0,-1.156811594,-1.170500555,-1.092467184,1.841450743,1.510257724,1.510257724,-1.092467184,-1.170500555,0,1,1
7791,33,112,59,110,89,0,1514.825,70,1019.202,MORE,-278,840,562,2,1,-21,-1.968557767,21,2.095290887,0.707273349,-1.220868129,199,110,89,1,0.777856072,1.170500555,0.351150166,-1.244779553,-0.355034929,0.355034929,0.351150166,1.170500555,1,0,0
7792,33,113,60,87,110,1,1858.269,80,1477.596,MORE,720,822,1542,3,2,23,2.15603946,23,2.444506035,1.08034061,-1.052568358,197,87,110,0,0.737966017,0.273116796,1.170500555,-0.627533494,0.976554533,0.976554533,1.170500555,0.273116796,1,0,1
7793,33,114,52,110,105,0,6416.581,50,1178.949,MORE,526,2882,3408,7,2,-5,-0.46870423,5,-0.698430296,-0.038861173,1.181166587,215,110,105,1,1.096976512,1.170500555,0.975417129,1.841450743,0.717708485,0.717708485,0.975417129,1.170500555,0,1,1
7794,33,115,30,80,96,1,3910.93,60,2299.098,MORE,676,1578,2254,5,2,16,1.499853537,16,1.222253018,0.334206088,-0.046691488,176,80,96,0,0.31912044,0,0.624266962,0.606958625,0.917847182,0.917847182,0.624266962,0,0,1,1
7795,33,116,24,80,86,1,5398.642,50,1664.218,MORE,1308,2280,3588,5,2,6,0.562445076,6,-0.523822722,-0.038861173,0.682340286,166,80,86,0,0.119670165,0,0.234100111,0.606958625,1.761098224,1.761098224,0.234100111,0,0,1,1
7796,33,117,5,50,55,1,2087.1,20,1039.838,MORE,-76,1314,1238,3,1,5,0.46870423,5,-0.698430296,-1.158062956,-0.940433032,105,50,55,0,-1.096976512,-1.170500555,-0.975417129,-0.627533494,-0.085514818,0.085514818,-0.975417129,-1.170500555,0,0,0
7797,33,118,34,80,74,0,4061.396,80,2238.245,MORE,-1464,2998,1534,4,1,-6,-0.562445076,6,-0.523822722,1.08034061,0.027042202,154,80,74,1,-0.119670165,0,-0.234100111,-0.010287434,-1.937464891,1.937464891,-0.234100111,0,1,0,0
7798,33,119,15,45,50,1,4085.18,80,1335.607,MORE,1832,1596,3428,5,2,5,0.46870423,5,-0.698430296,1.08034061,0.038697207,95,45,50,0,-1.296426786,-1.36558398,-1.170500555,0.606958625,2.460249405,2.460249405,-1.170500555,-1.36558398,1,1,1
7799,33,120,37,69,80,0,6443.634,0,2334.742,MORE,-1052,4118,3066,4,1,11,1.031149307,11,0.349215148,-1.904197477,1.194423519,149,69,80,0,-0.219395302,-0.429183537,0,-0.010287434,-1.387750604,1.387750604,0,-0.429183537,0,1,0
7800,33,121,48,128,110,0,9912.744,30,1348.928,LESS,-958,4484,3526,6,1,-18,-1.687335229,18,1.571468165,-0.784995695,2.894410759,238,128,110,0,1.555712144,1.872800887,1.170500555,1.224204684,-1.262330354,1.262330354,1.170500555,1.872800887,0,1,0
7801,33,122,8,50,58,1,4956.217,20,2139.626,LESS,836,2248,3084,5,2,8,0.749926769,8,-0.174607574,-1.158062956,0.465536306,108,50,58,1,-1.037141429,-1.170500555,-0.858367073,0.606958625,1.131328459,1.131328459,-0.858367073,-1.170500555,0,1,1
7802,33,123,4,54,50,1,3466.463,60,1051.991,LESS,-20,1576,1556,3,2,-4,-0.374963384,4,-0.87303787,0.334206088,-0.26449612,104,54,50,0,-1.116921539,-1.014433814,-1.170500555,-0.627533494,-0.010796371,0.010796371,-1.170500555,-1.014433814,1,0,0
7803,33,124,37,80,69,0,11742.385,10,1028.749,LESS,922,4222,5144,7,1,-11,-1.031149307,11,0.349215148,-1.531130216,3.7909999,149,80,69,0,-0.219395302,0,-0.429183537,1.841450743,1.246074645,1.246074645,-0.429183537,0,0,1,1
7804,33,125,52,105,110,0,3035.147,40,1411.189,LESS,-216,1560,1344,4,1,5,0.46870423,5,-0.698430296,-0.411928434,-0.475856295,215,105,110,1,1.096976512,0.975417129,1.170500555,-0.010287434,-0.272310935,0.272310935,1.170500555,0.975417129,0,1,0
7805,33,126,5,55,50,1,1883.488,30,1048.605,LESS,506,880,1386,3,2,-5,-0.46870423,5,-0.698430296,-0.784995695,-1.040210151,105,55,50,0,-1.096976512,-0.975417129,-1.170500555,-0.627533494,0.691023326,0.691023326,-1.170500555,-0.975417129,0,0,1
7806,33,127,30,96,80,1,2258.504,20,1081.054,LESS,446,946,1392,3,2,-16,-1.499853537,16,1.222253018,-1.158062956,-0.856438978,176,96,80,0,0.31912044,0.624266962,0,-0.627533494,0.610967847,0.610967847,0,0.624266962,0,0,1
7807,33,128,33,80,75,1,2103.169,0,1859.848,LESS,-472,1808,1336,3,1,-5,-0.46870423,5,-0.698430296,-1.904197477,-0.932558651,155,80,75,0,-0.099725137,0,-0.195083426,-0.627533494,-0.613880977,0.613880977,-0.195083426,0,0,0,0
7808,33,129,48,110,128,0,1443.26,80,633.472,LESS,-406,964,558,2,1,18,1.687335229,18,1.571468165,1.08034061,-1.255937523,238,110,128,1,1.555712144,1.170500555,1.872800887,-1.244779553,-0.52581995,0.52581995,1.872800887,1.170500555,1,0,0
7809,33,130,9,59,50,1,2539.606,80,917.915,LESS,716,1080,1796,3,2,-9,-0.843667615,9,0,1.08034061,-0.718689004,109,59,50,0,-1.017196402,-0.819350388,-1.170500555,-0.627533494,0.971217501,0.971217501,-1.170500555,-0.819350388,1,0,1
7810,33,131,44,110,119,0,3106.006,50,883.738,LESS,-588,1778,1190,4,1,9,0.843667615,9,0,-0.038861173,-0.441132866,229,110,119,1,1.376206896,1.170500555,1.521650721,-0.010287434,-0.768654902,0.768654902,1.521650721,1.170500555,1,1,0
7811,33,132,2,52,50,1,1854.279,90,786.853,LESS,1118,656,1774,3,2,-2,-0.187481692,2,-1.222253018,1.45340787,-1.0545236,102,52,50,0,-1.156811594,-1.092467184,-1.170500555,-0.627533494,1.507589209,1.507589209,-1.170500555,-1.092467184,1,0,1
7812,33,133,8,58,50,1,2148.818,80,1465.112,LESS,1864,774,2638,3,2,-8,-0.749926769,8,-0.174607574,1.08034061,-0.910189018,108,58,50,0,-1.037141429,-0.858367073,-1.170500555,-0.627533494,2.50294566,2.50294566,-1.170500555,-0.858367073,1,0,1
7813,33,134,44,119,110,1,5173.625,90,885.29,LESS,-20,2682,2662,5,2,-9,-0.843667615,9,0,1.45340787,0.572073956,229,119,110,0,1.376206896,1.521650721,1.170500555,0.606958625,-0.010796371,0.010796371,1.170500555,1.521650721,1,1,0
7814,33,135,34,74,80,0,3705.788,70,1995.354,LESS,-1250,2588,1338,3,1,6,0.562445076,6,-0.523822722,0.707273349,-0.147218362,154,74,80,1,-0.119670165,-0.234100111,0,-0.627533494,-1.651933684,1.651933684,0,-0.234100111,1,0,0
7815,33,136,24,86,80,1,4434.619,20,764.294,LESS,458,2034,2492,5,1,-6,-0.562445076,6,-0.523822722,-1.158062956,0.209934741,166,86,80,0,0.119670165,0.234100111,0,0.606958625,0.626978943,0.626978943,0,0.234100111,0,1,1
7816,33,137,39,66,80,0,1666.633,70,1058.885,LESS,-274,862,588,2,1,14,1.312371845,14,0.87303787,0.707273349,-1.146476811,146,66,80,1,-0.279230385,-0.546233592,0,-1.244779553,-0.349697897,0.349697897,0,-0.546233592,1,0,0
7817,33,138,9,50,59,0,2893.832,70,992.759,LESS,-254,1436,1182,4,1,9,0.843667615,9,0,0.707273349,-0.54510567,109,50,59,1,-1.017196402,-1.170500555,-0.819350388,-0.010287434,-0.323012738,0.323012738,-0.819350388,-1.170500555,1,1,0
7818,33,139,57,94,110,0,1582.342,70,1172.115,LESS,-254,1042,788,2,2,16,1.499853537,16,1.222253018,0.707273349,-1.187782398,204,94,110,1,0.877581209,0.546233592,1.170500555,-1.244779553,-0.323012738,0.323012738,1.170500555,0.546233592,1,0,0
7819,33,140,60,110,87,1,3695.395,80,1106.856,LESS,280,1686,1966,5,2,-23,-2.15603946,23,2.444506035,1.08034061,-0.152311301,197,110,87,0,0.737966017,1.170500555,0.273116796,0.606958625,0.389481023,0.389481023,0.273116796,1.170500555,1,1,1
7820,33,141,33,75,80,0,5574.181,70,971.626,LESS,-2,2408,2406,4,1,5,0.46870423,5,-0.698430296,0.707273349,0.768360637,155,75,80,1,-0.099725137,-0.195083426,0,-0.010287434,0.013220273,0.013220273,0,-0.195083426,1,1,0
7821,33,142,15,50,45,1,3548.102,30,982.569,LESS,280,1742,2022,3,2,-5,-0.46870423,5,-0.698430296,-0.784995695,-0.224490108,95,50,45,0,-1.296426786,-1.170500555,-1.36558398,-0.627533494,0.389481023,0.389481023,-1.36558398,-1.170500555,0,0,1
7822,33,143,59,89,110,0,1623.716,30,1383.839,LESS,-542,1138,596,2,1,21,1.968557767,21,2.095290887,-0.784995695,-1.167507667,199,89,110,1,0.777856072,0.351150166,1.170500555,-1.244779553,-0.707279035,0.707279035,1.170500555,0.351150166,0,0,0
7823,33,144,29,80,94,0,10280.819,50,1179.868,LESS,798,3974,4772,7,1,14,1.312371845,14,0.87303787,-0.038861173,3.074780596,174,80,94,1,0.279230385,0,0.546233592,1.841450743,1.080626655,1.080626655,0.546233592,0,0,1,1
7824,33,145,55,110,98,1,5266.289,10,1292.84,LESS,-540,2954,2414,7,1,-12,-1.124890153,12,0.523822722,-1.531130216,0.61748261,208,110,98,0,0.957361319,1.170500555,0.702300333,1.841450743,-0.70461052,0.70461052,0.702300333,1.170500555,0,1,0
7825,33,146,29,94,80,1,1946.86,40,734.55,LESS,402,824,1226,3,2,-14,-1.312371845,14,0.87303787,-0.411928434,-1.009155618,174,94,80,0,0.279230385,0.546233592,0,-0.627533494,0.552260496,0.552260496,0,0.546233592,0,0,1
7826,33,147,57,110,94,1,4480.192,70,1135.156,LESS,414,1874,2288,7,2,-16,-1.499853537,16,1.222253018,0.707273349,0.232267131,204,110,94,0,0.877581209,1.170500555,0.546233592,1.841450743,0.568271592,0.568271592,0.546233592,1.170500555,1,1,1
7827,33,148,39,80,66,0,2948.228,30,1442.475,LESS,-410,1632,1222,4,1,-14,-1.312371845,14,0.87303787,-0.784995695,-0.518449696,146,80,66,0,-0.279230385,0,-0.546233592,-0.010287434,-0.531156982,0.531156982,-0.546233592,0,0,1,0
7828,33,149,4,50,54,1,2559.781,30,928.783,LESS,730,894,1624,3,2,4,0.374963384,4,-0.87303787,-0.784995695,-0.708802536,104,50,54,1,-1.116921539,-1.170500555,-1.014433814,-0.627533494,0.989897113,0.989897113,-1.014433814,-1.170500555,0,0,1
7829,33,150,55,98,110,0,1842.027,70,1203.063,LESS,-642,1202,560,2,1,12,1.124890153,12,0.523822722,0.707273349,-1.060527515,208,98,110,1,0.957361319,0.702300333,1.170500555,-1.244779553,-0.840704833,0.840704833,1.170500555,0.702300333,1,0,0
7830,33,151,2,50,52,1,4939.104,70,1479.32,LESS,664,2252,2916,5,2,2,0.187481692,2,-1.222253018,0.707273349,0.457150327,102,50,52,1,-1.156811594,-1.170500555,-1.092467184,0.606958625,0.901836086,0.901836086,-1.092467184,-1.170500555,1,1,1
7831,33,152,59,110,89,1,2196.524,90,1711.878,LESS,590,828,1418,3,2,-21,-1.968557767,21,2.095290887,1.45340787,-0.886811382,199,110,89,0,0.777856072,1.170500555,0.351150166,-0.627533494,0.803100996,0.803100996,0.351150166,1.170500555,1,0,1
7832,33,153,60,87,110,0,3524.365,90,1387.779,LESS,260,1698,1958,4,2,23,2.15603946,23,2.444506035,1.45340787,-0.236122082,197,87,110,1,0.737966017,0.273116796,1.170500555,-0.010287434,0.362795863,0.362795863,1.170500555,0.273116796,1,1,1
7833,33,154,52,110,105,1,9019.205,70,895.155,LESS,1044,3754,4798,7,2,-5,-0.46870423,5,-0.698430296,0.707273349,2.45654488,215,110,105,0,1.096976512,1.170500555,0.975417129,1.841450743,1.408854118,1.408854118,0.975417129,1.170500555,1,1,1
7834,33,155,30,80,96,0,4286.78,20,1606.445,LESS,-496,2362,1866,4,1,16,1.499853537,16,1.222253018,-1.158062956,0.137488375,176,80,96,1,0.31912044,0,0.624266962,-0.010287434,-0.645903168,0.645903168,0.624266962,0,0,1,0
7835,33,156,24,80,86,0,1866.205,100,1541.805,LESS,56,1162,1218,2,2,6,0.562445076,6,-0.523822722,1.826475131,-1.048679436,166,80,86,1,0.119670165,0,0.234100111,-1.244779553,0.090607236,0.090607236,0.234100111,0,1,0,0
7836,33,157,5,50,55,0,4953.792,20,1815.389,LESS,-596,2594,1998,5,1,5,0.46870423,5,-0.698430296,-1.158062956,0.46434797,105,50,55,1,-1.096976512,-1.170500555,-0.975417129,0.606958625,-0.779328966,0.779328966,-0.975417129,-1.170500555,0,1,0
7837,33,158,34,80,74,0,6165.749,20,1619.153,LESS,-958,3402,2444,6,1,-6,-0.562445076,6,-0.523822722,-1.158062956,1.058249989,154,80,74,0,-0.119670165,0,-0.234100111,1.224204684,-1.262330354,1.262330354,-0.234100111,0,0,1,0
7838,33,159,15,45,50,0,1525.091,50,777.406,LESS,-276,906,630,2,1,5,0.46870423,5,-0.698430296,-0.038861173,-1.215837424,95,45,50,1,-1.296426786,-1.36558398,-1.170500555,-1.244779553,-0.352366413,0.352366413,-1.170500555,-1.36558398,0,0,0
7839,33,160,37,69,80,0,1898.417,60,932.481,LESS,-498,1194,696,2,1,11,1.031149307,11,0.349215148,0.334206088,-1.03289441,149,69,80,1,-0.219395302,-0.429183537,0,-1.244779553,-0.648571684,0.648571684,0,-0.429183537,1,0,0
7840,33,161,3,50,53,1,6549.821,70,1524.05,MORE,-594,3374,2780,4,2,3,0.281222538,3,-1.047645444,0.707273349,1.246458925,103,50,53,0,-1.136866566,-1.170500555,-1.053450499,-0.010287434,-0.77666045,0.77666045,-1.053450499,-1.170500555,1,0,0
7841,33,162,20,50,40,0,3497.788,80,1002.732,MORE,-76,1742,1666,4,1,-10,-0.937408461,10,0.174607574,1.08034061,-0.249145757,90,50,40,1,-1.396151924,-1.170500555,-1.560667406,-0.010287434,-0.085514818,0.085514818,-1.560667406,-1.170500555,1,0,0
7842,33,163,25,80,88,1,4550.765,80,1462.478,MORE,734,1980,2714,5,2,8,0.749926769,8,-0.174607574,1.08034061,0.266850411,168,80,88,0,0.15956022,0,0.312133481,0.606958625,0.995234145,0.995234145,0.312133481,0,1,1,1
7843,33,164,42,115,110,0,1526.413,0,1275.715,MORE,-1110,1668,558,2,1,-5,-0.46870423,5,-0.698430296,-1.904197477,-1.215189597,225,115,110,1,1.296426786,1.36558398,1.170500555,-1.244779553,-1.465137567,1.465137567,1.170500555,1.36558398,0,0,0
7844,33,165,53,103,110,0,5756.064,30,904.897,MORE,86,2538,2624,5,1,7,0.656185922,7,-0.349215148,-0.784995695,0.857489773,213,103,110,0,1.057086457,0.897383758,1.170500555,0.606958625,0.130634975,0.130634975,1.170500555,0.897383758,0,1,1
7845,33,166,26,90,80,0,9142.834,20,1389.664,MORE,-1882,5014,3132,6,1,-10,-0.937408461,10,0.174607574,-1.158062956,2.517127486,170,90,80,1,0.199450275,0.390166852,0,1.224204684,-2.495184726,2.495184726,0,0.390166852,0,1,0
7846,33,167,35,80,72,0,4035.357,60,1199.959,MORE,366,1802,2168,5,2,-8,-0.749926769,8,-0.174607574,0.334206088,0.014282166,152,80,72,1,-0.15956022,0,-0.312133481,0.606958625,0.504227209,0.504227209,-0.312133481,0,0,1,1
7847,33,168,28,93,80,0,2688.894,30,1455.529,MORE,-248,1418,1170,4,1,-13,-1.218630999,13,0.698430296,-0.784995695,-0.645532576,173,93,80,1,0.259285357,0.507216907,0,-0.010287434,-0.31500719,0.31500719,0,0.507216907,0,0,0
7848,33,169,26,80,90,1,1844.621,80,750.45,MORE,618,790,1408,3,2,10,0.937408461,10,0.174607574,1.08034061,-1.059256363,170,80,90,0,0.199450275,0,0.390166852,-0.627533494,0.840460219,0.840460219,0.390166852,0,1,0,1
7849,33,170,25,88,80,0,1453.716,70,784.634,MORE,-350,908,558,2,1,-8,-0.749926769,8,-0.174607574,0.707273349,-1.250813711,168,88,80,1,0.15956022,0.312133481,0,-1.244779553,-0.451101504,0.451101504,0,0.312133481,1,0,0
7850,33,171,36,80,70,0,3936.449,70,813.283,MORE,-24,1886,1862,4,1,-10,-0.937408461,10,0.174607574,0.707273349,-0.034186271,150,80,70,1,-0.199450275,0,-0.390166852,-0.010287434,-0.016133403,0.016133403,-0.390166852,0,1,0,1
7851,33,172,28,80,93,0,2977.221,70,1080.921,MORE,-438,1758,1320,4,1,13,1.218630999,13,0.698430296,0.707273349,-0.504242095,173,80,93,0,0.259285357,0,0.507216907,-0.010287434,-0.568516206,0.568516206,0.507216907,0,1,0,0
7852,33,173,21,82,80,0,11964.377,70,2005.103,MORE,-56,5508,5452,12,1,-2,-0.187481692,2,-1.222253018,0.707273349,3.899783872,162,82,80,1,0.039890055,0.07803337,0,4.92768104,-0.058829658,0.058829658,0,0.07803337,1,1,0
7853,33,174,19,50,41,0,4135.63,40,1021.755,MORE,-1108,2478,1370,4,1,-9,-0.843667615,9,0,-0.411928434,0.063419501,91,50,41,1,-1.376206896,-1.170500555,-1.521650721,-0.010287434,-1.462469051,1.462469051,-1.521650721,-1.170500555,0,1,0
7854,33,175,56,96,110,1,2743.44,60,1578.227,MORE,174,1234,1408,2,2,14,1.312371845,14,0.87303787,0.334206088,-0.618803097,206,96,110,0,0.917471264,0.624266962,1.170500555,-1.244779553,0.248049677,0.248049677,1.170500555,0.624266962,1,0,1
7855,33,176,23,80,85,0,3397.34,30,1124.74,MORE,-704,2028,1324,4,1,5,0.46870423,5,-0.698430296,-0.784995695,-0.298368848,165,80,85,0,0.099725137,0,0.195083426,-0.010287434,-0.923428828,0.923428828,0.195083426,0,0,0,0
7856,33,177,10,60,50,0,2532.466,70,945.711,MORE,-360,1396,1036,4,1,-10,-0.937408461,10,0.174607574,0.707273349,-0.722187858,110,60,50,1,-0.997251374,-0.780333703,-1.170500555,-0.010287434,-0.464444083,0.464444083,-1.170500555,-0.780333703,1,0,0
7857,33,178,19,41,50,0,6140.558,70,1163.627,MORE,314,2786,3100,6,1,9,0.843667615,9,0,0.707273349,1.045905504,91,41,50,0,-1.376206896,-1.521650721,-1.170500555,1.224204684,0.434845794,0.434845794,-1.170500555,-1.521650721,1,1,1
7858,33,179,56,110,96,1,6412.806,20,1527.67,MORE,-804,3986,3182,5,1,-14,-1.312371845,14,0.87303787,-1.158062956,1.179316703,206,110,96,1,0.917471264,1.170500555,0.624266962,0.606958625,-1.056854626,1.056854626,0.624266962,1.170500555,0,1,0
7859,33,180,35,72,80,1,4655.703,60,1542.304,MORE,830,1760,2590,5,2,8,0.749926769,8,-0.174607574,0.334206088,0.318273761,152,72,80,0,-0.15956022,-0.312133481,0,0.606958625,1.123322911,1.123322911,0,-0.312133481,1,1,1
7860,33,181,11,49,50,0,4007.788,40,1603.565,MORE,-612,2172,1560,4,1,1,0.093740846,1,-1.396860592,-0.411928434,0.000772376,99,49,50,0,-1.216646676,-1.20951724,-1.170500555,-0.010287434,-0.800677094,0.800677094,-1.170500555,-1.20951724,0,0,0
7861,33,182,17,43,50,0,5057.656,70,1287.006,MORE,180,2240,2420,4,1,7,0.656185922,7,-0.349215148,0.707273349,0.515245022,93,43,50,0,-1.336316841,-1.443617351,-1.170500555,-0.010287434,0.256055225,0.256055225,-1.170500555,-1.443617351,1,1,1
7862,33,183,1,51,50,0,3685.316,70,1253.82,MORE,-728,2090,1362,4,1,-1,-0.093740846,1,-1.396860592,0.707273349,-0.157250369,101,51,50,1,-1.176756621,-1.131483869,-1.170500555,-0.010287434,-0.955451019,0.955451019,-1.170500555,-1.131483869,1,1,0
7863,33,184,41,112,110,1,5533.621,20,1315.799,MORE,-1570,3924,2354,5,1,-2,-0.187481692,2,-1.222253018,-1.158062956,0.748484795,222,112,110,1,1.236591704,1.248533925,1.170500555,0.606958625,-2.078896237,2.078896237,1.170500555,1.248533925,0,1,0
7864,33,185,20,40,50,1,1988.182,100,1186.665,MORE,1200,804,2004,3,2,10,0.937408461,10,0.174607574,1.826475131,-0.988906369,90,40,50,0,-1.396151924,-1.560667406,-1.170500555,-0.627533494,1.616998363,1.616998363,-1.170500555,-1.560667406,1,0,1
7865,33,186,1,50,51,1,5891.906,30,1066.853,MORE,268,2522,2790,5,2,1,0.093740846,1,-1.396860592,-0.784995695,0.924057183,101,50,51,0,-1.176756621,-1.170500555,-1.131483869,0.606958625,0.373469927,0.373469927,-1.131483869,-1.170500555,0,1,1
7866,33,187,23,85,80,0,4300.777,70,985.119,MORE,-30,1394,1364,3,1,-5,-0.46870423,5,-0.698430296,0.707273349,0.144347403,165,85,80,1,0.099725137,0.195083426,0,-0.627533494,-0.024138951,0.024138951,0,0.195083426,1,0,0
7867,33,188,11,50,49,0,5242.89,40,1023.543,MORE,220,2242,2462,6,1,-1,-0.093740846,1,-1.396860592,-0.411928434,0.606016268,99,50,49,1,-1.216646676,-1.170500555,-1.20951724,1.224204684,0.309425544,0.309425544,-1.20951724,-1.170500555,0,1,1
7868,33,189,17,50,43,0,7640.657,70,1191.156,MORE,-1200,3854,2654,3,1,-7,-0.656185922,7,-0.349215148,0.707273349,1.781007348,93,50,43,1,-1.336316841,-1.170500555,-1.443617351,-0.627533494,-1.585220785,1.585220785,-1.443617351,-1.170500555,1,0,0
7869,33,190,21,80,82,0,3754.229,60,512.611,MORE,-636,2052,1416,4,1,2,0.187481692,2,-1.222253018,0.334206088,-0.123480549,162,80,82,0,0.039890055,0,0.07803337,-0.010287434,-0.832699285,0.832699285,0.07803337,0,1,0,0
7870,33,191,10,50,60,1,3341.929,70,1521.771,MORE,246,1544,1790,3,2,10,0.937408461,10,0.174607574,0.707273349,-0.325522208,110,50,60,0,-0.997251374,-1.170500555,-0.780333703,-0.627533494,0.344116251,0.344116251,-0.780333703,-1.170500555,1,0,1
7871,33,192,3,53,50,0,1694.368,20,1987.436,MORE,280,1118,1398,2,1,-3,-0.281222538,3,-1.047645444,-1.158062956,-1.132885675,103,53,50,1,-1.136866566,-1.053450499,-1.170500555,-1.244779553,0.389481023,0.389481023,-1.170500555,-1.053450499,0,0,1
7872,33,193,45,122,110,0,2674.219,90,1362.512,MORE,310,1646,1956,4,2,-12,-1.124890153,12,0.523822722,1.45340787,-0.652723848,232,122,110,1,1.436041979,1.638700776,1.170500555,-0.010287434,0.429508762,0.429508762,1.170500555,1.638700776,1,0,1
7873,33,194,38,67,80,1,2228.699,80,2385.772,MORE,2446,1034,3480,3,2,13,1.218630999,13,0.698430296,1.08034061,-0.871044488,147,67,80,0,-0.259285357,-0.507216907,0,-0.627533494,3.279483804,3.279483804,0,-0.507216907,1,0,1
7874,33,195,38,80,67,1,2848.448,20,1458.319,MORE,66,1552,1618,3,1,-13,-1.218630999,13,0.698430296,-1.158062956,-0.567345443,147,80,67,1,-0.259285357,0,-0.507216907,-0.627533494,0.103949815,0.103949815,-0.507216907,0,0,0,1
7875,33,196,36,70,80,0,4027.628,30,802.149,MORE,-452,2052,1600,4,1,10,0.937408461,10,0.174607574,-0.784995695,0.010494681,150,70,80,0,-0.199450275,-0.390166852,0,-0.010287434,-0.587195817,0.587195817,0,-0.390166852,0,0,0
7876,33,197,45,110,122,1,2835.649,70,1275.939,MORE,-524,1846,1322,1,2,12,1.124890153,12,0.523822722,0.707273349,-0.573617408,232,110,122,0,1.436041979,1.170500555,1.638700776,-1.862025612,-0.683262392,0.683262392,1.638700776,1.170500555,1,0,0
7877,33,198,42,110,115,0,8278.587,80,2054.34,MORE,14,3902,3916,6,2,5,0.46870423,5,-0.698430296,1.08034061,2.093615729,225,110,115,0,1.296426786,1.170500555,1.36558398,1.224204684,0.0345684,0.0345684,1.36558398,1.170500555,1,1,1
7878,33,199,41,110,112,1,3903.836,60,1607.113,MORE,908,1458,2366,3,2,2,0.187481692,2,-1.222253018,0.334206088,-0.0501678,222,110,112,0,1.236591704,1.170500555,1.248533925,-0.627533494,1.227395033,1.227395033,1.248533925,1.170500555,1,0,1
7879,33,200,53,110,103,0,2579.74,70,992.616,MORE,-490,1576,1086,2,1,-7,-0.656185922,7,-0.349215148,0.707273349,-0.699021917,213,110,103,1,1.057086457,1.170500555,0.897383758,-1.244779553,-0.637897621,0.637897621,0.897383758,1.170500555,1,0,0
7880,33,201,3,50,53,1,5318.646,10,945.704,LESS,-446,2538,2092,5,1,3,0.281222538,3,-1.047645444,-1.531130216,0.643139402,103,50,53,1,-1.136866566,-1.170500555,-1.053450499,0.606958625,-0.57919027,0.57919027,-1.053450499,-1.170500555,0,1,0
7881,33,202,20,50,40,1,2086.724,50,1912.752,LESS,642,814,1456,3,2,-10,-0.937408461,10,0.174607574,-0.038861173,-0.940617285,90,50,40,0,-1.396151924,-1.170500555,-1.560667406,-0.627533494,0.872482411,0.872482411,-1.560667406,-1.170500555,0,0,1
7882,33,203,25,80,88,0,1867.922,60,1252.064,LESS,-524,1168,644,2,1,8,0.749926769,8,-0.174607574,0.334206088,-1.047838045,168,80,88,1,0.15956022,0,0.312133481,-1.244779553,-0.683262392,0.683262392,0.312133481,0,1,0,0
7883,33,204,42,115,110,1,3287.542,0,786.082,LESS,-214,1794,1580,3,1,-5,-0.46870423,5,-0.698430296,-1.904197477,-0.352173772,225,115,110,0,1.296426786,1.36558398,1.170500555,-0.627533494,-0.269642419,0.269642419,1.170500555,1.36558398,0,0,0
7884,33,205,53,103,110,0,4005.469,20,1826.911,LESS,228,1858,2086,4,1,7,0.656185922,7,-0.349215148,-1.158062956,-0.000364017,213,103,110,1,1.057086457,0.897383758,1.170500555,-0.010287434,0.320099608,0.320099608,1.170500555,0.897383758,0,1,1
7885,33,206,26,90,80,1,5558.85,30,955.412,LESS,-42,2460,2418,6,1,-10,-0.937408461,10,0.174607574,-0.784995695,0.760847902,170,90,80,0,0.199450275,0.390166852,0,1.224204684,-0.040150046,0.040150046,0,0.390166852,0,1,0
7886,33,207,35,80,72,0,4756.104,30,942.68,LESS,354,2112,2466,4,1,-8,-0.749926769,8,-0.174607574,-0.784995695,0.367473821,152,80,72,0,-0.15956022,0,-0.312133481,-0.010287434,0.488216113,0.488216113,-0.312133481,0,0,1,1
7887,33,208,28,93,80,1,3127.495,20,872.327,LESS,836,1112,1948,3,2,-13,-1.218630999,13,0.698430296,-1.158062956,-0.430602492,173,93,80,0,0.259285357,0.507216907,0,-0.627533494,1.131328459,1.131328459,0,0.507216907,0,0,1
7888,33,209,26,80,90,0,2002.718,10,1494.584,LESS,-1198,1854,656,2,1,10,0.937408461,10,0.174607574,-1.531130216,-0.981783212,170,80,90,1,0.199450275,0,0.390166852,-1.244779553,-1.582552269,1.582552269,0.390166852,0,0,0,0
7889,33,210,25,88,80,1,6819.028,50,788.567,LESS,282,3060,3342,7,2,-8,-0.749926769,8,-0.174607574,-0.038861173,1.378379926,168,88,80,0,0.15956022,0.312133481,0,1.841450743,0.392149539,0.392149539,0,0.312133481,0,1,1
7890,33,211,36,80,70,1,2154.276,70,861.683,LESS,196,936,1132,3,2,-10,-0.937408461,10,0.174607574,0.707273349,-0.907514404,150,80,70,0,-0.199450275,0,-0.390166852,-0.627533494,0.277403353,0.277403353,-0.390166852,0,1,0,1
7891,33,212,28,80,93,0,1635.658,30,1555.445,LESS,-448,1028,580,2,1,13,1.218630999,13,0.698430296,-0.784995695,-1.161655662,173,80,93,1,0.259285357,0,0.507216907,-1.244779553,-0.581858786,0.581858786,0.507216907,0,0,0,0
7892,33,213,21,82,80,1,3600.589,30,1327.454,LESS,170,1620,1790,3,2,-2,-0.187481692,2,-1.222253018,-0.784995695,-0.198769612,162,82,80,0,0.039890055,0.07803337,0,-0.627533494,0.242712645,0.242712645,0,0.07803337,0,0,1
7893,33,214,19,50,41,1,1985.539,90,1059.813,LESS,1096,992,2088,3,2,-9,-0.843667615,9,0,1.45340787,-0.990201533,91,50,41,0,-1.376206896,-1.170500555,-1.521650721,-0.627533494,1.478235533,1.478235533,-1.521650721,-1.170500555,1,0,1
7894,33,215,56,96,110,0,3099.15,80,922.887,LESS,194,1484,1678,4,2,14,1.312371845,14,0.87303787,1.08034061,-0.44449255,206,96,110,1,0.917471264,0.624266962,1.170500555,-0.010287434,0.274734837,0.274734837,1.170500555,0.624266962,1,1,1
7895,33,216,23,80,85,0,2016.568,50,1222.147,LESS,-388,1098,710,2,1,5,0.46870423,5,-0.698430296,-0.038861173,-0.97499622,165,80,85,1,0.099725137,0,0.195083426,-1.244779553,-0.501803307,0.501803307,0.195083426,0,0,0,0
7896,33,217,10,60,50,1,4201.412,40,1188.568,LESS,590,1810,2400,3,2,-10,-0.937408461,10,0.174607574,-0.411928434,0.09565502,110,60,50,0,-0.997251374,-0.780333703,-1.170500555,-0.627533494,0.803100996,0.803100996,-1.170500555,-0.780333703,0,0,1
7897,33,218,19,41,50,0,7393.335,30,883.917,LESS,-1052,3902,2850,4,1,9,0.843667615,9,0,-0.784995695,1.659810775,91,41,50,1,-1.376206896,-1.521650721,-1.170500555,-0.010287434,-1.387750604,1.387750604,-1.170500555,-1.521650721,0,1,0
7898,33,219,56,110,96,1,2128.968,30,1121.363,LESS,494,852,1346,3,2,-14,-1.312371845,14,0.87303787,-0.784995695,-0.919916223,206,110,96,0,0.917471264,1.170500555,0.624266962,-0.627533494,0.67501223,0.67501223,0.624266962,1.170500555,0,0,1
7899,33,220,35,72,80,0,3018.356,40,1935.841,LESS,246,1418,1664,2,2,8,0.749926769,8,-0.174607574,-0.411928434,-0.484084482,152,72,80,1,-0.15956022,-0.312133481,0,-1.244779553,0.344116251,0.344116251,0,-0.312133481,0,0,1
7900,33,221,11,49,50,0,2593.981,60,740.282,LESS,-378,1354,976,2,1,1,0.093740846,1,-1.396860592,0.334206088,-0.69204332,99,49,50,1,-1.216646676,-1.20951724,-1.170500555,-1.244779553,-0.488460727,0.488460727,-1.170500555,-1.20951724,1,0,0
7901,33,222,17,43,50,0,5548.946,10,971.147,LESS,-1638,3512,1874,4,1,7,0.656185922,7,-0.349215148,-1.531130216,0.75599459,93,43,50,1,-1.336316841,-1.443617351,-1.170500555,-0.010287434,-2.16962578,2.16962578,-1.170500555,-1.443617351,0,1,0
7902,33,223,1,51,50,1,3422.548,50,1339.558,LESS,364,1602,1966,5,2,-1,-0.093740846,1,-1.396860592,-0.038861173,-0.286016032,101,51,50,0,-1.176756621,-1.131483869,-1.170500555,0.606958625,0.501558693,0.501558693,-1.170500555,-1.131483869,0,1,1
7903,33,224,41,112,110,1,2089.469,80,641.617,LESS,522,922,1444,3,2,-2,-0.187481692,2,-1.222253018,1.08034061,-0.939272138,222,112,110,0,1.236591704,1.248533925,1.170500555,-0.627533494,0.712371453,0.712371453,1.170500555,1.248533925,1,0,1
7904,33,225,20,40,50,0,3026.628,70,854.097,LESS,-350,1678,1328,4,2,10,0.937408461,10,0.174607574,0.707273349,-0.480030908,90,40,50,1,-1.396151924,-1.560667406,-1.170500555,-0.010287434,-0.451101504,0.451101504,-1.170500555,-1.560667406,1,1,0
7905,33,226,1,50,51,0,1934.204,80,1512.009,LESS,208,952,1160,2,2,1,0.093740846,1,-1.396860592,1.08034061,-1.015357508,101,50,51,1,-1.176756621,-1.170500555,-1.131483869,-1.244779553,0.293414448,0.293414448,-1.131483869,-1.170500555,1,0,1
7906,33,227,23,85,80,1,4261.328,70,662.796,LESS,884,1560,2444,5,2,-5,-0.46870423,5,-0.698430296,0.707273349,0.12501599,165,85,80,0,0.099725137,0.195083426,0,0.606958625,1.195372842,1.195372842,0,0.195083426,1,1,1
7907,33,228,11,50,49,0,3629.222,40,1432.429,LESS,120,1598,1718,4,1,-1,-0.093740846,1,-1.396860592,-0.411928434,-0.184738424,99,50,49,0,-1.216646676,-1.170500555,-1.20951724,-0.010287434,0.175999746,0.175999746,-1.20951724,-1.170500555,0,1,0
7908,33,229,17,50,43,1,2831.685,80,1426.629,LESS,722,986,1708,3,2,-7,-0.656185922,7,-0.349215148,1.08034061,-0.575559909,93,50,43,0,-1.336316841,-1.170500555,-1.443617351,-0.627533494,0.979223049,0.979223049,-1.443617351,-1.170500555,1,0,1
7909,33,230,21,80,82,0,4352.493,80,699.624,LESS,-98,1966,1868,5,1,2,0.187481692,2,-1.222253018,1.08034061,0.169690081,162,80,82,1,0.039890055,0,0.07803337,0.606958625,-0.114868493,0.114868493,0.07803337,0,1,1,0
7910,33,231,10,50,60,0,1522.433,70,1606.979,LESS,174,744,918,2,2,10,0.937408461,10,0.174607574,0.707273349,-1.217139938,110,50,60,1,-0.997251374,-1.170500555,-0.780333703,-1.244779553,0.248049677,0.248049677,-0.780333703,-1.170500555,1,0,1
7911,33,232,3,53,50,0,2025.634,80,1162.914,LESS,-614,1342,728,2,1,-3,-0.281222538,3,-1.047645444,1.08034061,-0.970553557,103,53,50,0,-1.136866566,-1.053450499,-1.170500555,-1.244779553,-0.80334561,0.80334561,-1.170500555,-1.053450499,1,0,0
7912,33,233,45,122,110,1,2271.982,70,1370.944,LESS,352,950,1302,3,2,-12,-1.124890153,12,0.523822722,0.707273349,-0.849834279,232,122,110,0,1.436041979,1.638700776,1.170500555,-0.627533494,0.485547597,0.485547597,1.170500555,1.638700776,1,0,1
7913,33,234,38,67,80,0,3836.855,50,1015.503,LESS,148,1618,1766,4,1,13,1.218630999,13,0.698430296,-0.038861173,-0.082990872,147,67,80,1,-0.259285357,-0.507216907,0,-0.010287434,0.21335897,0.21335897,0,-0.507216907,1,1,0
7914,33,235,38,80,67,1,3589.465,80,1612.528,LESS,348,1568,1916,3,2,-13,-1.218630999,13,0.698430296,1.08034061,-0.204220767,147,80,67,0,-0.259285357,0,-0.507216907,-0.627533494,0.480210565,0.480210565,-0.507216907,0,1,0,1
7915,33,236,36,70,80,0,3708.714,20,1111.763,LESS,-668,2228,1560,3,1,10,0.937408461,10,0.174607574,-1.158062956,-0.145784518,150,70,80,1,-0.199450275,-0.390166852,0,-0.627533494,-0.875395541,0.875395541,0,-0.390166852,0,0,0
7916,33,237,45,110,122,0,6127.148,60,1516.142,LESS,460,2574,3034,6,1,12,1.124890153,12,0.523822722,0.334206088,1.039334127,232,110,122,1,1.436041979,1.170500555,1.638700776,1.224204684,0.629647459,0.629647459,1.638700776,1.170500555,1,1,1
7917,33,238,42,110,115,1,8632.543,30,1365.827,LESS,-382,4318,3936,7,2,5,0.46870423,5,-0.698430296,-0.784995695,2.267066753,225,110,115,1,1.296426786,1.170500555,1.36558398,1.841450743,-0.493797759,0.493797759,1.36558398,1.170500555,0,1,0
7918,33,239,41,110,112,1,3218.693,80,837.48,LESS,332,1334,1666,3,2,2,0.187481692,2,-1.222253018,1.08034061,-0.38591223,222,110,112,1,1.236591704,1.170500555,1.248533925,-0.627533494,0.458862438,0.458862438,1.248533925,1.170500555,1,0,1
7919,33,240,53,110,103,1,6540.174,40,900.536,LESS,-684,3446,2762,5,2,-7,-0.656185922,7,-0.349215148,-0.411928434,1.241731552,213,110,103,0,1.057086457,1.170500555,0.897383758,0.606958625,-0.896743668,0.896743668,0.897383758,1.170500555,0,1,0